index,year,period,area,adjustment,employment,civilian_labor_force,unemployment,unemployment_rate
0,2005,March,Texas,Not Adjusted,10457456,11066337,608881,5.5
1,2005,March,Texas,Adjusted,10502785,11125846,623061,5.6
2,2005,June,Texas,Not Adjusted,10557049,11181612,624563,5.6
3,2005,June,Texas,Adjusted,10569961,11163389,593428,5.3
4,2005,September,Texas,Not Adjusted,10589753,11216770,627017,5.6
5,2005,September,Texas,Adjusted,10604917,11211963,607046,5.4
6,2005,December,Texas,Not Adjusted,10668207,11236116,567909,5.1
7,2005,December,Texas,Adjusted,10633045,11233098,600053,5.3
8,2005,March,Anderson                                             ,Not Adjusted,18642,19915,1273,6.4
9,2005,June,Anderson                                             ,Not Adjusted,18954,20265,1311,6.5
10,2005,September,Anderson                                             ,Not Adjusted,18667,19969,1302,6.5
11,2005,December,Anderson                                             ,Not Adjusted,18829,19976,1147,5.7
12,2005,March,Andrews                                              ,Not Adjusted,5949,6207,258,4.2
13,2005,June,Andrews                                              ,Not Adjusted,6158,6436,278,4.3
14,2005,September,Andrews                                              ,Not Adjusted,6117,6374,257,4.0
15,2005,December,Andrews                                              ,Not Adjusted,6333,6561,228,3.5
16,2005,March,Angelina                                             ,Not Adjusted,36983,39252,2269,5.8
17,2005,June,Angelina                                             ,Not Adjusted,37131,39329,2198,5.6
18,2005,September,Angelina                                             ,Not Adjusted,37295,39415,2120,5.4
19,2005,December,Angelina                                             ,Not Adjusted,38004,39903,1899,4.8
20,2005,March,Aransas                                              ,Not Adjusted,10427,11036,609,5.5
21,2005,June,Aransas                                              ,Not Adjusted,10425,11071,646,5.8
22,2005,September,Aransas                                              ,Not Adjusted,10341,10959,618,5.6
23,2005,December,Aransas                                              ,Not Adjusted,10341,10876,535,4.9
24,2005,March,Archer                                               ,Not Adjusted,5102,5280,178,3.4
25,2005,June,Archer                                               ,Not Adjusted,5132,5347,215,4.0
26,2005,September,Archer                                               ,Not Adjusted,5108,5288,180,3.4
27,2005,December,Archer                                               ,Not Adjusted,5130,5313,183,3.4
28,2005,March,Armstrong                                            ,Not Adjusted,1069,1114,45,4.0
29,2005,June,Armstrong                                            ,Not Adjusted,1082,1126,44,3.9
30,2005,September,Armstrong                                            ,Not Adjusted,1089,1130,41,3.6
31,2005,December,Armstrong                                            ,Not Adjusted,1087,1126,39,3.5
32,2005,March,Atascosa                                             ,Not Adjusted,17899,18937,1038,5.5
33,2005,June,Atascosa                                             ,Not Adjusted,18130,19265,1135,5.9
34,2005,September,Atascosa                                             ,Not Adjusted,18160,19141,981,5.1
35,2005,December,Atascosa                                             ,Not Adjusted,18273,19124,851,4.4
36,2005,March,Austin                                               ,Not Adjusted,12164,12735,571,4.5
37,2005,June,Austin                                               ,Not Adjusted,12217,12836,619,4.8
38,2005,September,Austin                                               ,Not Adjusted,12291,12890,599,4.6
39,2005,December,Austin                                               ,Not Adjusted,12462,12976,514,4.0
40,2005,March,Bailey                                               ,Not Adjusted,3044,3251,207,6.4
41,2005,June,Bailey                                               ,Not Adjusted,3182,3379,197,5.8
42,2005,September,Bailey                                               ,Not Adjusted,3029,3188,159,5.0
43,2005,December,Bailey                                               ,Not Adjusted,2948,3096,148,4.8
44,2005,March,Bandera                                              ,Not Adjusted,9170,9606,436,4.5
45,2005,June,Bandera                                              ,Not Adjusted,9289,9753,464,4.8
46,2005,September,Bandera                                              ,Not Adjusted,9305,9740,435,4.5
47,2005,December,Bandera                                              ,Not Adjusted,9362,9773,411,4.2
48,2005,March,Bastrop                                              ,Not Adjusted,31706,33418,1712,5.1
49,2005,June,Bastrop                                              ,Not Adjusted,32080,33924,1844,5.4
50,2005,September,Bastrop                                              ,Not Adjusted,32088,33826,1738,5.1
51,2005,December,Bastrop                                              ,Not Adjusted,32382,33884,1502,4.4
52,2005,March,Baylor                                               ,Not Adjusted,1778,1885,107,5.7
53,2005,June,Baylor                                               ,Not Adjusted,1816,1903,87,4.6
54,2005,September,Baylor                                               ,Not Adjusted,1790,1876,86,4.6
55,2005,December,Baylor                                               ,Not Adjusted,1742,1817,75,4.1
56,2005,March,Bee                                                  ,Not Adjusted,10247,11043,796,7.2
57,2005,June,Bee                                                  ,Not Adjusted,10300,11185,885,7.9
58,2005,September,Bee                                                  ,Not Adjusted,10303,11085,782,7.1
59,2005,December,Bee                                                  ,Not Adjusted,10354,11057,703,6.4
60,2005,March,Bell                                                 ,Not Adjusted,108614,114142,5528,4.8
61,2005,June,Bell                                                 ,Not Adjusted,108931,114921,5990,5.2
62,2005,September,Bell                                                 ,Not Adjusted,108690,114871,6181,5.4
63,2005,December,Bell                                                 ,Not Adjusted,108163,113919,5756,5.1
64,2005,March,Bexar                                                ,Not Adjusted,673323,710383,37060,5.2
65,2005,June,Bexar                                                ,Not Adjusted,682032,720538,38506,5.3
66,2005,September,Bexar                                                ,Not Adjusted,683147,720712,37565,5.2
67,2005,December,Bexar                                                ,Not Adjusted,687415,720993,33578,4.7
68,2005,March,Blanco                                               ,Not Adjusted,4462,4656,194,4.2
69,2005,June,Blanco                                               ,Not Adjusted,4572,4777,205,4.3
70,2005,September,Blanco                                               ,Not Adjusted,4479,4677,198,4.2
71,2005,December,Blanco                                               ,Not Adjusted,4440,4617,177,3.8
72,2005,March,Borden                                               ,Not Adjusted,417,436,19,4.4
73,2005,June,Borden                                               ,Not Adjusted,453,474,21,4.4
74,2005,September,Borden                                               ,Not Adjusted,431,446,15,3.4
75,2005,December,Borden                                               ,Not Adjusted,423,436,13,3.0
76,2005,March,Bosque                                               ,Not Adjusted,8019,8433,414,4.9
77,2005,June,Bosque                                               ,Not Adjusted,8128,8592,464,5.4
78,2005,September,Bosque                                               ,Not Adjusted,7871,8302,431,5.2
79,2005,December,Bosque                                               ,Not Adjusted,7887,8300,413,5.0
80,2005,March,Bowie                                                ,Not Adjusted,39796,42083,2287,5.4
81,2005,June,Bowie                                                ,Not Adjusted,40063,42482,2419,5.7
82,2005,September,Bowie                                                ,Not Adjusted,40196,42704,2508,5.9
83,2005,December,Bowie                                                ,Not Adjusted,40348,42446,2098,4.9
84,2005,March,Brazoria                                             ,Not Adjusted,125330,133022,7692,5.8
85,2005,June,Brazoria                                             ,Not Adjusted,125878,134314,8436,6.3
86,2005,September,Brazoria                                             ,Not Adjusted,126643,134441,7798,5.8
87,2005,December,Brazoria                                             ,Not Adjusted,128403,135179,6776,5.0
88,2005,March,Brazos                                               ,Not Adjusted,84515,88113,3598,4.1
89,2005,June,Brazos                                               ,Not Adjusted,80223,84171,3948,4.7
90,2005,September,Brazos                                               ,Not Adjusted,84898,88854,3956,4.5
91,2005,December,Brazos                                               ,Not Adjusted,84171,87721,3550,4.0
92,2005,March,Brewster                                             ,Not Adjusted,5183,5386,203,3.8
93,2005,June,Brewster                                             ,Not Adjusted,4911,5125,214,4.2
94,2005,September,Brewster                                             ,Not Adjusted,4991,5189,198,3.8
95,2005,December,Brewster                                             ,Not Adjusted,5134,5316,182,3.4
96,2005,March,Briscoe                                              ,Not Adjusted,634,678,44,6.5
97,2005,June,Briscoe                                              ,Not Adjusted,721,761,40,5.3
98,2005,September,Briscoe                                              ,Not Adjusted,688,725,37,5.1
99,2005,December,Briscoe                                              ,Not Adjusted,651,687,36,5.2
100,2005,March,Brooks                                               ,Not Adjusted,2881,3090,209,6.8
101,2005,June,Brooks                                               ,Not Adjusted,2895,3139,244,7.8
102,2005,September,Brooks                                               ,Not Adjusted,2890,3096,206,6.7
103,2005,December,Brooks                                               ,Not Adjusted,2872,3060,188,6.1
104,2005,March,Brown                                                ,Not Adjusted,17760,18651,891,4.8
105,2005,June,Brown                                                ,Not Adjusted,17878,18841,963,5.1
106,2005,September,Brown                                                ,Not Adjusted,17965,18838,873,4.6
107,2005,December,Brown                                                ,Not Adjusted,18074,18869,795,4.2
108,2005,March,Burleson                                             ,Not Adjusted,8404,8765,361,4.1
109,2005,June,Burleson                                             ,Not Adjusted,7977,8372,395,4.7
110,2005,September,Burleson                                             ,Not Adjusted,8442,8781,339,3.9
111,2005,December,Burleson                                             ,Not Adjusted,8370,8705,335,3.8
112,2005,March,Burnet                                               ,Not Adjusted,19232,20144,912,4.5
113,2005,June,Burnet                                               ,Not Adjusted,19489,20433,944,4.6
114,2005,September,Burnet                                               ,Not Adjusted,19502,20419,917,4.5
115,2005,December,Burnet                                               ,Not Adjusted,19369,20208,839,4.2
116,2005,March,Caldwell                                             ,Not Adjusted,15002,15856,854,5.4
117,2005,June,Caldwell                                             ,Not Adjusted,15179,16066,887,5.5
118,2005,September,Caldwell                                             ,Not Adjusted,15183,16064,881,5.5
119,2005,December,Caldwell                                             ,Not Adjusted,15322,16099,777,4.8
120,2005,March,Calhoun                                              ,Not Adjusted,8728,9284,556,6.0
121,2005,June,Calhoun                                              ,Not Adjusted,8885,9468,583,6.2
122,2005,September,Calhoun                                              ,Not Adjusted,8797,9363,566,6.0
123,2005,December,Calhoun                                              ,Not Adjusted,8833,9274,441,4.8
124,2005,March,Callahan                                             ,Not Adjusted,6617,6907,290,4.2
125,2005,June,Callahan                                             ,Not Adjusted,6686,7003,317,4.5
126,2005,September,Callahan                                             ,Not Adjusted,6803,7090,287,4.0
127,2005,December,Callahan                                             ,Not Adjusted,6790,7047,257,3.6
128,2005,March,Cameron                                              ,Not Adjusted,129190,140788,11598,8.2
129,2005,June,Cameron                                              ,Not Adjusted,130074,141542,11468,8.1
130,2005,September,Cameron                                              ,Not Adjusted,129031,139220,10189,7.3
131,2005,December,Cameron                                              ,Not Adjusted,131196,140760,9564,6.8
132,2005,March,Camp                                                 ,Not Adjusted,5023,5343,320,6.0
133,2005,June,Camp                                                 ,Not Adjusted,5118,5446,328,6.0
134,2005,September,Camp                                                 ,Not Adjusted,5126,5436,310,5.7
135,2005,December,Camp                                                 ,Not Adjusted,5221,5509,288,5.2
136,2005,March,Carson                                               ,Not Adjusted,3323,3465,142,4.1
137,2005,June,Carson                                               ,Not Adjusted,3360,3502,142,4.1
138,2005,September,Carson                                               ,Not Adjusted,3383,3527,144,4.1
139,2005,December,Carson                                               ,Not Adjusted,3380,3504,124,3.5
140,2005,March,Cass                                                 ,Not Adjusted,12640,13492,852,6.3
141,2005,June,Cass                                                 ,Not Adjusted,12738,13615,877,6.4
142,2005,September,Cass                                                 ,Not Adjusted,12479,13340,861,6.5
143,2005,December,Cass                                                 ,Not Adjusted,12314,13084,770,5.9
144,2005,March,Castro                                               ,Not Adjusted,3146,3331,185,5.6
145,2005,June,Castro                                               ,Not Adjusted,3305,3515,210,6.0
146,2005,September,Castro                                               ,Not Adjusted,3221,3413,192,5.6
147,2005,December,Castro                                               ,Not Adjusted,3023,3174,151,4.8
148,2005,March,Chambers                                             ,Not Adjusted,13067,13912,845,6.1
149,2005,June,Chambers                                             ,Not Adjusted,13124,14095,971,6.9
150,2005,September,Chambers                                             ,Not Adjusted,13204,14091,887,6.3
151,2005,December,Chambers                                             ,Not Adjusted,13386,14165,779,5.5
152,2005,March,Cherokee                                             ,Not Adjusted,19363,20467,1104,5.4
153,2005,June,Cherokee                                             ,Not Adjusted,19702,20851,1149,5.5
154,2005,September,Cherokee                                             ,Not Adjusted,19465,20651,1186,5.7
155,2005,December,Cherokee                                             ,Not Adjusted,19149,20288,1139,5.6
156,2005,March,Childress                                            ,Not Adjusted,2855,3030,175,5.8
157,2005,June,Childress                                            ,Not Adjusted,3004,3180,176,5.5
158,2005,September,Childress                                            ,Not Adjusted,2871,3050,179,5.9
159,2005,December,Childress                                            ,Not Adjusted,2798,2973,175,5.9
160,2005,March,Clay                                                 ,Not Adjusted,6226,6471,245,3.8
161,2005,June,Clay                                                 ,Not Adjusted,6265,6538,273,4.2
162,2005,September,Clay                                                 ,Not Adjusted,6234,6481,247,3.8
163,2005,December,Clay                                                 ,Not Adjusted,6260,6486,226,3.5
164,2005,March,Cochran                                              ,Not Adjusted,1438,1548,110,7.1
165,2005,June,Cochran                                              ,Not Adjusted,1496,1599,103,6.4
166,2005,September,Cochran                                              ,Not Adjusted,1472,1549,77,5.0
167,2005,December,Cochran                                              ,Not Adjusted,1407,1481,74,5.0
168,2005,March,Coke                                                 ,Not Adjusted,1273,1352,79,5.8
169,2005,June,Coke                                                 ,Not Adjusted,1339,1422,83,5.8
170,2005,September,Coke                                                 ,Not Adjusted,1293,1370,77,5.6
171,2005,December,Coke                                                 ,Not Adjusted,1239,1309,70,5.3
172,2005,March,Coleman                                              ,Not Adjusted,4089,4284,195,4.6
173,2005,June,Coleman                                              ,Not Adjusted,4228,4438,210,4.7
174,2005,September,Coleman                                              ,Not Adjusted,4103,4301,198,4.6
175,2005,December,Coleman                                              ,Not Adjusted,4018,4200,182,4.3
176,2005,March,Collin                                               ,Not Adjusted,346120,363588,17468,4.8
177,2005,June,Collin                                               ,Not Adjusted,350562,368251,17689,4.8
178,2005,September,Collin                                               ,Not Adjusted,352741,370670,17929,4.8
179,2005,December,Collin                                               ,Not Adjusted,355983,371854,15871,4.3
180,2005,March,Collingsworth                                        ,Not Adjusted,1452,1526,74,4.8
181,2005,June,Collingsworth                                        ,Not Adjusted,1592,1668,76,4.6
182,2005,September,Collingsworth                                        ,Not Adjusted,1599,1667,68,4.1
183,2005,December,Collingsworth                                        ,Not Adjusted,1539,1610,71,4.4
184,2005,March,Colorado                                             ,Not Adjusted,9532,9996,464,4.6
185,2005,June,Colorado                                             ,Not Adjusted,10210,10688,478,4.5
186,2005,September,Colorado                                             ,Not Adjusted,9856,10343,487,4.7
187,2005,December,Colorado                                             ,Not Adjusted,9819,10256,437,4.3
188,2005,March,Comal                                                ,Not Adjusted,46331,48617,2286,4.7
189,2005,June,Comal                                                ,Not Adjusted,46930,49196,2266,4.6
190,2005,September,Comal                                                ,Not Adjusted,47007,49214,2207,4.5
191,2005,December,Comal                                                ,Not Adjusted,47300,49293,1993,4.0
192,2005,March,Comanche                                             ,Not Adjusted,5970,6270,300,4.8
193,2005,June,Comanche                                             ,Not Adjusted,6271,6609,338,5.1
194,2005,September,Comanche                                             ,Not Adjusted,6219,6520,301,4.6
195,2005,December,Comanche                                             ,Not Adjusted,5992,6274,282,4.5
196,2005,March,Concho                                               ,Not Adjusted,1238,1317,79,6.0
197,2005,June,Concho                                               ,Not Adjusted,1352,1429,77,5.4
198,2005,September,Concho                                               ,Not Adjusted,1286,1369,83,6.1
199,2005,December,Concho                                               ,Not Adjusted,1264,1345,81,6.0
200,2005,March,Cooke                                                ,Not Adjusted,18675,19538,863,4.4
201,2005,June,Cooke                                                ,Not Adjusted,19381,20292,911,4.5
202,2005,September,Cooke                                                ,Not Adjusted,19311,20188,877,4.3
203,2005,December,Cooke                                                ,Not Adjusted,19322,20098,776,3.9
204,2005,March,Coryell                                              ,Not Adjusted,23840,25389,1549,6.1
205,2005,June,Coryell                                              ,Not Adjusted,23910,25599,1689,6.6
206,2005,September,Coryell                                              ,Not Adjusted,23857,25531,1674,6.6
207,2005,December,Coryell                                              ,Not Adjusted,23741,25266,1525,6.0
208,2005,March,Cottle                                               ,Not Adjusted,791,847,56,6.6
209,2005,June,Cottle                                               ,Not Adjusted,812,859,47,5.5
210,2005,September,Cottle                                               ,Not Adjusted,750,793,43,5.4
211,2005,December,Cottle                                               ,Not Adjusted,753,796,43,5.4
212,2005,March,Crane                                                ,Not Adjusted,1495,1584,89,5.6
213,2005,June,Crane                                                ,Not Adjusted,1475,1563,88,5.6
214,2005,September,Crane                                                ,Not Adjusted,1481,1559,78,5.0
215,2005,December,Crane                                                ,Not Adjusted,1570,1643,73,4.4
216,2005,March,Crockett                                             ,Not Adjusted,1884,1960,76,3.9
217,2005,June,Crockett                                             ,Not Adjusted,2025,2108,83,3.9
218,2005,September,Crockett                                             ,Not Adjusted,2007,2086,79,3.8
219,2005,December,Crockett                                             ,Not Adjusted,1928,1995,67,3.4
220,2005,March,Crosby                                               ,Not Adjusted,2772,2930,158,5.4
221,2005,June,Crosby                                               ,Not Adjusted,2750,2923,173,5.9
222,2005,September,Crosby                                               ,Not Adjusted,2778,2929,151,5.2
223,2005,December,Crosby                                               ,Not Adjusted,2790,2928,138,4.7
224,2005,March,Culberson                                            ,Not Adjusted,1571,1646,75,4.6
225,2005,June,Culberson                                            ,Not Adjusted,1600,1668,68,4.1
226,2005,September,Culberson                                            ,Not Adjusted,1641,1704,63,3.7
227,2005,December,Culberson                                            ,Not Adjusted,1558,1617,59,3.6
228,2005,March,Dallam                                               ,Not Adjusted,2888,2997,109,3.6
229,2005,June,Dallam                                               ,Not Adjusted,3068,3176,108,3.4
230,2005,September,Dallam                                               ,Not Adjusted,3005,3106,101,3.3
231,2005,December,Dallam                                               ,Not Adjusted,2898,2988,90,3.0
232,2005,March,Dallas                                               ,Not Adjusted,1064931,1130138,65207,5.8
233,2005,June,Dallas                                               ,Not Adjusted,1078600,1143654,65054,5.7
234,2005,September,Dallas                                               ,Not Adjusted,1085305,1154208,68903,6.0
235,2005,December,Dallas                                               ,Not Adjusted,1095275,1157275,62000,5.4
236,2005,March,Dawson                                               ,Not Adjusted,4792,5169,377,7.3
237,2005,June,Dawson                                               ,Not Adjusted,4990,5377,387,7.2
238,2005,September,Dawson                                               ,Not Adjusted,4719,5080,361,7.1
239,2005,December,Dawson                                               ,Not Adjusted,4723,5012,289,5.8
240,2005,March,Deaf Smith                                           ,Not Adjusted,7799,8190,391,4.8
241,2005,June,Deaf Smith                                           ,Not Adjusted,8134,8552,418,4.9
242,2005,September,Deaf Smith                                           ,Not Adjusted,7992,8376,384,4.6
243,2005,December,Deaf Smith                                           ,Not Adjusted,7887,8248,361,4.4
244,2005,March,Delta                                                ,Not Adjusted,2252,2400,148,6.2
245,2005,June,Delta                                                ,Not Adjusted,2281,2432,151,6.2
246,2005,September,Delta                                                ,Not Adjusted,2295,2418,123,5.1
247,2005,December,Delta                                                ,Not Adjusted,2317,2422,105,4.3
248,2005,March,Denton                                               ,Not Adjusted,296097,310683,14586,4.7
249,2005,June,Denton                                               ,Not Adjusted,299899,315422,15523,4.9
250,2005,September,Denton                                               ,Not Adjusted,301763,316651,14888,4.7
251,2005,December,Denton                                               ,Not Adjusted,304536,317696,13160,4.1
252,2005,March,DeWitt                                               ,Not Adjusted,8672,9115,443,4.9
253,2005,June,DeWitt                                               ,Not Adjusted,9002,9454,452,4.8
254,2005,September,DeWitt                                               ,Not Adjusted,8984,9408,424,4.5
255,2005,December,DeWitt                                               ,Not Adjusted,8952,9340,388,4.2
256,2005,March,Dickens                                              ,Not Adjusted,967,1027,60,5.8
257,2005,June,Dickens                                              ,Not Adjusted,1040,1097,57,5.2
258,2005,September,Dickens                                              ,Not Adjusted,1016,1070,54,5.0
259,2005,December,Dickens                                              ,Not Adjusted,1080,1127,47,4.2
260,2005,March,Dimmit                                               ,Not Adjusted,3502,3830,328,8.6
261,2005,June,Dimmit                                               ,Not Adjusted,3523,3859,336,8.7
262,2005,September,Dimmit                                               ,Not Adjusted,3473,3778,305,8.1
263,2005,December,Dimmit                                               ,Not Adjusted,3464,3777,313,8.3
264,2005,March,Donley                                               ,Not Adjusted,1687,1779,92,5.2
265,2005,June,Donley                                               ,Not Adjusted,1797,1899,102,5.4
266,2005,September,Donley                                               ,Not Adjusted,1695,1783,88,4.9
267,2005,December,Donley                                               ,Not Adjusted,1774,1853,79,4.3
268,2005,March,Duval                                                ,Not Adjusted,4895,5224,329,6.3
269,2005,June,Duval                                                ,Not Adjusted,4955,5312,357,6.7
270,2005,September,Duval                                                ,Not Adjusted,5034,5360,326,6.1
271,2005,December,Duval                                                ,Not Adjusted,4921,5211,290,5.6
272,2005,March,Eastland                                             ,Not Adjusted,7789,8237,448,5.4
273,2005,June,Eastland                                             ,Not Adjusted,8114,8614,500,5.8
274,2005,September,Eastland                                             ,Not Adjusted,8135,8567,432,5.0
275,2005,December,Eastland                                             ,Not Adjusted,8275,8676,401,4.6
276,2005,March,Ector                                                ,Not Adjusted,58726,61669,2943,4.8
277,2005,June,Ector                                                ,Not Adjusted,59086,62189,3103,5.0
278,2005,September,Ector                                                ,Not Adjusted,60247,63013,2766,4.4
279,2005,December,Ector                                                ,Not Adjusted,61512,63984,2472,3.9
280,2005,March,Edwards                                              ,Not Adjusted,964,1007,43,4.3
281,2005,June,Edwards                                              ,Not Adjusted,1022,1065,43,4.0
282,2005,September,Edwards                                              ,Not Adjusted,970,1010,40,4.0
283,2005,December,Edwards                                              ,Not Adjusted,945,986,41,4.2
284,2005,March,Ellis                                                ,Not Adjusted,62010,65614,3604,5.5
285,2005,June,Ellis                                                ,Not Adjusted,62805,66474,3669,5.5
286,2005,September,Ellis                                                ,Not Adjusted,63196,66770,3574,5.4
287,2005,December,Ellis                                                ,Not Adjusted,63776,67200,3424,5.1
288,2005,March,El Paso                                              ,Not Adjusted,268914,290550,21636,7.4
289,2005,June,El Paso                                              ,Not Adjusted,269576,291050,21474,7.4
290,2005,September,El Paso                                              ,Not Adjusted,272687,292801,20114,6.9
291,2005,December,El Paso                                              ,Not Adjusted,273313,291937,18624,6.4
292,2005,March,Erath                                                ,Not Adjusted,16341,17066,725,4.2
293,2005,June,Erath                                                ,Not Adjusted,17046,17867,821,4.6
294,2005,September,Erath                                                ,Not Adjusted,16999,17738,739,4.2
295,2005,December,Erath                                                ,Not Adjusted,17065,17727,662,3.7
296,2005,March,Falls                                                ,Not Adjusted,6829,7284,455,6.2
297,2005,June,Falls                                                ,Not Adjusted,6937,7423,486,6.5
298,2005,September,Falls                                                ,Not Adjusted,6810,7263,453,6.2
299,2005,December,Falls                                                ,Not Adjusted,6728,7141,413,5.8
300,2005,March,Fannin                                               ,Not Adjusted,12743,13626,883,6.5
301,2005,June,Fannin                                               ,Not Adjusted,13177,14051,874,6.2
302,2005,September,Fannin                                               ,Not Adjusted,12931,13890,959,6.9
303,2005,December,Fannin                                               ,Not Adjusted,12778,13680,902,6.6
304,2005,March,Fayette                                              ,Not Adjusted,11417,11881,464,3.9
305,2005,June,Fayette                                              ,Not Adjusted,11744,12251,507,4.1
306,2005,September,Fayette                                              ,Not Adjusted,11498,11975,477,4.0
307,2005,December,Fayette                                              ,Not Adjusted,11448,11878,430,3.6
308,2005,March,Fisher                                               ,Not Adjusted,1927,2018,91,4.5
309,2005,June,Fisher                                               ,Not Adjusted,1983,2077,94,4.5
310,2005,September,Fisher                                               ,Not Adjusted,1934,2017,83,4.1
311,2005,December,Fisher                                               ,Not Adjusted,1901,1978,77,3.9
312,2005,March,Floyd                                                ,Not Adjusted,2980,3182,202,6.3
313,2005,June,Floyd                                                ,Not Adjusted,3150,3362,212,6.3
314,2005,September,Floyd                                                ,Not Adjusted,3140,3313,173,5.2
315,2005,December,Floyd                                                ,Not Adjusted,2960,3121,161,5.2
316,2005,March,Foard                                                ,Not Adjusted,636,671,35,5.2
317,2005,June,Foard                                                ,Not Adjusted,669,707,38,5.4
318,2005,September,Foard                                                ,Not Adjusted,649,681,32,4.7
319,2005,December,Foard                                                ,Not Adjusted,634,666,32,4.8
320,2005,March,Fort Bend                                            ,Not Adjusted,221736,234144,12408,5.3
321,2005,June,Fort Bend                                            ,Not Adjusted,222702,235070,12368,5.3
322,2005,September,Fort Bend                                            ,Not Adjusted,224059,237803,13744,5.8
323,2005,December,Fort Bend                                            ,Not Adjusted,227171,238949,11778,4.9
324,2005,March,Franklin                                             ,Not Adjusted,4855,5112,257,5.0
325,2005,June,Franklin                                             ,Not Adjusted,5003,5269,266,5.0
326,2005,September,Franklin                                             ,Not Adjusted,4843,5109,266,5.2
327,2005,December,Franklin                                             ,Not Adjusted,5045,5277,232,4.4
328,2005,March,Freestone                                            ,Not Adjusted,9609,10034,425,4.2
329,2005,June,Freestone                                            ,Not Adjusted,9625,10087,462,4.6
330,2005,September,Freestone                                            ,Not Adjusted,9716,10165,449,4.4
331,2005,December,Freestone                                            ,Not Adjusted,9569,9958,389,3.9
332,2005,March,Frio                                                 ,Not Adjusted,5905,6302,397,6.3
333,2005,June,Frio                                                 ,Not Adjusted,6097,6527,430,6.6
334,2005,September,Frio                                                 ,Not Adjusted,6041,6429,388,6.0
335,2005,December,Frio                                                 ,Not Adjusted,5940,6288,348,5.5
336,2005,March,Gaines                                               ,Not Adjusted,6020,6352,332,5.2
337,2005,June,Gaines                                               ,Not Adjusted,6188,6512,324,5.0
338,2005,September,Gaines                                               ,Not Adjusted,5831,6110,279,4.6
339,2005,December,Gaines                                               ,Not Adjusted,5565,5813,248,4.3
340,2005,March,Galveston                                            ,Not Adjusted,129281,137008,7727,5.6
341,2005,June,Galveston                                            ,Not Adjusted,129845,138283,8438,6.1
342,2005,September,Galveston                                            ,Not Adjusted,130636,138987,8351,6.0
343,2005,December,Galveston                                            ,Not Adjusted,132450,139651,7201,5.2
344,2005,March,Garza                                                ,Not Adjusted,2210,2318,108,4.7
345,2005,June,Garza                                                ,Not Adjusted,2305,2421,116,4.8
346,2005,September,Garza                                                ,Not Adjusted,2310,2418,108,4.5
347,2005,December,Garza                                                ,Not Adjusted,2344,2441,97,4.0
348,2005,March,Gillespie                                            ,Not Adjusted,12017,12445,428,3.4
349,2005,June,Gillespie                                            ,Not Adjusted,12887,13339,452,3.4
350,2005,September,Gillespie                                            ,Not Adjusted,12278,12732,454,3.6
351,2005,December,Gillespie                                            ,Not Adjusted,12317,12705,388,3.1
352,2005,March,Glasscock                                            ,Not Adjusted,595,621,26,4.2
353,2005,June,Glasscock                                            ,Not Adjusted,647,674,27,4.0
354,2005,September,Glasscock                                            ,Not Adjusted,610,634,24,3.8
355,2005,December,Glasscock                                            ,Not Adjusted,584,607,23,3.8
356,2005,March,Goliad                                               ,Not Adjusted,3206,3366,160,4.8
357,2005,June,Goliad                                               ,Not Adjusted,3264,3435,171,5.0
358,2005,September,Goliad                                               ,Not Adjusted,3232,3404,172,5.1
359,2005,December,Goliad                                               ,Not Adjusted,3244,3409,165,4.8
360,2005,March,Gonzales                                             ,Not Adjusted,9050,9456,406,4.3
361,2005,June,Gonzales                                             ,Not Adjusted,9398,9825,427,4.3
362,2005,September,Gonzales                                             ,Not Adjusted,9251,9655,404,4.2
363,2005,December,Gonzales                                             ,Not Adjusted,9281,9649,368,3.8
364,2005,March,Gray                                                 ,Not Adjusted,10232,10705,473,4.4
365,2005,June,Gray                                                 ,Not Adjusted,10521,11009,488,4.4
366,2005,September,Gray                                                 ,Not Adjusted,10549,11017,468,4.2
367,2005,December,Gray                                                 ,Not Adjusted,10368,10768,400,3.7
368,2005,March,Grayson                                              ,Not Adjusted,53219,56375,3156,5.6
369,2005,June,Grayson                                              ,Not Adjusted,53722,56904,3182,5.6
370,2005,September,Grayson                                              ,Not Adjusted,53645,56742,3097,5.5
371,2005,December,Grayson                                              ,Not Adjusted,53935,56712,2777,4.9
372,2005,March,Gregg                                                ,Not Adjusted,57453,60473,3020,5.0
373,2005,June,Gregg                                                ,Not Adjusted,57905,60920,3015,4.9
374,2005,September,Gregg                                                ,Not Adjusted,57914,60962,3048,5.0
375,2005,December,Gregg                                                ,Not Adjusted,57942,60710,2768,4.6
376,2005,March,Grimes                                               ,Not Adjusted,9474,10091,617,6.1
377,2005,June,Grimes                                               ,Not Adjusted,9629,10304,675,6.6
378,2005,September,Grimes                                               ,Not Adjusted,9730,10369,639,6.2
379,2005,December,Grimes                                               ,Not Adjusted,9658,10241,583,5.7
380,2005,March,Guadalupe                                            ,Not Adjusted,49000,51513,2513,4.9
381,2005,June,Guadalupe                                            ,Not Adjusted,49635,52212,2577,4.9
382,2005,September,Guadalupe                                            ,Not Adjusted,49716,52115,2399,4.6
383,2005,December,Guadalupe                                            ,Not Adjusted,50026,52161,2135,4.1
384,2005,March,Hale                                                 ,Not Adjusted,15630,16553,923,5.6
385,2005,June,Hale                                                 ,Not Adjusted,16037,17090,1053,6.2
386,2005,September,Hale                                                 ,Not Adjusted,15999,16834,835,5.0
387,2005,December,Hale                                                 ,Not Adjusted,15627,16415,788,4.8
388,2005,March,Hall                                                 ,Not Adjusted,1419,1522,103,6.8
389,2005,June,Hall                                                 ,Not Adjusted,1505,1596,91,5.7
390,2005,September,Hall                                                 ,Not Adjusted,1538,1629,91,5.6
391,2005,December,Hall                                                 ,Not Adjusted,1514,1602,88,5.5
392,2005,March,Hamilton                                             ,Not Adjusted,3670,3854,184,4.8
393,2005,June,Hamilton                                             ,Not Adjusted,3794,3992,198,5.0
394,2005,September,Hamilton                                             ,Not Adjusted,3866,4046,180,4.4
395,2005,December,Hamilton                                             ,Not Adjusted,3742,3914,172,4.4
396,2005,March,Hansford                                             ,Not Adjusted,2288,2379,91,3.8
397,2005,June,Hansford                                             ,Not Adjusted,2469,2563,94,3.7
398,2005,September,Hansford                                             ,Not Adjusted,2411,2499,88,3.5
399,2005,December,Hansford                                             ,Not Adjusted,2300,2381,81,3.4
400,2005,March,Hardeman                                             ,Not Adjusted,2091,2193,102,4.7
401,2005,June,Hardeman                                             ,Not Adjusted,2212,2329,117,5.0
402,2005,September,Hardeman                                             ,Not Adjusted,2257,2365,108,4.6
403,2005,December,Hardeman                                             ,Not Adjusted,2214,2311,97,4.2
404,2005,March,Hardin                                               ,Not Adjusted,23101,24628,1527,6.2
405,2005,June,Hardin                                               ,Not Adjusted,23275,24927,1652,6.6
406,2005,September,Hardin                                               ,Not Adjusted,23178,24751,1573,6.4
407,2005,December,Hardin                                               ,Not Adjusted,23370,24860,1490,6.0
408,2005,March,Harris                                               ,Not Adjusted,1712638,1813301,100663,5.6
409,2005,June,Harris                                               ,Not Adjusted,1720113,1823145,103032,5.7
410,2005,September,Harris                                               ,Not Adjusted,1730582,1849487,118905,6.4
411,2005,December,Harris                                               ,Not Adjusted,1754620,1859436,104816,5.6
412,2005,March,Harrison                                             ,Not Adjusted,29433,31224,1791,5.7
413,2005,June,Harrison                                             ,Not Adjusted,29249,31045,1796,5.8
414,2005,September,Harrison                                             ,Not Adjusted,29744,31602,1858,5.9
415,2005,December,Harrison                                             ,Not Adjusted,29572,31190,1618,5.2
416,2005,March,Hartley                                              ,Not Adjusted,2121,2208,87,3.9
417,2005,June,Hartley                                              ,Not Adjusted,2255,2348,93,4.0
418,2005,September,Hartley                                              ,Not Adjusted,2209,2305,96,4.2
419,2005,December,Hartley                                              ,Not Adjusted,2129,2208,79,3.6
420,2005,March,Haskell                                              ,Not Adjusted,3015,3142,127,4.0
421,2005,June,Haskell                                              ,Not Adjusted,3023,3145,122,3.9
422,2005,September,Haskell                                              ,Not Adjusted,3050,3166,116,3.7
423,2005,December,Haskell                                              ,Not Adjusted,2964,3064,100,3.3
424,2005,March,Hays                                                 ,Not Adjusted,63510,66499,2989,4.5
425,2005,June,Hays                                                 ,Not Adjusted,64260,67599,3339,4.9
426,2005,September,Hays                                                 ,Not Adjusted,64275,67349,3074,4.6
427,2005,December,Hays                                                 ,Not Adjusted,64865,67637,2772,4.1
428,2005,March,Hemphill                                             ,Not Adjusted,2041,2113,72,3.4
429,2005,June,Hemphill                                             ,Not Adjusted,2326,2396,70,2.9
430,2005,September,Hemphill                                             ,Not Adjusted,2249,2312,63,2.7
431,2005,December,Hemphill                                             ,Not Adjusted,2203,2260,57,2.5
432,2005,March,Henderson                                            ,Not Adjusted,32366,34496,2130,6.2
433,2005,June,Henderson                                            ,Not Adjusted,32748,34790,2042,5.9
434,2005,September,Henderson                                            ,Not Adjusted,32749,34723,1974,5.7
435,2005,December,Henderson                                            ,Not Adjusted,32519,34289,1770,5.2
436,2005,March,Hidalgo                                              ,Not Adjusted,239324,261732,22408,8.6
437,2005,June,Hidalgo                                              ,Not Adjusted,241201,263121,21920,8.3
438,2005,September,Hidalgo                                              ,Not Adjusted,240216,259745,19529,7.5
439,2005,December,Hidalgo                                              ,Not Adjusted,245820,265764,19944,7.5
440,2005,March,Hill                                                 ,Not Adjusted,14261,15281,1020,6.7
441,2005,June,Hill                                                 ,Not Adjusted,14512,15540,1028,6.6
442,2005,September,Hill                                                 ,Not Adjusted,14354,15313,959,6.3
443,2005,December,Hill                                                 ,Not Adjusted,14378,15238,860,5.6
444,2005,March,Hockley                                              ,Not Adjusted,10497,11008,511,4.6
445,2005,June,Hockley                                              ,Not Adjusted,10555,11115,560,5.0
446,2005,September,Hockley                                              ,Not Adjusted,10602,11091,489,4.4
447,2005,December,Hockley                                              ,Not Adjusted,10507,10954,447,4.1
448,2005,March,Hood                                                 ,Not Adjusted,21161,22352,1191,5.3
449,2005,June,Hood                                                 ,Not Adjusted,21775,23026,1251,5.4
450,2005,September,Hood                                                 ,Not Adjusted,21565,22754,1189,5.2
451,2005,December,Hood                                                 ,Not Adjusted,21609,22694,1085,4.8
452,2005,March,Hopkins                                              ,Not Adjusted,16400,17231,831,4.8
453,2005,June,Hopkins                                              ,Not Adjusted,16821,17652,831,4.7
454,2005,September,Hopkins                                              ,Not Adjusted,16707,17521,814,4.6
455,2005,December,Hopkins                                              ,Not Adjusted,16727,17452,725,4.2
456,2005,March,Houston                                              ,Not Adjusted,7862,8397,535,6.4
457,2005,June,Houston                                              ,Not Adjusted,8091,8674,583,6.7
458,2005,September,Houston                                              ,Not Adjusted,7918,8479,561,6.6
459,2005,December,Houston                                              ,Not Adjusted,7788,8302,514,6.2
460,2005,March,Howard                                               ,Not Adjusted,12442,13182,740,5.6
461,2005,June,Howard                                               ,Not Adjusted,12689,13448,759,5.6
462,2005,September,Howard                                               ,Not Adjusted,12694,13387,693,5.2
463,2005,December,Howard                                               ,Not Adjusted,12729,13378,649,4.9
464,2005,March,Hudspeth                                             ,Not Adjusted,1184,1273,89,7.0
465,2005,June,Hudspeth                                             ,Not Adjusted,1291,1370,79,5.8
466,2005,September,Hudspeth                                             ,Not Adjusted,1234,1321,87,6.6
467,2005,December,Hudspeth                                             ,Not Adjusted,1204,1326,122,9.2
468,2005,March,Hunt                                                 ,Not Adjusted,35974,38286,2312,6.0
469,2005,June,Hunt                                                 ,Not Adjusted,36437,38628,2191,5.7
470,2005,September,Hunt                                                 ,Not Adjusted,36664,38716,2052,5.3
471,2005,December,Hunt                                                 ,Not Adjusted,37000,38953,1953,5.0
472,2005,March,Hutchinson                                           ,Not Adjusted,9579,10109,530,5.2
473,2005,June,Hutchinson                                           ,Not Adjusted,9703,10279,576,5.6
474,2005,September,Hutchinson                                           ,Not Adjusted,9863,10372,509,4.9
475,2005,December,Hutchinson                                           ,Not Adjusted,9931,10370,439,4.2
476,2005,March,Irion                                                ,Not Adjusted,923,955,32,3.4
477,2005,June,Irion                                                ,Not Adjusted,929,971,42,4.3
478,2005,September,Irion                                                ,Not Adjusted,924,958,34,3.5
479,2005,December,Irion                                                ,Not Adjusted,926,952,26,2.7
480,2005,March,Jack                                                 ,Not Adjusted,3811,4006,195,4.9
481,2005,June,Jack                                                 ,Not Adjusted,3936,4144,208,5.0
482,2005,September,Jack                                                 ,Not Adjusted,3922,4113,191,4.6
483,2005,December,Jack                                                 ,Not Adjusted,3931,4092,161,3.9
484,2005,March,Jackson                                              ,Not Adjusted,6187,6512,325,5.0
485,2005,June,Jackson                                              ,Not Adjusted,6361,6714,353,5.3
486,2005,September,Jackson                                              ,Not Adjusted,6327,6667,340,5.1
487,2005,December,Jackson                                              ,Not Adjusted,6303,6589,286,4.3
488,2005,March,Jasper                                               ,Not Adjusted,14186,15401,1215,7.9
489,2005,June,Jasper                                               ,Not Adjusted,14563,15781,1218,7.7
490,2005,September,Jasper                                               ,Not Adjusted,14594,15737,1143,7.3
491,2005,December,Jasper                                               ,Not Adjusted,14389,15547,1158,7.4
492,2005,March,Jeff Davis                                           ,Not Adjusted,1158,1209,51,4.2
493,2005,June,Jeff Davis                                           ,Not Adjusted,1220,1268,48,3.8
494,2005,September,Jeff Davis                                           ,Not Adjusted,1134,1181,47,4.0
495,2005,December,Jeff Davis                                           ,Not Adjusted,1136,1180,44,3.7
496,2005,March,Jefferson                                            ,Not Adjusted,103345,111225,7880,7.1
497,2005,June,Jefferson                                            ,Not Adjusted,104125,112410,8285,7.4
498,2005,September,Jefferson                                            ,Not Adjusted,103691,112313,8622,7.7
499,2005,December,Jefferson                                            ,Not Adjusted,104546,113263,8717,7.7
500,2005,March,Jim Hogg                                             ,Not Adjusted,2467,2593,126,4.9
501,2005,June,Jim Hogg                                             ,Not Adjusted,2449,2587,138,5.3
502,2005,September,Jim Hogg                                             ,Not Adjusted,2508,2638,130,4.9
503,2005,December,Jim Hogg                                             ,Not Adjusted,2511,2629,118,4.5
504,2005,March,Jim Wells                                            ,Not Adjusted,18605,19741,1136,5.8
505,2005,June,Jim Wells                                            ,Not Adjusted,18763,19966,1203,6.0
506,2005,September,Jim Wells                                            ,Not Adjusted,18931,19993,1062,5.3
507,2005,December,Jim Wells                                            ,Not Adjusted,18749,19720,971,4.9
508,2005,March,Johnson                                              ,Not Adjusted,68132,71866,3734,5.2
509,2005,June,Johnson                                              ,Not Adjusted,68813,72578,3765,5.2
510,2005,September,Johnson                                              ,Not Adjusted,69095,72596,3501,4.8
511,2005,December,Johnson                                              ,Not Adjusted,69575,72737,3162,4.3
512,2005,March,Jones                                                ,Not Adjusted,7344,7787,443,5.7
513,2005,June,Jones                                                ,Not Adjusted,7423,7894,471,6.0
514,2005,September,Jones                                                ,Not Adjusted,7551,7979,428,5.4
515,2005,December,Jones                                                ,Not Adjusted,7538,7923,385,4.9
516,2005,March,Karnes                                               ,Not Adjusted,5144,5485,341,6.2
517,2005,June,Karnes                                               ,Not Adjusted,5149,5531,382,6.9
518,2005,September,Karnes                                               ,Not Adjusted,5075,5429,354,6.5
519,2005,December,Karnes                                               ,Not Adjusted,5030,5344,314,5.9
520,2005,March,Kaufman                                              ,Not Adjusted,40156,42639,2483,5.8
521,2005,June,Kaufman                                              ,Not Adjusted,40671,43096,2425,5.6
522,2005,September,Kaufman                                              ,Not Adjusted,40924,43301,2377,5.5
523,2005,December,Kaufman                                              ,Not Adjusted,41300,43505,2205,5.1
524,2005,March,Kendall                                              ,Not Adjusted,13615,14214,599,4.2
525,2005,June,Kendall                                              ,Not Adjusted,13791,14416,625,4.3
526,2005,September,Kendall                                              ,Not Adjusted,13814,14443,629,4.4
527,2005,December,Kendall                                              ,Not Adjusted,13900,14445,545,3.8
528,2005,March,Kenedy                                               ,Not Adjusted,243,251,8,3.2
529,2005,June,Kenedy                                               ,Not Adjusted,243,250,7,2.8
530,2005,September,Kenedy                                               ,Not Adjusted,241,247,6,2.4
531,2005,December,Kenedy                                               ,Not Adjusted,239,244,5,2.0
532,2005,March,Kent                                                 ,Not Adjusted,423,442,19,4.3
533,2005,June,Kent                                                 ,Not Adjusted,448,467,19,4.1
534,2005,September,Kent                                                 ,Not Adjusted,413,431,18,4.2
535,2005,December,Kent                                                 ,Not Adjusted,381,400,19,4.8
536,2005,March,Kerr                                                 ,Not Adjusted,21593,22532,939,4.2
537,2005,June,Kerr                                                 ,Not Adjusted,22259,23235,976,4.2
538,2005,September,Kerr                                                 ,Not Adjusted,21267,22215,948,4.3
539,2005,December,Kerr                                                 ,Not Adjusted,21502,22350,848,3.8
540,2005,March,Kimble                                               ,Not Adjusted,2195,2292,97,4.2
541,2005,June,Kimble                                               ,Not Adjusted,2222,2321,99,4.3
542,2005,September,Kimble                                               ,Not Adjusted,2150,2242,92,4.1
543,2005,December,Kimble                                               ,Not Adjusted,2099,2183,84,3.8
544,2005,March,King                                                 ,Not Adjusted,148,155,7,4.5
545,2005,June,King                                                 ,Not Adjusted,173,180,7,3.9
546,2005,September,King                                                 ,Not Adjusted,166,172,6,3.5
547,2005,December,King                                                 ,Not Adjusted,152,158,6,3.8
548,2005,March,Kinney                                               ,Not Adjusted,1319,1418,99,7.0
549,2005,June,Kinney                                               ,Not Adjusted,1362,1445,83,5.7
550,2005,September,Kinney                                               ,Not Adjusted,1356,1434,78,5.4
551,2005,December,Kinney                                               ,Not Adjusted,1378,1462,84,5.7
552,2005,March,Kleberg                                              ,Not Adjusted,15574,16457,883,5.4
553,2005,June,Kleberg                                              ,Not Adjusted,15626,16547,921,5.6
554,2005,September,Kleberg                                              ,Not Adjusted,15446,16270,824,5.1
555,2005,December,Kleberg                                              ,Not Adjusted,15285,16023,738,4.6
556,2005,March,Knox                                                 ,Not Adjusted,1636,1732,96,5.5
557,2005,June,Knox                                                 ,Not Adjusted,1752,1844,92,5.0
558,2005,September,Knox                                                 ,Not Adjusted,1745,1823,78,4.3
559,2005,December,Knox                                                 ,Not Adjusted,1668,1739,71,4.1
560,2005,March,Lamar                                                ,Not Adjusted,21133,22631,1498,6.6
561,2005,June,Lamar                                                ,Not Adjusted,21806,23307,1501,6.4
562,2005,September,Lamar                                                ,Not Adjusted,21762,23181,1419,6.1
563,2005,December,Lamar                                                ,Not Adjusted,21536,22815,1279,5.6
564,2005,March,Lamb                                                 ,Not Adjusted,6750,7159,409,5.7
565,2005,June,Lamb                                                 ,Not Adjusted,7009,7383,374,5.1
566,2005,September,Lamb                                                 ,Not Adjusted,6854,7192,338,4.7
567,2005,December,Lamb                                                 ,Not Adjusted,6708,7000,292,4.2
568,2005,March,Lampasas                                             ,Not Adjusted,9512,9959,447,4.5
569,2005,June,Lampasas                                             ,Not Adjusted,9540,10011,471,4.7
570,2005,September,Lampasas                                             ,Not Adjusted,9520,9937,417,4.2
571,2005,December,Lampasas                                             ,Not Adjusted,9473,9867,394,4.0
572,2005,March,La Salle                                             ,Not Adjusted,2446,2596,150,5.8
573,2005,June,La Salle                                             ,Not Adjusted,2492,2653,161,6.1
574,2005,September,La Salle                                             ,Not Adjusted,2444,2592,148,5.7
575,2005,December,La Salle                                             ,Not Adjusted,2399,2528,129,5.1
576,2005,March,Lavaca                                               ,Not Adjusted,9783,10166,383,3.8
577,2005,June,Lavaca                                               ,Not Adjusted,10184,10588,404,3.8
578,2005,September,Lavaca                                               ,Not Adjusted,9984,10365,381,3.7
579,2005,December,Lavaca                                               ,Not Adjusted,9997,10330,333,3.2
580,2005,March,Lee                                                  ,Not Adjusted,8029,8416,387,4.6
581,2005,June,Lee                                                  ,Not Adjusted,8409,8818,409,4.6
582,2005,September,Lee                                                  ,Not Adjusted,8305,8696,391,4.5
583,2005,December,Lee                                                  ,Not Adjusted,8346,8699,353,4.1
584,2005,March,Leon                                                 ,Not Adjusted,7147,7572,425,5.6
585,2005,June,Leon                                                 ,Not Adjusted,7290,7752,462,6.0
586,2005,September,Leon                                                 ,Not Adjusted,7415,7854,439,5.6
587,2005,December,Leon                                                 ,Not Adjusted,7259,7660,401,5.2
588,2005,March,Liberty                                              ,Not Adjusted,29035,31103,2068,6.6
589,2005,June,Liberty                                              ,Not Adjusted,29162,31485,2323,7.4
590,2005,September,Liberty                                              ,Not Adjusted,29339,31410,2071,6.6
591,2005,December,Liberty                                              ,Not Adjusted,29747,31615,1868,5.9
592,2005,March,Limestone                                            ,Not Adjusted,9797,10334,537,5.2
593,2005,June,Limestone                                            ,Not Adjusted,10038,10602,564,5.3
594,2005,September,Limestone                                            ,Not Adjusted,9835,10364,529,5.1
595,2005,December,Limestone                                            ,Not Adjusted,9686,10145,459,4.5
596,2005,March,Lipscomb                                             ,Not Adjusted,1550,1609,59,3.7
597,2005,June,Lipscomb                                             ,Not Adjusted,1604,1665,61,3.7
598,2005,September,Lipscomb                                             ,Not Adjusted,1578,1638,60,3.7
599,2005,December,Lipscomb                                             ,Not Adjusted,1689,1740,51,2.9
600,2005,March,Live Oak                                             ,Not Adjusted,4799,5067,268,5.3
601,2005,June,Live Oak                                             ,Not Adjusted,4877,5143,266,5.2
602,2005,September,Live Oak                                             ,Not Adjusted,4759,5021,262,5.2
603,2005,December,Live Oak                                             ,Not Adjusted,4702,4920,218,4.4
604,2005,March,Llano                                                ,Not Adjusted,7544,7967,423,5.3
605,2005,June,Llano                                                ,Not Adjusted,7770,8190,420,5.1
606,2005,September,Llano                                                ,Not Adjusted,7644,8064,420,5.2
607,2005,December,Llano                                                ,Not Adjusted,7656,8015,359,4.5
608,2005,March,Loving                                               ,Not Adjusted,35,39,4,10.3
609,2005,June,Loving                                               ,Not Adjusted,32,36,4,11.1
610,2005,September,Loving                                               ,Not Adjusted,36,40,4,10.0
611,2005,December,Loving                                               ,Not Adjusted,38,42,4,9.5
612,2005,March,Lubbock                                              ,Not Adjusted,132061,137668,5607,4.1
613,2005,June,Lubbock                                              ,Not Adjusted,130967,137411,6444,4.7
614,2005,September,Lubbock                                              ,Not Adjusted,132318,137887,5569,4.0
615,2005,December,Lubbock                                              ,Not Adjusted,132891,137913,5022,3.6
616,2005,March,Lynn                                                 ,Not Adjusted,2614,2788,174,6.2
617,2005,June,Lynn                                                 ,Not Adjusted,2725,2908,183,6.3
618,2005,September,Lynn                                                 ,Not Adjusted,2705,2867,162,5.7
619,2005,December,Lynn                                                 ,Not Adjusted,2566,2695,129,4.8
620,2005,March,McCulloch                                            ,Not Adjusted,3472,3666,194,5.3
621,2005,June,McCulloch                                            ,Not Adjusted,3605,3805,200,5.3
622,2005,September,McCulloch                                            ,Not Adjusted,3611,3791,180,4.7
623,2005,December,McCulloch                                            ,Not Adjusted,3613,3783,170,4.5
624,2005,March,McLennan                                             ,Not Adjusted,106889,112465,5576,5.0
625,2005,June,McLennan                                             ,Not Adjusted,107233,113558,6325,5.6
626,2005,September,McLennan                                             ,Not Adjusted,106668,112310,5642,5.0
627,2005,December,McLennan                                             ,Not Adjusted,106527,111765,5238,4.7
628,2005,March,McMullen                                             ,Not Adjusted,356,378,22,5.8
629,2005,June,McMullen                                             ,Not Adjusted,374,395,21,5.3
630,2005,September,McMullen                                             ,Not Adjusted,352,371,19,5.1
631,2005,December,McMullen                                             ,Not Adjusted,360,377,17,4.5
632,2005,March,Madison                                              ,Not Adjusted,4607,4896,289,5.9
633,2005,June,Madison                                              ,Not Adjusted,4674,4983,309,6.2
634,2005,September,Madison                                              ,Not Adjusted,4667,4963,296,6.0
635,2005,December,Madison                                              ,Not Adjusted,4609,4863,254,5.2
636,2005,March,Marion                                               ,Not Adjusted,4692,4997,305,6.1
637,2005,June,Marion                                               ,Not Adjusted,4832,5124,292,5.7
638,2005,September,Marion                                               ,Not Adjusted,4833,5132,299,5.8
639,2005,December,Marion                                               ,Not Adjusted,4824,5097,273,5.4
640,2005,March,Martin                                               ,Not Adjusted,1919,2016,97,4.8
641,2005,June,Martin                                               ,Not Adjusted,2063,2162,99,4.6
642,2005,September,Martin                                               ,Not Adjusted,2062,2153,91,4.2
643,2005,December,Martin                                               ,Not Adjusted,2020,2105,85,4.0
644,2005,March,Mason                                                ,Not Adjusted,2247,2319,72,3.1
645,2005,June,Mason                                                ,Not Adjusted,2361,2438,77,3.2
646,2005,September,Mason                                                ,Not Adjusted,2343,2414,71,2.9
647,2005,December,Mason                                                ,Not Adjusted,2298,2362,64,2.7
648,2005,March,Matagorda                                            ,Not Adjusted,15026,16313,1287,7.9
649,2005,June,Matagorda                                            ,Not Adjusted,15350,16822,1472,8.8
650,2005,September,Matagorda                                            ,Not Adjusted,14938,16284,1346,8.3
651,2005,December,Matagorda                                            ,Not Adjusted,14787,16022,1235,7.7
652,2005,March,Maverick                                             ,Not Adjusted,16677,20082,3405,17.0
653,2005,June,Maverick                                             ,Not Adjusted,16576,18869,2293,12.2
654,2005,September,Maverick                                             ,Not Adjusted,16653,18311,1658,9.1
655,2005,December,Maverick                                             ,Not Adjusted,16853,19367,2514,13.0
656,2005,March,Medina                                               ,Not Adjusted,18347,19342,995,5.1
657,2005,June,Medina                                               ,Not Adjusted,18583,19559,976,5.0
658,2005,September,Medina                                               ,Not Adjusted,18614,19567,953,4.9
659,2005,December,Medina                                               ,Not Adjusted,18731,19655,924,4.7
660,2005,March,Menard                                               ,Not Adjusted,1005,1056,51,4.8
661,2005,June,Menard                                               ,Not Adjusted,1063,1120,57,5.1
662,2005,September,Menard                                               ,Not Adjusted,1032,1083,51,4.7
663,2005,December,Menard                                               ,Not Adjusted,1033,1077,44,4.1
664,2005,March,Midland                                              ,Not Adjusted,62855,65393,2538,3.9
665,2005,June,Midland                                              ,Not Adjusted,63565,66232,2667,4.0
666,2005,September,Midland                                              ,Not Adjusted,64921,67398,2477,3.7
667,2005,December,Midland                                              ,Not Adjusted,66045,68233,2188,3.2
668,2005,March,Milam                                                ,Not Adjusted,11495,12130,635,5.2
669,2005,June,Milam                                                ,Not Adjusted,11678,12324,646,5.2
670,2005,September,Milam                                                ,Not Adjusted,11609,12243,634,5.2
671,2005,December,Milam                                                ,Not Adjusted,11416,12015,599,5.0
672,2005,March,Mills                                                ,Not Adjusted,2362,2465,103,4.2
673,2005,June,Mills                                                ,Not Adjusted,2526,2640,114,4.3
674,2005,September,Mills                                                ,Not Adjusted,2463,2559,96,3.8
675,2005,December,Mills                                                ,Not Adjusted,2450,2536,86,3.4
676,2005,March,Mitchell                                             ,Not Adjusted,3140,3368,228,6.8
677,2005,June,Mitchell                                             ,Not Adjusted,3202,3427,225,6.6
678,2005,September,Mitchell                                             ,Not Adjusted,3166,3371,205,6.1
679,2005,December,Mitchell                                             ,Not Adjusted,3110,3299,189,5.7
680,2005,March,Montague                                             ,Not Adjusted,9244,9690,446,4.6
681,2005,June,Montague                                             ,Not Adjusted,9426,9873,447,4.5
682,2005,September,Montague                                             ,Not Adjusted,9391,9815,424,4.3
683,2005,December,Montague                                             ,Not Adjusted,9351,9755,404,4.1
684,2005,March,Montgomery                                           ,Not Adjusted,179340,188569,9229,4.9
685,2005,June,Montgomery                                           ,Not Adjusted,180122,189454,9332,4.9
686,2005,September,Montgomery                                           ,Not Adjusted,181218,190560,9342,4.9
687,2005,December,Montgomery                                           ,Not Adjusted,183736,191891,8155,4.2
688,2005,March,Moore                                                ,Not Adjusted,9672,10093,421,4.2
689,2005,June,Moore                                                ,Not Adjusted,10002,10417,415,4.0
690,2005,September,Moore                                                ,Not Adjusted,9835,10212,377,3.7
691,2005,December,Moore                                                ,Not Adjusted,9888,10221,333,3.3
692,2005,March,Morris                                               ,Not Adjusted,5650,6041,391,6.5
693,2005,June,Morris                                               ,Not Adjusted,5819,6220,401,6.4
694,2005,September,Morris                                               ,Not Adjusted,5788,6160,372,6.0
695,2005,December,Morris                                               ,Not Adjusted,5750,6076,326,5.4
696,2005,March,Motley                                               ,Not Adjusted,619,650,31,4.8
697,2005,June,Motley                                               ,Not Adjusted,669,695,26,3.7
698,2005,September,Motley                                               ,Not Adjusted,647,674,27,4.0
699,2005,December,Motley                                               ,Not Adjusted,617,646,29,4.5
700,2005,March,Nacogdoches                                          ,Not Adjusted,29225,30797,1572,5.1
701,2005,June,Nacogdoches                                          ,Not Adjusted,29665,31459,1794,5.7
702,2005,September,Nacogdoches                                          ,Not Adjusted,29596,31295,1699,5.4
703,2005,December,Nacogdoches                                          ,Not Adjusted,29415,30918,1503,4.9
704,2005,March,Navarro                                              ,Not Adjusted,19848,21169,1321,6.2
705,2005,June,Navarro                                              ,Not Adjusted,20362,21673,1311,6.0
706,2005,September,Navarro                                              ,Not Adjusted,20209,21445,1236,5.8
707,2005,December,Navarro                                              ,Not Adjusted,20562,21666,1104,5.1
708,2005,March,Newton                                               ,Not Adjusted,5181,5686,505,8.9
709,2005,June,Newton                                               ,Not Adjusted,5349,5885,536,9.1
710,2005,September,Newton                                               ,Not Adjusted,5340,5858,518,8.8
711,2005,December,Newton                                               ,Not Adjusted,5329,5810,481,8.3
712,2005,March,Nolan                                                ,Not Adjusted,7245,7613,368,4.8
713,2005,June,Nolan                                                ,Not Adjusted,7224,7625,401,5.3
714,2005,September,Nolan                                                ,Not Adjusted,7255,7622,367,4.8
715,2005,December,Nolan                                                ,Not Adjusted,7170,7498,328,4.4
716,2005,March,Nueces                                               ,Not Adjusted,149000,157696,8696,5.5
717,2005,June,Nueces                                               ,Not Adjusted,148980,158101,9121,5.8
718,2005,September,Nueces                                               ,Not Adjusted,147791,156494,8703,5.6
719,2005,December,Nueces                                               ,Not Adjusted,147782,155552,7770,5.0
720,2005,March,Ochiltree                                            ,Not Adjusted,4635,4797,162,3.4
721,2005,June,Ochiltree                                            ,Not Adjusted,4994,5166,172,3.3
722,2005,September,Ochiltree                                            ,Not Adjusted,5055,5214,159,3.0
723,2005,December,Ochiltree                                            ,Not Adjusted,4898,5045,147,2.9
724,2005,March,Oldham                                               ,Not Adjusted,1013,1050,37,3.5
725,2005,June,Oldham                                               ,Not Adjusted,1036,1082,46,4.3
726,2005,September,Oldham                                               ,Not Adjusted,1013,1053,40,3.8
727,2005,December,Oldham                                               ,Not Adjusted,1017,1054,37,3.5
728,2005,March,Orange                                               ,Not Adjusted,37698,40618,2920,7.2
729,2005,June,Orange                                               ,Not Adjusted,37982,41210,3228,7.8
730,2005,September,Orange                                               ,Not Adjusted,37824,40847,3023,7.4
731,2005,December,Orange                                               ,Not Adjusted,38135,41221,3086,7.5
732,2005,March,Palo Pinto                                           ,Not Adjusted,13234,13898,664,4.8
733,2005,June,Palo Pinto                                           ,Not Adjusted,13757,14424,667,4.6
734,2005,September,Palo Pinto                                           ,Not Adjusted,13960,14582,622,4.3
735,2005,December,Palo Pinto                                           ,Not Adjusted,13752,14352,600,4.2
736,2005,March,Panola                                               ,Not Adjusted,10771,11354,583,5.1
737,2005,June,Panola                                               ,Not Adjusted,11130,11725,595,5.1
738,2005,September,Panola                                               ,Not Adjusted,11219,11821,602,5.1
739,2005,December,Panola                                               ,Not Adjusted,11165,11694,529,4.5
740,2005,March,Parker                                               ,Not Adjusted,47953,50433,2480,4.9
741,2005,June,Parker                                               ,Not Adjusted,48433,51091,2658,5.2
742,2005,September,Parker                                               ,Not Adjusted,48630,50992,2362,4.6
743,2005,December,Parker                                               ,Not Adjusted,48970,51130,2160,4.2
744,2005,March,Parmer                                               ,Not Adjusted,4316,4509,193,4.3
745,2005,June,Parmer                                               ,Not Adjusted,4524,4719,195,4.1
746,2005,September,Parmer                                               ,Not Adjusted,4430,4610,180,3.9
747,2005,December,Parmer                                               ,Not Adjusted,4303,4467,164,3.7
748,2005,March,Pecos                                                ,Not Adjusted,6195,6567,372,5.7
749,2005,June,Pecos                                                ,Not Adjusted,6604,6978,374,5.4
750,2005,September,Pecos                                                ,Not Adjusted,6284,6609,325,4.9
751,2005,December,Pecos                                                ,Not Adjusted,6297,6592,295,4.5
752,2005,March,Polk                                                 ,Not Adjusted,15631,16767,1136,6.8
753,2005,June,Polk                                                 ,Not Adjusted,15705,16897,1192,7.1
754,2005,September,Polk                                                 ,Not Adjusted,15378,16538,1160,7.0
755,2005,December,Polk                                                 ,Not Adjusted,15548,16587,1039,6.3
756,2005,March,Potter                                               ,Not Adjusted,53486,56144,2658,4.7
757,2005,June,Potter                                               ,Not Adjusted,54090,56904,2814,4.9
758,2005,September,Potter                                               ,Not Adjusted,54450,57096,2646,4.6
759,2005,December,Potter                                               ,Not Adjusted,54401,56703,2302,4.1
760,2005,March,Presidio                                             ,Not Adjusted,2849,3282,433,13.2
761,2005,June,Presidio                                             ,Not Adjusted,2872,3275,403,12.3
762,2005,September,Presidio                                             ,Not Adjusted,2910,3219,309,9.6
763,2005,December,Presidio                                             ,Not Adjusted,2883,3190,307,9.6
764,2005,March,Rains                                                ,Not Adjusted,4918,5198,280,5.4
765,2005,June,Rains                                                ,Not Adjusted,4795,5075,280,5.5
766,2005,September,Rains                                                ,Not Adjusted,4838,5112,274,5.4
767,2005,December,Rains                                                ,Not Adjusted,4719,4963,244,4.9
768,2005,March,Randall                                              ,Not Adjusted,62565,64891,2326,3.6
769,2005,June,Randall                                              ,Not Adjusted,63273,65682,2409,3.7
770,2005,September,Randall                                              ,Not Adjusted,63694,65946,2252,3.4
771,2005,December,Randall                                              ,Not Adjusted,63636,65712,2076,3.2
772,2005,March,Reagan                                               ,Not Adjusted,1978,2029,51,2.5
773,2005,June,Reagan                                               ,Not Adjusted,2146,2208,62,2.8
774,2005,September,Reagan                                               ,Not Adjusted,2224,2279,55,2.4
775,2005,December,Reagan                                               ,Not Adjusted,2170,2220,50,2.3
776,2005,March,Real                                                 ,Not Adjusted,1173,1240,67,5.4
777,2005,June,Real                                                 ,Not Adjusted,1315,1388,73,5.3
778,2005,September,Real                                                 ,Not Adjusted,1245,1305,60,4.6
779,2005,December,Real                                                 ,Not Adjusted,1255,1315,60,4.6
780,2005,March,Red River                                            ,Not Adjusted,5734,6150,416,6.8
781,2005,June,Red River                                            ,Not Adjusted,5870,6282,412,6.6
782,2005,September,Red River                                            ,Not Adjusted,5899,6271,372,5.9
783,2005,December,Red River                                            ,Not Adjusted,5937,6267,330,5.3
784,2005,March,Reeves                                               ,Not Adjusted,3922,4278,356,8.3
785,2005,June,Reeves                                               ,Not Adjusted,4007,4353,346,7.9
786,2005,September,Reeves                                               ,Not Adjusted,3810,4102,292,7.1
787,2005,December,Reeves                                               ,Not Adjusted,3926,4182,256,6.1
788,2005,March,Refugio                                              ,Not Adjusted,3654,3852,198,5.1
789,2005,June,Refugio                                              ,Not Adjusted,3745,3955,210,5.3
790,2005,September,Refugio                                              ,Not Adjusted,3678,3864,186,4.8
791,2005,December,Refugio                                              ,Not Adjusted,3604,3774,170,4.5
792,2005,March,Roberts                                              ,Not Adjusted,527,546,19,3.5
793,2005,June,Roberts                                              ,Not Adjusted,541,560,19,3.4
794,2005,September,Roberts                                              ,Not Adjusted,543,561,18,3.2
795,2005,December,Roberts                                              ,Not Adjusted,533,548,15,2.7
796,2005,March,Robertson                                            ,Not Adjusted,7308,7678,370,4.8
797,2005,June,Robertson                                            ,Not Adjusted,6938,7347,409,5.6
798,2005,September,Robertson                                            ,Not Adjusted,7342,7730,388,5.0
799,2005,December,Robertson                                            ,Not Adjusted,7279,7639,360,4.7
800,2005,March,Rockwall                                             ,Not Adjusted,30483,32028,1545,4.8
801,2005,June,Rockwall                                             ,Not Adjusted,30873,32490,1617,5.0
802,2005,September,Rockwall                                             ,Not Adjusted,31064,32645,1581,4.8
803,2005,December,Rockwall                                             ,Not Adjusted,31350,32776,1426,4.4
804,2005,March,Runnels                                              ,Not Adjusted,4355,4592,237,5.2
805,2005,June,Runnels                                              ,Not Adjusted,4447,4695,248,5.3
806,2005,September,Runnels                                              ,Not Adjusted,4304,4543,239,5.3
807,2005,December,Runnels                                              ,Not Adjusted,4290,4502,212,4.7
808,2005,March,Rusk                                                 ,Not Adjusted,21487,22724,1237,5.4
809,2005,June,Rusk                                                 ,Not Adjusted,21656,22928,1272,5.5
810,2005,September,Rusk                                                 ,Not Adjusted,21660,22841,1181,5.2
811,2005,December,Rusk                                                 ,Not Adjusted,21669,22724,1055,4.6
812,2005,March,Sabine                                               ,Not Adjusted,3084,3440,356,10.3
813,2005,June,Sabine                                               ,Not Adjusted,3193,3554,361,10.2
814,2005,September,Sabine                                               ,Not Adjusted,3121,3455,334,9.7
815,2005,December,Sabine                                               ,Not Adjusted,3022,3348,326,9.7
816,2005,March,San Augustine                                        ,Not Adjusted,3248,3498,250,7.1
817,2005,June,San Augustine                                        ,Not Adjusted,3454,3705,251,6.8
818,2005,September,San Augustine                                        ,Not Adjusted,3348,3586,238,6.6
819,2005,December,San Augustine                                        ,Not Adjusted,3288,3632,344,9.5
820,2005,March,San Jacinto                                          ,Not Adjusted,9490,10170,680,6.7
821,2005,June,San Jacinto                                          ,Not Adjusted,9531,10226,695,6.8
822,2005,September,San Jacinto                                          ,Not Adjusted,9590,10173,583,5.7
823,2005,December,San Jacinto                                          ,Not Adjusted,9723,10311,588,5.7
824,2005,March,San Patricio                                         ,Not Adjusted,27699,29732,2033,6.8
825,2005,June,San Patricio                                         ,Not Adjusted,27695,30132,2437,8.1
826,2005,September,San Patricio                                         ,Not Adjusted,27474,29412,1938,6.6
827,2005,December,San Patricio                                         ,Not Adjusted,27472,29196,1724,5.9
828,2005,March,San Saba                                             ,Not Adjusted,2508,2645,137,5.2
829,2005,June,San Saba                                             ,Not Adjusted,2564,2721,157,5.8
830,2005,September,San Saba                                             ,Not Adjusted,2466,2596,130,5.0
831,2005,December,San Saba                                             ,Not Adjusted,2451,2568,117,4.6
832,2005,March,Schleicher                                           ,Not Adjusted,1284,1339,55,4.1
833,2005,June,Schleicher                                           ,Not Adjusted,1342,1399,57,4.1
834,2005,September,Schleicher                                           ,Not Adjusted,1293,1349,56,4.2
835,2005,December,Schleicher                                           ,Not Adjusted,1323,1370,47,3.4
836,2005,March,Scurry                                               ,Not Adjusted,6695,7039,344,4.9
837,2005,June,Scurry                                               ,Not Adjusted,6767,7176,409,5.7
838,2005,September,Scurry                                               ,Not Adjusted,6848,7185,337,4.7
839,2005,December,Scurry                                               ,Not Adjusted,6791,7106,315,4.4
840,2005,March,Shackelford                                          ,Not Adjusted,1836,1895,59,3.1
841,2005,June,Shackelford                                          ,Not Adjusted,1950,2011,61,3.0
842,2005,September,Shackelford                                          ,Not Adjusted,1847,1907,60,3.1
843,2005,December,Shackelford                                          ,Not Adjusted,1898,1959,61,3.1
844,2005,March,Shelby                                               ,Not Adjusted,10947,11604,657,5.7
845,2005,June,Shelby                                               ,Not Adjusted,11023,11737,714,6.1
846,2005,September,Shelby                                               ,Not Adjusted,11024,11694,670,5.7
847,2005,December,Shelby                                               ,Not Adjusted,11078,12035,957,8.0
848,2005,March,Sherman                                              ,Not Adjusted,1262,1317,55,4.2
849,2005,June,Sherman                                              ,Not Adjusted,1402,1468,66,4.5
850,2005,September,Sherman                                              ,Not Adjusted,1346,1406,60,4.3
851,2005,December,Sherman                                              ,Not Adjusted,1255,1303,48,3.7
852,2005,March,Smith                                                ,Not Adjusted,90776,95449,4673,4.9
853,2005,June,Smith                                                ,Not Adjusted,90664,95674,5010,5.2
854,2005,September,Smith                                                ,Not Adjusted,91142,96166,5024,5.2
855,2005,December,Smith                                                ,Not Adjusted,91583,95875,4292,4.5
856,2005,March,Somervell                                            ,Not Adjusted,3456,3628,172,4.7
857,2005,June,Somervell                                            ,Not Adjusted,3556,3792,236,6.2
858,2005,September,Somervell                                            ,Not Adjusted,3522,3729,207,5.6
859,2005,December,Somervell                                            ,Not Adjusted,3529,3737,208,5.6
860,2005,March,Starr                                                ,Not Adjusted,18209,21750,3541,16.3
861,2005,June,Starr                                                ,Not Adjusted,18601,21179,2578,12.2
862,2005,September,Starr                                                ,Not Adjusted,18433,20554,2121,10.3
863,2005,December,Starr                                                ,Not Adjusted,18439,21352,2913,13.6
864,2005,March,Stephens                                             ,Not Adjusted,3987,4189,202,4.8
865,2005,June,Stephens                                             ,Not Adjusted,4178,4383,205,4.7
866,2005,September,Stephens                                             ,Not Adjusted,4192,4392,200,4.6
867,2005,December,Stephens                                             ,Not Adjusted,4157,4335,178,4.1
868,2005,March,Sterling                                             ,Not Adjusted,877,906,29,3.2
869,2005,June,Sterling                                             ,Not Adjusted,962,995,33,3.3
870,2005,September,Sterling                                             ,Not Adjusted,926,953,27,2.8
871,2005,December,Sterling                                             ,Not Adjusted,829,852,23,2.7
872,2005,March,Stonewall                                            ,Not Adjusted,767,800,33,4.1
873,2005,June,Stonewall                                            ,Not Adjusted,833,860,27,3.1
874,2005,September,Stonewall                                            ,Not Adjusted,855,879,24,2.7
875,2005,December,Stonewall                                            ,Not Adjusted,761,786,25,3.2
876,2005,March,Sutton                                               ,Not Adjusted,2529,2612,83,3.2
877,2005,June,Sutton                                               ,Not Adjusted,2684,2767,83,3.0
878,2005,September,Sutton                                               ,Not Adjusted,2633,2707,74,2.7
879,2005,December,Sutton                                               ,Not Adjusted,2666,2733,67,2.5
880,2005,March,Swisher                                              ,Not Adjusted,3400,3584,184,5.1
881,2005,June,Swisher                                              ,Not Adjusted,3565,3748,183,4.9
882,2005,September,Swisher                                              ,Not Adjusted,3451,3616,165,4.6
883,2005,December,Swisher                                              ,Not Adjusted,3343,3481,138,4.0
884,2005,March,Tarrant                                              ,Not Adjusted,795677,839372,43695,5.2
885,2005,June,Tarrant                                              ,Not Adjusted,803625,848036,44411,5.2
886,2005,September,Tarrant                                              ,Not Adjusted,806919,852588,45669,5.4
887,2005,December,Tarrant                                              ,Not Adjusted,812530,853287,40757,4.8
888,2005,March,Taylor                                               ,Not Adjusted,61696,64473,2777,4.3
889,2005,June,Taylor                                               ,Not Adjusted,62353,65220,2867,4.4
890,2005,September,Taylor                                               ,Not Adjusted,63432,66111,2679,4.1
891,2005,December,Taylor                                               ,Not Adjusted,63323,65721,2398,3.6
892,2005,March,Terrell                                              ,Not Adjusted,340,363,23,6.3
893,2005,June,Terrell                                              ,Not Adjusted,368,400,32,8.0
894,2005,September,Terrell                                              ,Not Adjusted,346,378,32,8.5
895,2005,December,Terrell                                              ,Not Adjusted,354,377,23,6.1
896,2005,March,Terry                                                ,Not Adjusted,5311,5650,339,6.0
897,2005,June,Terry                                                ,Not Adjusted,5563,5924,361,6.1
898,2005,September,Terry                                                ,Not Adjusted,5408,5728,320,5.6
899,2005,December,Terry                                                ,Not Adjusted,5378,5652,274,4.8
900,2005,March,Throckmorton                                         ,Not Adjusted,871,904,33,3.7
901,2005,June,Throckmorton                                         ,Not Adjusted,947,984,37,3.8
902,2005,September,Throckmorton                                         ,Not Adjusted,905,938,33,3.5
903,2005,December,Throckmorton                                         ,Not Adjusted,876,905,29,3.2
904,2005,March,Titus                                                ,Not Adjusted,14071,14777,706,4.8
905,2005,June,Titus                                                ,Not Adjusted,14164,14937,773,5.2
906,2005,September,Titus                                                ,Not Adjusted,13921,14609,688,4.7
907,2005,December,Titus                                                ,Not Adjusted,13915,14536,621,4.3
908,2005,March,Tom Green                                            ,Not Adjusted,49577,51874,2297,4.4
909,2005,June,Tom Green                                            ,Not Adjusted,49876,52245,2369,4.5
910,2005,September,Tom Green                                            ,Not Adjusted,49639,51916,2277,4.4
911,2005,December,Tom Green                                            ,Not Adjusted,49750,51768,2018,3.9
912,2005,March,Travis                                               ,Not Adjusted,475938,498571,22633,4.5
913,2005,June,Travis                                               ,Not Adjusted,481561,504916,23355,4.6
914,2005,September,Travis                                               ,Not Adjusted,481679,505492,23813,4.7
915,2005,December,Travis                                               ,Not Adjusted,486102,507334,21232,4.2
916,2005,March,Trinity                                              ,Not Adjusted,5364,5721,357,6.2
917,2005,June,Trinity                                              ,Not Adjusted,5500,5890,390,6.6
918,2005,September,Trinity                                              ,Not Adjusted,5564,5941,377,6.3
919,2005,December,Trinity                                              ,Not Adjusted,5343,5687,344,6.0
920,2005,March,Tyler                                                ,Not Adjusted,7770,8347,577,6.9
921,2005,June,Tyler                                                ,Not Adjusted,7781,8388,607,7.2
922,2005,September,Tyler                                                ,Not Adjusted,7745,8369,624,7.5
923,2005,December,Tyler                                                ,Not Adjusted,7711,8301,590,7.1
924,2005,March,Upshur                                               ,Not Adjusted,17798,18760,962,5.1
925,2005,June,Upshur                                               ,Not Adjusted,17938,18915,977,5.2
926,2005,September,Upshur                                               ,Not Adjusted,17941,18889,948,5.0
927,2005,December,Upshur                                               ,Not Adjusted,17950,18846,896,4.8
928,2005,March,Upton                                                ,Not Adjusted,1544,1619,75,4.6
929,2005,June,Upton                                                ,Not Adjusted,1637,1714,77,4.5
930,2005,September,Upton                                                ,Not Adjusted,1629,1694,65,3.8
931,2005,December,Upton                                                ,Not Adjusted,1632,1682,50,3.0
932,2005,March,Uvalde                                               ,Not Adjusted,11073,11824,751,6.4
933,2005,June,Uvalde                                               ,Not Adjusted,11170,11888,718,6.0
934,2005,September,Uvalde                                               ,Not Adjusted,10999,11692,693,5.9
935,2005,December,Uvalde                                               ,Not Adjusted,10874,11569,695,6.0
936,2005,March,Val Verde                                            ,Not Adjusted,18665,20046,1381,6.9
937,2005,June,Val Verde                                            ,Not Adjusted,18782,20094,1312,6.5
938,2005,September,Val Verde                                            ,Not Adjusted,18783,19950,1167,5.8
939,2005,December,Val Verde                                            ,Not Adjusted,18727,19913,1186,6.0
940,2005,March,Van Zandt                                            ,Not Adjusted,23815,25102,1287,5.1
941,2005,June,Van Zandt                                            ,Not Adjusted,24320,25652,1332,5.2
942,2005,September,Van Zandt                                            ,Not Adjusted,24071,25384,1313,5.2
943,2005,December,Van Zandt                                            ,Not Adjusted,24154,25307,1153,4.6
944,2005,March,Victoria                                             ,Not Adjusted,41552,43574,2022,4.6
945,2005,June,Victoria                                             ,Not Adjusted,42294,44398,2104,4.7
946,2005,September,Victoria                                             ,Not Adjusted,41877,43893,2016,4.6
947,2005,December,Victoria                                             ,Not Adjusted,42051,43896,1845,4.2
948,2005,March,Walker                                               ,Not Adjusted,24434,25902,1468,5.7
949,2005,June,Walker                                               ,Not Adjusted,24440,26066,1626,6.2
950,2005,September,Walker                                               ,Not Adjusted,24746,26261,1515,5.8
951,2005,December,Walker                                               ,Not Adjusted,24707,26033,1326,5.1
952,2005,March,Waller                                               ,Not Adjusted,14897,15796,899,5.7
953,2005,June,Waller                                               ,Not Adjusted,14962,15973,1011,6.3
954,2005,September,Waller                                               ,Not Adjusted,15054,15927,873,5.5
955,2005,December,Waller                                               ,Not Adjusted,15263,16074,811,5.0
956,2005,March,Ward                                                 ,Not Adjusted,4111,4358,247,5.7
957,2005,June,Ward                                                 ,Not Adjusted,4287,4567,280,6.1
958,2005,September,Ward                                                 ,Not Adjusted,4253,4488,235,5.2
959,2005,December,Ward                                                 ,Not Adjusted,4323,4538,215,4.7
960,2005,March,Washington                                           ,Not Adjusted,15345,16074,729,4.5
961,2005,June,Washington                                           ,Not Adjusted,15640,16453,813,4.9
962,2005,September,Washington                                           ,Not Adjusted,15553,16335,782,4.8
963,2005,December,Washington                                           ,Not Adjusted,15429,16105,676,4.2
964,2005,March,Webb                                                 ,Not Adjusted,79210,84745,5535,6.5
965,2005,June,Webb                                                 ,Not Adjusted,79705,85386,5681,6.7
966,2005,September,Webb                                                 ,Not Adjusted,81786,86695,4909,5.7
967,2005,December,Webb                                                 ,Not Adjusted,82750,87342,4592,5.3
968,2005,March,Wharton                                              ,Not Adjusted,19685,20777,1092,5.3
969,2005,June,Wharton                                              ,Not Adjusted,19915,21027,1112,5.3
970,2005,September,Wharton                                              ,Not Adjusted,19740,20794,1054,5.1
971,2005,December,Wharton                                              ,Not Adjusted,19619,20581,962,4.7
972,2005,March,Wheeler                                              ,Not Adjusted,2530,2634,104,3.9
973,2005,June,Wheeler                                              ,Not Adjusted,2615,2731,116,4.2
974,2005,September,Wheeler                                              ,Not Adjusted,2598,2703,105,3.9
975,2005,December,Wheeler                                              ,Not Adjusted,2575,2671,96,3.6
976,2005,March,Wichita                                              ,Not Adjusted,59501,62535,3034,4.9
977,2005,June,Wichita                                              ,Not Adjusted,59867,63128,3261,5.2
978,2005,September,Wichita                                              ,Not Adjusted,59578,62549,2971,4.7
979,2005,December,Wichita                                              ,Not Adjusted,59827,62438,2611,4.2
980,2005,March,Wilbarger                                            ,Not Adjusted,7127,7412,285,3.8
981,2005,June,Wilbarger                                            ,Not Adjusted,7206,7544,338,4.5
982,2005,September,Wilbarger                                            ,Not Adjusted,7180,7469,289,3.9
983,2005,December,Wilbarger                                            ,Not Adjusted,7253,7515,262,3.5
984,2005,March,Willacy                                              ,Not Adjusted,6755,7544,789,10.5
985,2005,June,Willacy                                              ,Not Adjusted,6868,7637,769,10.1
986,2005,September,Willacy                                              ,Not Adjusted,6956,7625,669,8.8
987,2005,December,Willacy                                              ,Not Adjusted,6825,7546,721,9.6
988,2005,March,Williamson                                           ,Not Adjusted,170039,178480,8441,4.7
989,2005,June,Williamson                                           ,Not Adjusted,172048,180496,8448,4.7
990,2005,September,Williamson                                           ,Not Adjusted,172091,180493,8402,4.7
991,2005,December,Williamson                                           ,Not Adjusted,173671,181479,7808,4.3
992,2005,March,Wilson                                               ,Not Adjusted,16732,17585,853,4.9
993,2005,June,Wilson                                               ,Not Adjusted,16948,17879,931,5.2
994,2005,September,Wilson                                               ,Not Adjusted,16976,17848,872,4.9
995,2005,December,Wilson                                               ,Not Adjusted,17083,17835,752,4.2
996,2005,March,Winkler                                              ,Not Adjusted,2839,2986,147,4.9
997,2005,June,Winkler                                              ,Not Adjusted,2892,3045,153,5.0
998,2005,September,Winkler                                              ,Not Adjusted,2908,3050,142,4.7
999,2005,December,Winkler                                              ,Not Adjusted,2966,3103,137,4.4
1000,2005,March,Wise                                                 ,Not Adjusted,26142,27472,1330,4.8
1001,2005,June,Wise                                                 ,Not Adjusted,26403,27915,1512,5.4
1002,2005,September,Wise                                                 ,Not Adjusted,26511,27780,1269,4.6
1003,2005,December,Wise                                                 ,Not Adjusted,26695,27826,1131,4.1
1004,2005,March,Wood                                                 ,Not Adjusted,16632,17629,997,5.7
1005,2005,June,Wood                                                 ,Not Adjusted,16808,17834,1026,5.8
1006,2005,September,Wood                                                 ,Not Adjusted,16544,17537,993,5.7
1007,2005,December,Wood                                                 ,Not Adjusted,16608,17487,879,5.0
1008,2005,March,Yoakum                                               ,Not Adjusted,3013,3179,166,5.2
1009,2005,June,Yoakum                                               ,Not Adjusted,3206,3374,168,5.0
1010,2005,September,Yoakum                                               ,Not Adjusted,3130,3276,146,4.5
1011,2005,December,Yoakum                                               ,Not Adjusted,3191,3315,124,3.7
1012,2005,March,Young                                                ,Not Adjusted,8644,9056,412,4.5
1013,2005,June,Young                                                ,Not Adjusted,9121,9546,425,4.5
1014,2005,September,Young                                                ,Not Adjusted,9188,9572,384,4.0
1015,2005,December,Young                                                ,Not Adjusted,9125,9475,350,3.7
1016,2005,March,Zapata                                               ,Not Adjusted,4717,5078,361,7.1
1017,2005,June,Zapata                                               ,Not Adjusted,4823,5198,375,7.2
1018,2005,September,Zapata                                               ,Not Adjusted,4698,5023,325,6.5
1019,2005,December,Zapata                                               ,Not Adjusted,4661,4974,313,6.3
1020,2005,March,Zavala                                               ,Not Adjusted,3516,3995,479,12.0
1021,2005,June,Zavala                                               ,Not Adjusted,3491,3922,431,11.0
1022,2005,September,Zavala                                               ,Not Adjusted,3293,3708,415,11.2
1023,2005,December,Zavala                                               ,Not Adjusted,3315,3776,461,12.2
1024,2006,March,Texas,Not Adjusted,10657710,11237871,580161,5.2
1025,2006,March,Texas,Adjusted,10683983,11272128,588145,5.2
1026,2006,June,Texas,Not Adjusted,10757645,11384146,626501,5.5
1027,2006,June,Texas,Adjusted,10749064,11335374,586310,5.2
1028,2006,September,Texas,Not Adjusted,10819212,11366189,546977,4.8
1029,2006,September,Texas,Adjusted,10832912,11381736,548824,4.8
1030,2006,December,Texas,Not Adjusted,10960018,11434053,474035,4.1
1031,2006,December,Texas,Adjusted,10896648,11412317,515669,4.5
1032,2006,March,Anderson                                             ,Not Adjusted,18916,20156,1240,6.2
1033,2006,June,Anderson                                             ,Not Adjusted,19227,20547,1320,6.4
1034,2006,September,Anderson                                             ,Not Adjusted,18966,20146,1180,5.9
1035,2006,December,Anderson                                             ,Not Adjusted,19162,20171,1009,5.0
1036,2006,March,Andrews                                              ,Not Adjusted,6384,6629,245,3.7
1037,2006,June,Andrews                                              ,Not Adjusted,6600,6877,277,4.0
1038,2006,September,Andrews                                              ,Not Adjusted,6587,6822,235,3.4
1039,2006,December,Andrews                                              ,Not Adjusted,6706,6901,195,2.8
1040,2006,March,Angelina                                             ,Not Adjusted,37933,39855,1922,4.8
1041,2006,June,Angelina                                             ,Not Adjusted,38100,40191,2091,5.2
1042,2006,September,Angelina                                             ,Not Adjusted,38375,40208,1833,4.6
1043,2006,December,Angelina                                             ,Not Adjusted,38369,40010,1641,4.1
1044,2006,March,Aransas                                              ,Not Adjusted,10491,11047,556,5.0
1045,2006,June,Aransas                                              ,Not Adjusted,10479,11041,562,5.1
1046,2006,September,Aransas                                              ,Not Adjusted,10500,11022,522,4.7
1047,2006,December,Aransas                                              ,Not Adjusted,10617,11072,455,4.1
1048,2006,March,Archer                                               ,Not Adjusted,5263,5454,191,3.5
1049,2006,June,Archer                                               ,Not Adjusted,5293,5502,209,3.8
1050,2006,September,Archer                                               ,Not Adjusted,5277,5452,175,3.2
1051,2006,December,Archer                                               ,Not Adjusted,5228,5402,174,3.2
1052,2006,March,Armstrong                                            ,Not Adjusted,1052,1089,37,3.4
1053,2006,June,Armstrong                                            ,Not Adjusted,1068,1113,45,4.0
1054,2006,September,Armstrong                                            ,Not Adjusted,1069,1110,41,3.7
1055,2006,December,Armstrong                                            ,Not Adjusted,1070,1104,34,3.1
1056,2006,March,Atascosa                                             ,Not Adjusted,18121,19029,908,4.8
1057,2006,June,Atascosa                                             ,Not Adjusted,18296,19401,1105,5.7
1058,2006,September,Atascosa                                             ,Not Adjusted,18367,19245,878,4.6
1059,2006,December,Atascosa                                             ,Not Adjusted,18497,19216,719,3.7
1060,2006,March,Austin                                               ,Not Adjusted,12025,12622,597,4.7
1061,2006,June,Austin                                               ,Not Adjusted,12070,12694,624,4.9
1062,2006,September,Austin                                               ,Not Adjusted,12223,12767,544,4.3
1063,2006,December,Austin                                               ,Not Adjusted,12426,12873,447,3.5
1064,2006,March,Bailey                                               ,Not Adjusted,2871,3026,155,5.1
1065,2006,June,Bailey                                               ,Not Adjusted,3126,3329,203,6.1
1066,2006,September,Bailey                                               ,Not Adjusted,2997,3141,144,4.6
1067,2006,December,Bailey                                               ,Not Adjusted,3015,3157,142,4.5
1068,2006,March,Bandera                                              ,Not Adjusted,9246,9656,410,4.2
1069,2006,June,Bandera                                              ,Not Adjusted,9335,9787,452,4.6
1070,2006,September,Bandera                                              ,Not Adjusted,9371,9789,418,4.3
1071,2006,December,Bandera                                              ,Not Adjusted,9438,9799,361,3.7
1072,2006,March,Bastrop                                              ,Not Adjusted,31925,33659,1734,5.2
1073,2006,June,Bastrop                                              ,Not Adjusted,32462,34250,1788,5.2
1074,2006,September,Bastrop                                              ,Not Adjusted,32881,34406,1525,4.4
1075,2006,December,Bastrop                                              ,Not Adjusted,33425,34737,1312,3.8
1076,2006,March,Baylor                                               ,Not Adjusted,1777,1856,79,4.3
1077,2006,June,Baylor                                               ,Not Adjusted,1925,2016,91,4.5
1078,2006,September,Baylor                                               ,Not Adjusted,1885,1962,77,3.9
1079,2006,December,Baylor                                               ,Not Adjusted,1894,1961,67,3.4
1080,2006,March,Bee                                                  ,Not Adjusted,10705,11438,733,6.4
1081,2006,June,Bee                                                  ,Not Adjusted,10830,11667,837,7.2
1082,2006,September,Bee                                                  ,Not Adjusted,10676,11393,717,6.3
1083,2006,December,Bee                                                  ,Not Adjusted,10751,11370,619,5.4
1084,2006,March,Bell                                                 ,Not Adjusted,108100,113902,5802,5.1
1085,2006,June,Bell                                                 ,Not Adjusted,110072,116546,6474,5.6
1086,2006,September,Bell                                                 ,Not Adjusted,109742,115556,5814,5.0
1087,2006,December,Bell                                                 ,Not Adjusted,111659,116730,5071,4.3
1088,2006,March,Bexar                                                ,Not Adjusted,688101,723437,35336,4.9
1089,2006,June,Bexar                                                ,Not Adjusted,694750,734355,39605,5.4
1090,2006,September,Bexar                                                ,Not Adjusted,697438,731456,34018,4.7
1091,2006,December,Bexar                                                ,Not Adjusted,702387,730676,28289,3.9
1092,2006,March,Blanco                                               ,Not Adjusted,4347,4534,187,4.1
1093,2006,June,Blanco                                               ,Not Adjusted,4555,4759,204,4.3
1094,2006,September,Blanco                                               ,Not Adjusted,4528,4700,172,3.7
1095,2006,December,Blanco                                               ,Not Adjusted,4659,4810,151,3.1
1096,2006,March,Borden                                               ,Not Adjusted,397,419,22,5.3
1097,2006,June,Borden                                               ,Not Adjusted,408,431,23,5.3
1098,2006,September,Borden                                               ,Not Adjusted,353,367,14,3.8
1099,2006,December,Borden                                               ,Not Adjusted,387,401,14,3.5
1100,2006,March,Bosque                                               ,Not Adjusted,7747,8166,419,5.1
1101,2006,June,Bosque                                               ,Not Adjusted,7898,8353,455,5.4
1102,2006,September,Bosque                                               ,Not Adjusted,7724,8110,386,4.8
1103,2006,December,Bosque                                               ,Not Adjusted,7794,8147,353,4.3
1104,2006,March,Bowie                                                ,Not Adjusted,40283,42544,2261,5.3
1105,2006,June,Bowie                                                ,Not Adjusted,40820,43332,2512,5.8
1106,2006,September,Bowie                                                ,Not Adjusted,40446,42721,2275,5.3
1107,2006,December,Bowie                                                ,Not Adjusted,40641,42726,2085,4.9
1108,2006,March,Brazoria                                             ,Not Adjusted,126714,133602,6888,5.2
1109,2006,June,Brazoria                                             ,Not Adjusted,127173,134886,7713,5.7
1110,2006,September,Brazoria                                             ,Not Adjusted,128800,135472,6672,4.9
1111,2006,December,Brazoria                                             ,Not Adjusted,130932,136718,5786,4.2
1112,2006,March,Brazos                                               ,Not Adjusted,84425,88080,3655,4.1
1113,2006,June,Brazos                                               ,Not Adjusted,79726,84006,4280,5.1
1114,2006,September,Brazos                                               ,Not Adjusted,84868,88248,3380,3.8
1115,2006,December,Brazos                                               ,Not Adjusted,85220,87939,2719,3.1
1116,2006,March,Brewster                                             ,Not Adjusted,5260,5452,192,3.5
1117,2006,June,Brewster                                             ,Not Adjusted,5301,5515,214,3.9
1118,2006,September,Brewster                                             ,Not Adjusted,5068,5243,175,3.3
1119,2006,December,Brewster                                             ,Not Adjusted,5307,5463,156,2.9
1120,2006,March,Briscoe                                              ,Not Adjusted,625,663,38,5.7
1121,2006,June,Briscoe                                              ,Not Adjusted,723,760,37,4.9
1122,2006,September,Briscoe                                              ,Not Adjusted,663,693,30,4.3
1123,2006,December,Briscoe                                              ,Not Adjusted,693,717,24,3.3
1124,2006,March,Brooks                                               ,Not Adjusted,2808,3002,194,6.5
1125,2006,June,Brooks                                               ,Not Adjusted,2892,3131,239,7.6
1126,2006,September,Brooks                                               ,Not Adjusted,2791,2973,182,6.1
1127,2006,December,Brooks                                               ,Not Adjusted,2933,3087,154,5.0
1128,2006,March,Brown                                                ,Not Adjusted,18132,18970,838,4.4
1129,2006,June,Brown                                                ,Not Adjusted,18366,19376,1010,5.2
1130,2006,September,Brown                                                ,Not Adjusted,18159,18970,811,4.3
1131,2006,December,Brown                                                ,Not Adjusted,17965,18830,865,4.6
1132,2006,March,Burleson                                             ,Not Adjusted,8106,8435,329,3.9
1133,2006,June,Burleson                                             ,Not Adjusted,7654,8044,390,4.8
1134,2006,September,Burleson                                             ,Not Adjusted,8147,8489,342,4.0
1135,2006,December,Burleson                                             ,Not Adjusted,8181,8477,296,3.5
1136,2006,March,Burnet                                               ,Not Adjusted,20111,21041,930,4.4
1137,2006,June,Burnet                                               ,Not Adjusted,20785,21781,996,4.6
1138,2006,September,Burnet                                               ,Not Adjusted,20749,21616,867,4.0
1139,2006,December,Burnet                                               ,Not Adjusted,20559,21260,701,3.3
1140,2006,March,Caldwell                                             ,Not Adjusted,14816,15647,831,5.3
1141,2006,June,Caldwell                                             ,Not Adjusted,15065,15997,932,5.8
1142,2006,September,Caldwell                                             ,Not Adjusted,15260,16036,776,4.8
1143,2006,December,Caldwell                                             ,Not Adjusted,15512,16147,635,3.9
1144,2006,March,Calhoun                                              ,Not Adjusted,8835,9288,453,4.9
1145,2006,June,Calhoun                                              ,Not Adjusted,8955,9491,536,5.6
1146,2006,September,Calhoun                                              ,Not Adjusted,8951,9398,447,4.8
1147,2006,December,Calhoun                                              ,Not Adjusted,8960,9315,355,3.8
1148,2006,March,Callahan                                             ,Not Adjusted,6758,7031,273,3.9
1149,2006,June,Callahan                                             ,Not Adjusted,6898,7222,324,4.5
1150,2006,September,Callahan                                             ,Not Adjusted,6841,7104,263,3.7
1151,2006,December,Callahan                                             ,Not Adjusted,6870,7099,229,3.2
1152,2006,March,Cameron                                              ,Not Adjusted,132007,141961,9954,7.0
1153,2006,June,Cameron                                              ,Not Adjusted,134035,144840,10805,7.5
1154,2006,September,Cameron                                              ,Not Adjusted,132988,142088,9100,6.4
1155,2006,December,Cameron                                              ,Not Adjusted,135274,143639,8365,5.8
1156,2006,March,Camp                                                 ,Not Adjusted,5168,5451,283,5.2
1157,2006,June,Camp                                                 ,Not Adjusted,5256,5561,305,5.5
1158,2006,September,Camp                                                 ,Not Adjusted,5236,5518,282,5.1
1159,2006,December,Camp                                                 ,Not Adjusted,5310,5556,246,4.4
1160,2006,March,Carson                                               ,Not Adjusted,3357,3486,129,3.7
1161,2006,June,Carson                                               ,Not Adjusted,3407,3557,150,4.2
1162,2006,September,Carson                                               ,Not Adjusted,3410,3529,119,3.4
1163,2006,December,Carson                                               ,Not Adjusted,3413,3512,99,2.8
1164,2006,March,Cass                                                 ,Not Adjusted,12347,13131,784,6.0
1165,2006,June,Cass                                                 ,Not Adjusted,12383,13227,844,6.4
1166,2006,September,Cass                                                 ,Not Adjusted,12218,12962,744,5.7
1167,2006,December,Cass                                                 ,Not Adjusted,12195,12883,688,5.3
1168,2006,March,Castro                                               ,Not Adjusted,2931,3097,166,5.4
1169,2006,June,Castro                                               ,Not Adjusted,3205,3384,179,5.3
1170,2006,September,Castro                                               ,Not Adjusted,3094,3235,141,4.4
1171,2006,December,Castro                                               ,Not Adjusted,3237,3347,110,3.3
1172,2006,March,Chambers                                             ,Not Adjusted,12944,13635,691,5.1
1173,2006,June,Chambers                                             ,Not Adjusted,12991,13852,861,6.2
1174,2006,September,Chambers                                             ,Not Adjusted,13158,13866,708,5.1
1175,2006,December,Chambers                                             ,Not Adjusted,13375,14016,641,4.6
1176,2006,March,Cherokee                                             ,Not Adjusted,18955,20067,1112,5.5
1177,2006,June,Cherokee                                             ,Not Adjusted,19543,20735,1192,5.7
1178,2006,September,Cherokee                                             ,Not Adjusted,19135,20184,1049,5.2
1179,2006,December,Cherokee                                             ,Not Adjusted,19236,20215,979,4.8
1180,2006,March,Childress                                            ,Not Adjusted,2784,2960,176,5.9
1181,2006,June,Childress                                            ,Not Adjusted,2919,3113,194,6.2
1182,2006,September,Childress                                            ,Not Adjusted,2905,3076,171,5.6
1183,2006,December,Childress                                            ,Not Adjusted,2884,3033,149,4.9
1184,2006,March,Clay                                                 ,Not Adjusted,6203,6445,242,3.8
1185,2006,June,Clay                                                 ,Not Adjusted,6238,6522,284,4.4
1186,2006,September,Clay                                                 ,Not Adjusted,6218,6451,233,3.6
1187,2006,December,Clay                                                 ,Not Adjusted,6161,6367,206,3.2
1188,2006,March,Cochran                                              ,Not Adjusted,1317,1420,103,7.3
1189,2006,June,Cochran                                              ,Not Adjusted,1403,1521,118,7.8
1190,2006,September,Cochran                                              ,Not Adjusted,1361,1441,80,5.6
1191,2006,December,Cochran                                              ,Not Adjusted,1431,1493,62,4.2
1192,2006,March,Coke                                                 ,Not Adjusted,1235,1310,75,5.7
1193,2006,June,Coke                                                 ,Not Adjusted,1333,1424,91,6.4
1194,2006,September,Coke                                                 ,Not Adjusted,1296,1369,73,5.3
1195,2006,December,Coke                                                 ,Not Adjusted,1286,1344,58,4.3
1196,2006,March,Coleman                                              ,Not Adjusted,3934,4126,192,4.7
1197,2006,June,Coleman                                              ,Not Adjusted,4131,4338,207,4.8
1198,2006,September,Coleman                                              ,Not Adjusted,4111,4288,177,4.1
1199,2006,December,Coleman                                              ,Not Adjusted,4218,4382,164,3.7
1200,2006,March,Collin                                               ,Not Adjusted,363070,380239,17169,4.5
1201,2006,June,Collin                                               ,Not Adjusted,368241,386464,18223,4.7
1202,2006,September,Collin                                               ,Not Adjusted,369575,385886,16311,4.2
1203,2006,December,Collin                                               ,Not Adjusted,373714,387600,13886,3.6
1204,2006,March,Collingsworth                                        ,Not Adjusted,1421,1499,78,5.2
1205,2006,June,Collingsworth                                        ,Not Adjusted,1557,1634,77,4.7
1206,2006,September,Collingsworth                                        ,Not Adjusted,1474,1540,66,4.3
1207,2006,December,Collingsworth                                        ,Not Adjusted,1520,1568,48,3.1
1208,2006,March,Colorado                                             ,Not Adjusted,9945,10424,479,4.6
1209,2006,June,Colorado                                             ,Not Adjusted,10553,11111,558,5.0
1210,2006,September,Colorado                                             ,Not Adjusted,10175,10615,440,4.1
1211,2006,December,Colorado                                             ,Not Adjusted,10332,10709,377,3.5
1212,2006,March,Comal                                                ,Not Adjusted,48699,50878,2179,4.3
1213,2006,June,Comal                                                ,Not Adjusted,49169,51528,2359,4.6
1214,2006,September,Comal                                                ,Not Adjusted,49361,51429,2068,4.0
1215,2006,December,Comal                                                ,Not Adjusted,49711,51504,1793,3.5
1216,2006,March,Comanche                                             ,Not Adjusted,5852,6136,284,4.6
1217,2006,June,Comanche                                             ,Not Adjusted,6301,6644,343,5.2
1218,2006,September,Comanche                                             ,Not Adjusted,6049,6321,272,4.3
1219,2006,December,Comanche                                             ,Not Adjusted,6275,6525,250,3.8
1220,2006,March,Concho                                               ,Not Adjusted,1219,1290,71,5.5
1221,2006,June,Concho                                               ,Not Adjusted,1310,1385,75,5.4
1222,2006,September,Concho                                               ,Not Adjusted,1246,1320,74,5.6
1223,2006,December,Concho                                               ,Not Adjusted,1270,1327,57,4.3
1224,2006,March,Cooke                                                ,Not Adjusted,19621,20462,841,4.1
1225,2006,June,Cooke                                                ,Not Adjusted,19936,20829,893,4.3
1226,2006,September,Cooke                                                ,Not Adjusted,20241,21002,761,3.6
1227,2006,December,Cooke                                                ,Not Adjusted,20624,21269,645,3.0
1228,2006,March,Coryell                                              ,Not Adjusted,22584,24177,1593,6.6
1229,2006,June,Coryell                                              ,Not Adjusted,22995,24838,1843,7.4
1230,2006,September,Coryell                                              ,Not Adjusted,22927,24573,1646,6.7
1231,2006,December,Coryell                                              ,Not Adjusted,23326,24678,1352,5.5
1232,2006,March,Cottle                                               ,Not Adjusted,726,769,43,5.6
1233,2006,June,Cottle                                               ,Not Adjusted,795,839,44,5.2
1234,2006,September,Cottle                                               ,Not Adjusted,758,803,45,5.6
1235,2006,December,Cottle                                               ,Not Adjusted,761,796,35,4.4
1236,2006,March,Crane                                                ,Not Adjusted,1613,1697,84,4.9
1237,2006,June,Crane                                                ,Not Adjusted,1659,1746,87,5.0
1238,2006,September,Crane                                                ,Not Adjusted,1678,1746,68,3.9
1239,2006,December,Crane                                                ,Not Adjusted,1732,1791,59,3.3
1240,2006,March,Crockett                                             ,Not Adjusted,1936,2012,76,3.8
1241,2006,June,Crockett                                             ,Not Adjusted,2013,2096,83,4.0
1242,2006,September,Crockett                                             ,Not Adjusted,1950,2014,64,3.2
1243,2006,December,Crockett                                             ,Not Adjusted,1951,2008,57,2.8
1244,2006,March,Crosby                                               ,Not Adjusted,2675,2859,184,6.4
1245,2006,June,Crosby                                               ,Not Adjusted,2651,2833,182,6.4
1246,2006,September,Crosby                                               ,Not Adjusted,2701,2843,142,5.0
1247,2006,December,Crosby                                               ,Not Adjusted,2725,2847,122,4.3
1248,2006,March,Culberson                                            ,Not Adjusted,1515,1569,54,3.4
1249,2006,June,Culberson                                            ,Not Adjusted,1701,1759,58,3.3
1250,2006,September,Culberson                                            ,Not Adjusted,1589,1637,48,2.9
1251,2006,December,Culberson                                            ,Not Adjusted,1569,1616,47,2.9
1252,2006,March,Dallam                                               ,Not Adjusted,2813,2914,101,3.5
1253,2006,June,Dallam                                               ,Not Adjusted,3037,3159,122,3.9
1254,2006,September,Dallam                                               ,Not Adjusted,2920,3018,98,3.2
1255,2006,December,Dallam                                               ,Not Adjusted,3047,3130,83,2.7
1256,2006,March,Dallas                                               ,Not Adjusted,1072566,1133511,60945,5.4
1257,2006,June,Dallas                                               ,Not Adjusted,1087841,1152876,65035,5.6
1258,2006,September,Dallas                                               ,Not Adjusted,1091785,1150525,58740,5.1
1259,2006,December,Dallas                                               ,Not Adjusted,1104011,1154232,50221,4.4
1260,2006,March,Dawson                                               ,Not Adjusted,4629,4976,347,7.0
1261,2006,June,Dawson                                               ,Not Adjusted,4842,5241,399,7.6
1262,2006,September,Dawson                                               ,Not Adjusted,4740,5082,342,6.7
1263,2006,December,Dawson                                               ,Not Adjusted,4793,5046,253,5.0
1264,2006,March,Deaf Smith                                           ,Not Adjusted,7695,8057,362,4.5
1265,2006,June,Deaf Smith                                           ,Not Adjusted,8064,8467,403,4.8
1266,2006,September,Deaf Smith                                           ,Not Adjusted,7843,8179,336,4.1
1267,2006,December,Deaf Smith                                           ,Not Adjusted,7993,8300,307,3.7
1268,2006,March,Delta                                                ,Not Adjusted,2261,2395,134,5.6
1269,2006,June,Delta                                                ,Not Adjusted,2294,2440,146,6.0
1270,2006,September,Delta                                                ,Not Adjusted,2302,2421,119,4.9
1271,2006,December,Delta                                                ,Not Adjusted,2328,2427,99,4.1
1272,2006,March,Denton                                               ,Not Adjusted,308729,323290,14561,4.5
1273,2006,June,Denton                                               ,Not Adjusted,313126,328802,15676,4.8
1274,2006,September,Denton                                               ,Not Adjusted,314260,327856,13596,4.1
1275,2006,December,Denton                                               ,Not Adjusted,317779,329571,11792,3.6
1276,2006,March,DeWitt                                               ,Not Adjusted,8860,9292,432,4.6
1277,2006,June,DeWitt                                               ,Not Adjusted,9011,9474,463,4.9
1278,2006,September,DeWitt                                               ,Not Adjusted,8727,9123,396,4.3
1279,2006,December,DeWitt                                               ,Not Adjusted,8659,8993,334,3.7
1280,2006,March,Dickens                                              ,Not Adjusted,1101,1151,50,4.3
1281,2006,June,Dickens                                              ,Not Adjusted,1210,1264,54,4.3
1282,2006,September,Dickens                                              ,Not Adjusted,1119,1169,50,4.3
1283,2006,December,Dickens                                              ,Not Adjusted,1170,1217,47,3.9
1284,2006,March,Dimmit                                               ,Not Adjusted,3468,3779,311,8.2
1285,2006,June,Dimmit                                               ,Not Adjusted,3591,3899,308,7.9
1286,2006,September,Dimmit                                               ,Not Adjusted,3500,3780,280,7.4
1287,2006,December,Dimmit                                               ,Not Adjusted,3658,3954,296,7.5
1288,2006,March,Donley                                               ,Not Adjusted,1645,1737,92,5.3
1289,2006,June,Donley                                               ,Not Adjusted,1798,1910,112,5.9
1290,2006,September,Donley                                               ,Not Adjusted,1688,1762,74,4.2
1291,2006,December,Donley                                               ,Not Adjusted,1776,1843,67,3.6
1292,2006,March,Duval                                                ,Not Adjusted,4958,5253,295,5.6
1293,2006,June,Duval                                                ,Not Adjusted,5004,5342,338,6.3
1294,2006,September,Duval                                                ,Not Adjusted,4947,5225,278,5.3
1295,2006,December,Duval                                                ,Not Adjusted,4892,5117,225,4.4
1296,2006,March,Eastland                                             ,Not Adjusted,7951,8371,420,5.0
1297,2006,June,Eastland                                             ,Not Adjusted,7976,8457,481,5.7
1298,2006,September,Eastland                                             ,Not Adjusted,7818,8200,382,4.7
1299,2006,December,Eastland                                             ,Not Adjusted,7887,8214,327,4.0
1300,2006,March,Ector                                                ,Not Adjusted,61822,64464,2642,4.1
1301,2006,June,Ector                                                ,Not Adjusted,62002,64950,2948,4.5
1302,2006,September,Ector                                                ,Not Adjusted,63604,66060,2456,3.7
1303,2006,December,Ector                                                ,Not Adjusted,64072,66086,2014,3.0
1304,2006,March,Edwards                                              ,Not Adjusted,862,903,41,4.5
1305,2006,June,Edwards                                              ,Not Adjusted,995,1045,50,4.8
1306,2006,September,Edwards                                              ,Not Adjusted,885,926,41,4.4
1307,2006,December,Edwards                                              ,Not Adjusted,968,1003,35,3.5
1308,2006,March,Ellis                                                ,Not Adjusted,64059,67812,3753,5.5
1309,2006,June,Ellis                                                ,Not Adjusted,64970,68839,3869,5.6
1310,2006,September,Ellis                                                ,Not Adjusted,65207,68462,3255,4.8
1311,2006,December,Ellis                                                ,Not Adjusted,65937,68717,2780,4.0
1312,2006,March,El Paso                                              ,Not Adjusted,272305,292138,19833,6.8
1313,2006,June,El Paso                                              ,Not Adjusted,268256,289839,21583,7.4
1314,2006,September,El Paso                                              ,Not Adjusted,273154,293120,19966,6.8
1315,2006,December,El Paso                                              ,Not Adjusted,276280,293961,17681,6.0
1316,2006,March,Erath                                                ,Not Adjusted,16820,17562,742,4.2
1317,2006,June,Erath                                                ,Not Adjusted,17136,17994,858,4.8
1318,2006,September,Erath                                                ,Not Adjusted,17044,17738,694,3.9
1319,2006,December,Erath                                                ,Not Adjusted,17750,18324,574,3.1
1320,2006,March,Falls                                                ,Not Adjusted,6570,7037,467,6.6
1321,2006,June,Falls                                                ,Not Adjusted,6728,7252,524,7.2
1322,2006,September,Falls                                                ,Not Adjusted,6596,7016,420,6.0
1323,2006,December,Falls                                                ,Not Adjusted,6594,6945,351,5.1
1324,2006,March,Fannin                                               ,Not Adjusted,12721,13584,863,6.4
1325,2006,June,Fannin                                               ,Not Adjusted,12802,13689,887,6.5
1326,2006,September,Fannin                                               ,Not Adjusted,12533,13319,786,5.9
1327,2006,December,Fannin                                               ,Not Adjusted,12519,13183,664,5.0
1328,2006,March,Fayette                                              ,Not Adjusted,11454,11917,463,3.9
1329,2006,June,Fayette                                              ,Not Adjusted,11717,12229,512,4.2
1330,2006,September,Fayette                                              ,Not Adjusted,11469,11896,427,3.6
1331,2006,December,Fayette                                              ,Not Adjusted,11736,12092,356,2.9
1332,2006,March,Fisher                                               ,Not Adjusted,1845,1924,79,4.1
1333,2006,June,Fisher                                               ,Not Adjusted,1915,1998,83,4.2
1334,2006,September,Fisher                                               ,Not Adjusted,1862,1945,83,4.3
1335,2006,December,Fisher                                               ,Not Adjusted,1925,2000,75,3.8
1336,2006,March,Floyd                                                ,Not Adjusted,2861,3072,211,6.9
1337,2006,June,Floyd                                                ,Not Adjusted,3034,3254,220,6.8
1338,2006,September,Floyd                                                ,Not Adjusted,3005,3174,169,5.3
1339,2006,December,Floyd                                                ,Not Adjusted,2927,3070,143,4.7
1340,2006,March,Foard                                                ,Not Adjusted,610,638,28,4.4
1341,2006,June,Foard                                                ,Not Adjusted,677,716,39,5.4
1342,2006,September,Foard                                                ,Not Adjusted,654,684,30,4.4
1343,2006,December,Foard                                                ,Not Adjusted,644,668,24,3.6
1344,2006,March,Fort Bend                                            ,Not Adjusted,230668,242865,12197,5.0
1345,2006,June,Fort Bend                                            ,Not Adjusted,231501,244472,12971,5.3
1346,2006,September,Fort Bend                                            ,Not Adjusted,234463,245996,11533,4.7
1347,2006,December,Fort Bend                                            ,Not Adjusted,238345,247877,9532,3.8
1348,2006,March,Franklin                                             ,Not Adjusted,5276,5512,236,4.3
1349,2006,June,Franklin                                             ,Not Adjusted,5196,5455,259,4.7
1350,2006,September,Franklin                                             ,Not Adjusted,5264,5486,222,4.0
1351,2006,December,Franklin                                             ,Not Adjusted,5263,5473,210,3.8
1352,2006,March,Freestone                                            ,Not Adjusted,9696,10115,419,4.1
1353,2006,June,Freestone                                            ,Not Adjusted,9787,10238,451,4.4
1354,2006,September,Freestone                                            ,Not Adjusted,9641,10040,399,4.0
1355,2006,December,Freestone                                            ,Not Adjusted,9597,9931,334,3.4
1356,2006,March,Frio                                                 ,Not Adjusted,6010,6368,358,5.6
1357,2006,June,Frio                                                 ,Not Adjusted,6209,6625,416,6.3
1358,2006,September,Frio                                                 ,Not Adjusted,6126,6462,336,5.2
1359,2006,December,Frio                                                 ,Not Adjusted,6194,6485,291,4.5
1360,2006,March,Gaines                                               ,Not Adjusted,5587,5893,306,5.2
1361,2006,June,Gaines                                               ,Not Adjusted,6028,6349,321,5.1
1362,2006,September,Gaines                                               ,Not Adjusted,5659,5928,269,4.5
1363,2006,December,Gaines                                               ,Not Adjusted,6108,6316,208,3.3
1364,2006,March,Galveston                                            ,Not Adjusted,129162,136295,7133,5.2
1365,2006,June,Galveston                                            ,Not Adjusted,129630,137803,8173,5.9
1366,2006,September,Galveston                                            ,Not Adjusted,131288,138353,7065,5.1
1367,2006,December,Galveston                                            ,Not Adjusted,133462,139496,6034,4.3
1368,2006,March,Garza                                                ,Not Adjusted,2333,2440,107,4.4
1369,2006,June,Garza                                                ,Not Adjusted,2465,2573,108,4.2
1370,2006,September,Garza                                                ,Not Adjusted,2393,2493,100,4.0
1371,2006,December,Garza                                                ,Not Adjusted,2592,2670,78,2.9
1372,2006,March,Gillespie                                            ,Not Adjusted,12165,12595,430,3.4
1373,2006,June,Gillespie                                            ,Not Adjusted,12772,13247,475,3.6
1374,2006,September,Gillespie                                            ,Not Adjusted,12187,12607,420,3.3
1375,2006,December,Gillespie                                            ,Not Adjusted,12590,12922,332,2.6
1376,2006,March,Glasscock                                            ,Not Adjusted,518,543,25,4.6
1377,2006,June,Glasscock                                            ,Not Adjusted,597,629,32,5.1
1378,2006,September,Glasscock                                            ,Not Adjusted,541,567,26,4.6
1379,2006,December,Glasscock                                            ,Not Adjusted,575,595,20,3.4
1380,2006,March,Goliad                                               ,Not Adjusted,3270,3418,148,4.3
1381,2006,June,Goliad                                               ,Not Adjusted,3315,3460,145,4.2
1382,2006,September,Goliad                                               ,Not Adjusted,3314,3442,128,3.7
1383,2006,December,Goliad                                               ,Not Adjusted,3317,3436,119,3.5
1384,2006,March,Gonzales                                             ,Not Adjusted,9101,9501,400,4.2
1385,2006,June,Gonzales                                             ,Not Adjusted,9629,10080,451,4.5
1386,2006,September,Gonzales                                             ,Not Adjusted,9361,9740,379,3.9
1387,2006,December,Gonzales                                             ,Not Adjusted,9427,9762,335,3.4
1388,2006,March,Gray                                                 ,Not Adjusted,10338,10770,432,4.0
1389,2006,June,Gray                                                 ,Not Adjusted,10665,11148,483,4.3
1390,2006,September,Gray                                                 ,Not Adjusted,10505,10934,429,3.9
1391,2006,December,Gray                                                 ,Not Adjusted,10612,10964,352,3.2
1392,2006,March,Grayson                                              ,Not Adjusted,53583,56512,2929,5.2
1393,2006,June,Grayson                                              ,Not Adjusted,53487,56542,3055,5.4
1394,2006,September,Grayson                                              ,Not Adjusted,53649,56292,2643,4.7
1395,2006,December,Grayson                                              ,Not Adjusted,53553,55813,2260,4.0
1396,2006,March,Gregg                                                ,Not Adjusted,58093,60948,2855,4.7
1397,2006,June,Gregg                                                ,Not Adjusted,58369,61499,3130,5.1
1398,2006,September,Gregg                                                ,Not Adjusted,58855,61523,2668,4.3
1399,2006,December,Gregg                                                ,Not Adjusted,59746,62042,2296,3.7
1400,2006,March,Grimes                                               ,Not Adjusted,9709,10313,604,5.9
1401,2006,June,Grimes                                               ,Not Adjusted,9895,10539,644,6.1
1402,2006,September,Grimes                                               ,Not Adjusted,10065,10609,544,5.1
1403,2006,December,Grimes                                               ,Not Adjusted,10098,10556,458,4.3
1404,2006,March,Guadalupe                                            ,Not Adjusted,51429,53854,2425,4.5
1405,2006,June,Guadalupe                                            ,Not Adjusted,51925,54584,2659,4.9
1406,2006,September,Guadalupe                                            ,Not Adjusted,52127,54460,2333,4.3
1407,2006,December,Guadalupe                                            ,Not Adjusted,52497,54479,1982,3.6
1408,2006,March,Hale                                                 ,Not Adjusted,15349,16311,962,5.9
1409,2006,June,Hale                                                 ,Not Adjusted,15792,16874,1082,6.4
1410,2006,September,Hale                                                 ,Not Adjusted,15756,16566,810,4.9
1411,2006,December,Hale                                                 ,Not Adjusted,15870,16533,663,4.0
1412,2006,March,Hall                                                 ,Not Adjusted,1404,1514,110,7.3
1413,2006,June,Hall                                                 ,Not Adjusted,1412,1504,92,6.1
1414,2006,September,Hall                                                 ,Not Adjusted,1332,1409,77,5.5
1415,2006,December,Hall                                                 ,Not Adjusted,1351,1425,74,5.2
1416,2006,March,Hamilton                                             ,Not Adjusted,3760,3930,170,4.3
1417,2006,June,Hamilton                                             ,Not Adjusted,3941,4133,192,4.6
1418,2006,September,Hamilton                                             ,Not Adjusted,3842,4007,165,4.1
1419,2006,December,Hamilton                                             ,Not Adjusted,3930,4063,133,3.3
1420,2006,March,Hansford                                             ,Not Adjusted,2181,2266,85,3.8
1421,2006,June,Hansford                                             ,Not Adjusted,2454,2556,102,4.0
1422,2006,September,Hansford                                             ,Not Adjusted,2273,2360,87,3.7
1423,2006,December,Hansford                                             ,Not Adjusted,2352,2421,69,2.9
1424,2006,March,Hardeman                                             ,Not Adjusted,2216,2309,93,4.0
1425,2006,June,Hardeman                                             ,Not Adjusted,2302,2413,111,4.6
1426,2006,September,Hardeman                                             ,Not Adjusted,2197,2291,94,4.1
1427,2006,December,Hardeman                                             ,Not Adjusted,2229,2308,79,3.4
1428,2006,March,Hardin                                               ,Not Adjusted,24112,25511,1399,5.5
1429,2006,June,Hardin                                               ,Not Adjusted,24021,25529,1508,5.9
1430,2006,September,Hardin                                               ,Not Adjusted,24106,25389,1283,5.1
1431,2006,December,Hardin                                               ,Not Adjusted,24509,25621,1112,4.3
1432,2006,March,Harris                                               ,Not Adjusted,1762535,1861147,98612,5.3
1433,2006,June,Harris                                               ,Not Adjusted,1768911,1873259,104348,5.6
1434,2006,September,Harris                                               ,Not Adjusted,1791544,1884112,92568,4.9
1435,2006,December,Harris                                               ,Not Adjusted,1821206,1899403,78197,4.1
1436,2006,March,Harrison                                             ,Not Adjusted,29621,31216,1595,5.1
1437,2006,June,Harrison                                             ,Not Adjusted,29718,31534,1816,5.8
1438,2006,September,Harrison                                             ,Not Adjusted,29893,31463,1570,5.0
1439,2006,December,Harrison                                             ,Not Adjusted,30498,31822,1324,4.2
1440,2006,March,Hartley                                              ,Not Adjusted,2035,2122,87,4.1
1441,2006,June,Hartley                                              ,Not Adjusted,2195,2294,99,4.3
1442,2006,September,Hartley                                              ,Not Adjusted,2110,2202,92,4.2
1443,2006,December,Hartley                                              ,Not Adjusted,2202,2272,70,3.1
1444,2006,March,Haskell                                              ,Not Adjusted,2904,3025,121,4.0
1445,2006,June,Haskell                                              ,Not Adjusted,2964,3089,125,4.0
1446,2006,September,Haskell                                              ,Not Adjusted,2710,2827,117,4.1
1447,2006,December,Haskell                                              ,Not Adjusted,2775,2870,95,3.3
1448,2006,March,Hays                                                 ,Not Adjusted,65341,68337,2996,4.4
1449,2006,June,Hays                                                 ,Not Adjusted,66441,69897,3456,4.9
1450,2006,September,Hays                                                 ,Not Adjusted,67298,70152,2854,4.1
1451,2006,December,Hays                                                 ,Not Adjusted,68413,70823,2410,3.4
1452,2006,March,Hemphill                                             ,Not Adjusted,2171,2238,67,3.0
1453,2006,June,Hemphill                                             ,Not Adjusted,2283,2361,78,3.3
1454,2006,September,Hemphill                                             ,Not Adjusted,2322,2382,60,2.5
1455,2006,December,Hemphill                                             ,Not Adjusted,2299,2349,50,2.1
1456,2006,March,Henderson                                            ,Not Adjusted,32605,34438,1833,5.3
1457,2006,June,Henderson                                            ,Not Adjusted,32833,34796,1963,5.6
1458,2006,September,Henderson                                            ,Not Adjusted,32762,34541,1779,5.2
1459,2006,December,Henderson                                            ,Not Adjusted,32861,34425,1564,4.5
1460,2006,March,Hidalgo                                              ,Not Adjusted,246024,266766,20742,7.8
1461,2006,June,Hidalgo                                              ,Not Adjusted,244807,266314,21507,8.1
1462,2006,September,Hidalgo                                              ,Not Adjusted,244130,262788,18658,7.1
1463,2006,December,Hidalgo                                              ,Not Adjusted,254027,272979,18952,6.9
1464,2006,March,Hill                                                 ,Not Adjusted,14033,14917,884,5.9
1465,2006,June,Hill                                                 ,Not Adjusted,14462,15407,945,6.1
1466,2006,September,Hill                                                 ,Not Adjusted,14254,15074,820,5.4
1467,2006,December,Hill                                                 ,Not Adjusted,14451,15176,725,4.8
1468,2006,March,Hockley                                              ,Not Adjusted,10753,11270,517,4.6
1469,2006,June,Hockley                                              ,Not Adjusted,10982,11548,566,4.9
1470,2006,September,Hockley                                              ,Not Adjusted,10788,11249,461,4.1
1471,2006,December,Hockley                                              ,Not Adjusted,11117,11496,379,3.3
1472,2006,March,Hood                                                 ,Not Adjusted,21614,22797,1183,5.2
1473,2006,June,Hood                                                 ,Not Adjusted,21873,23141,1268,5.5
1474,2006,September,Hood                                                 ,Not Adjusted,22270,23380,1110,4.7
1475,2006,December,Hood                                                 ,Not Adjusted,22163,23124,961,4.2
1476,2006,March,Hopkins                                              ,Not Adjusted,16434,17180,746,4.3
1477,2006,June,Hopkins                                              ,Not Adjusted,17019,17834,815,4.6
1478,2006,September,Hopkins                                              ,Not Adjusted,16653,17377,724,4.2
1479,2006,December,Hopkins                                              ,Not Adjusted,16347,16967,620,3.7
1480,2006,March,Houston                                              ,Not Adjusted,7537,8053,516,6.4
1481,2006,June,Houston                                              ,Not Adjusted,7661,8223,562,6.8
1482,2006,September,Houston                                              ,Not Adjusted,7426,7913,487,6.2
1483,2006,December,Houston                                              ,Not Adjusted,7549,7960,411,5.2
1484,2006,March,Howard                                               ,Not Adjusted,12775,13475,700,5.2
1485,2006,June,Howard                                               ,Not Adjusted,13068,13836,768,5.6
1486,2006,September,Howard                                               ,Not Adjusted,13077,13713,636,4.6
1487,2006,December,Howard                                               ,Not Adjusted,13325,13834,509,3.7
1488,2006,March,Hudspeth                                             ,Not Adjusted,1204,1325,121,9.1
1489,2006,June,Hudspeth                                             ,Not Adjusted,1312,1418,106,7.5
1490,2006,September,Hudspeth                                             ,Not Adjusted,1405,1496,91,6.1
1491,2006,December,Hudspeth                                             ,Not Adjusted,1396,1472,76,5.2
1492,2006,March,Hunt                                                 ,Not Adjusted,35952,38059,2107,5.5
1493,2006,June,Hunt                                                 ,Not Adjusted,36463,38769,2306,5.9
1494,2006,September,Hunt                                                 ,Not Adjusted,36596,38577,1981,5.1
1495,2006,December,Hunt                                                 ,Not Adjusted,37005,38749,1744,4.5
1496,2006,March,Hutchinson                                           ,Not Adjusted,10234,10683,449,4.2
1497,2006,June,Hutchinson                                           ,Not Adjusted,10669,11220,551,4.9
1498,2006,September,Hutchinson                                           ,Not Adjusted,10772,11280,508,4.5
1499,2006,December,Hutchinson                                           ,Not Adjusted,10700,11125,425,3.8
1500,2006,March,Irion                                                ,Not Adjusted,950,988,38,3.8
1501,2006,June,Irion                                                ,Not Adjusted,969,1013,44,4.3
1502,2006,September,Irion                                                ,Not Adjusted,949,981,32,3.3
1503,2006,December,Irion                                                ,Not Adjusted,959,983,24,2.4
1504,2006,March,Jack                                                 ,Not Adjusted,4024,4216,192,4.6
1505,2006,June,Jack                                                 ,Not Adjusted,4176,4378,202,4.6
1506,2006,September,Jack                                                 ,Not Adjusted,4204,4388,184,4.2
1507,2006,December,Jack                                                 ,Not Adjusted,4378,4527,149,3.3
1508,2006,March,Jackson                                              ,Not Adjusted,6020,6324,304,4.8
1509,2006,June,Jackson                                              ,Not Adjusted,6285,6617,332,5.0
1510,2006,September,Jackson                                              ,Not Adjusted,6089,6369,280,4.4
1511,2006,December,Jackson                                              ,Not Adjusted,6211,6446,235,3.6
1512,2006,March,Jasper                                               ,Not Adjusted,14410,15448,1038,6.7
1513,2006,June,Jasper                                               ,Not Adjusted,14801,15881,1080,6.8
1514,2006,September,Jasper                                               ,Not Adjusted,14797,15725,928,5.9
1515,2006,December,Jasper                                               ,Not Adjusted,14882,15761,879,5.6
1516,2006,March,Jeff Davis                                           ,Not Adjusted,1136,1189,53,4.5
1517,2006,June,Jeff Davis                                           ,Not Adjusted,1195,1249,54,4.3
1518,2006,September,Jeff Davis                                           ,Not Adjusted,1115,1160,45,3.9
1519,2006,December,Jeff Davis                                           ,Not Adjusted,1156,1195,39,3.3
1520,2006,March,Jefferson                                            ,Not Adjusted,105230,112388,7158,6.4
1521,2006,June,Jefferson                                            ,Not Adjusted,104832,112224,7392,6.6
1522,2006,September,Jefferson                                            ,Not Adjusted,105203,111729,6526,5.8
1523,2006,December,Jefferson                                            ,Not Adjusted,106966,112853,5887,5.2
1524,2006,March,Jim Hogg                                             ,Not Adjusted,2510,2627,117,4.5
1525,2006,June,Jim Hogg                                             ,Not Adjusted,2538,2677,139,5.2
1526,2006,September,Jim Hogg                                             ,Not Adjusted,2657,2768,111,4.0
1527,2006,December,Jim Hogg                                             ,Not Adjusted,2625,2714,89,3.3
1528,2006,March,Jim Wells                                            ,Not Adjusted,18962,19930,968,4.9
1529,2006,June,Jim Wells                                            ,Not Adjusted,19634,20761,1127,5.4
1530,2006,September,Jim Wells                                            ,Not Adjusted,19797,20744,947,4.6
1531,2006,December,Jim Wells                                            ,Not Adjusted,20048,20880,832,4.0
1532,2006,March,Johnson                                              ,Not Adjusted,68485,71969,3484,4.8
1533,2006,June,Johnson                                              ,Not Adjusted,68946,72788,3842,5.3
1534,2006,September,Johnson                                              ,Not Adjusted,69498,72868,3370,4.6
1535,2006,December,Johnson                                              ,Not Adjusted,70529,73390,2861,3.9
1536,2006,March,Jones                                                ,Not Adjusted,7482,7931,449,5.7
1537,2006,June,Jones                                                ,Not Adjusted,7636,8125,489,6.0
1538,2006,September,Jones                                                ,Not Adjusted,7572,7992,420,5.3
1539,2006,December,Jones                                                ,Not Adjusted,7606,7940,334,4.2
1540,2006,March,Karnes                                               ,Not Adjusted,5018,5337,319,6.0
1541,2006,June,Karnes                                               ,Not Adjusted,5142,5543,401,7.2
1542,2006,September,Karnes                                               ,Not Adjusted,4938,5264,326,6.2
1543,2006,December,Karnes                                               ,Not Adjusted,4899,5162,263,5.1
1544,2006,March,Kaufman                                              ,Not Adjusted,41582,43869,2287,5.2
1545,2006,June,Kaufman                                              ,Not Adjusted,42174,44622,2448,5.5
1546,2006,September,Kaufman                                              ,Not Adjusted,42327,44556,2229,5.0
1547,2006,December,Kaufman                                              ,Not Adjusted,42801,44822,2021,4.5
1548,2006,March,Kendall                                              ,Not Adjusted,14344,14962,618,4.1
1549,2006,June,Kendall                                              ,Not Adjusted,14483,15154,671,4.4
1550,2006,September,Kendall                                              ,Not Adjusted,14539,15114,575,3.8
1551,2006,December,Kendall                                              ,Not Adjusted,14642,15143,501,3.3
1552,2006,March,Kenedy                                               ,Not Adjusted,234,240,6,2.5
1553,2006,June,Kenedy                                               ,Not Adjusted,238,245,7,2.9
1554,2006,September,Kenedy                                               ,Not Adjusted,235,241,6,2.5
1555,2006,December,Kenedy                                               ,Not Adjusted,240,247,7,2.8
1556,2006,March,Kent                                                 ,Not Adjusted,371,388,17,4.4
1557,2006,June,Kent                                                 ,Not Adjusted,415,432,17,3.9
1558,2006,September,Kent                                                 ,Not Adjusted,385,401,16,4.0
1559,2006,December,Kent                                                 ,Not Adjusted,400,416,16,3.8
1560,2006,March,Kerr                                                 ,Not Adjusted,21388,22340,952,4.3
1561,2006,June,Kerr                                                 ,Not Adjusted,22069,23122,1053,4.6
1562,2006,September,Kerr                                                 ,Not Adjusted,21377,22277,900,4.0
1563,2006,December,Kerr                                                 ,Not Adjusted,21583,22317,734,3.3
1564,2006,March,Kimble                                               ,Not Adjusted,2140,2232,92,4.1
1565,2006,June,Kimble                                               ,Not Adjusted,2204,2297,93,4.0
1566,2006,September,Kimble                                               ,Not Adjusted,2079,2163,84,3.9
1567,2006,December,Kimble                                               ,Not Adjusted,2159,2227,68,3.1
1568,2006,March,King                                                 ,Not Adjusted,144,150,6,4.0
1569,2006,June,King                                                 ,Not Adjusted,172,182,10,5.5
1570,2006,September,King                                                 ,Not Adjusted,149,155,6,3.9
1571,2006,December,King                                                 ,Not Adjusted,158,166,8,4.8
1572,2006,March,Kinney                                               ,Not Adjusted,1215,1307,92,7.0
1573,2006,June,Kinney                                               ,Not Adjusted,1237,1317,80,6.1
1574,2006,September,Kinney                                               ,Not Adjusted,1227,1291,64,5.0
1575,2006,December,Kinney                                               ,Not Adjusted,1325,1393,68,4.9
1576,2006,March,Kleberg                                              ,Not Adjusted,15319,16059,740,4.6
1577,2006,June,Kleberg                                              ,Not Adjusted,15565,16432,867,5.3
1578,2006,September,Kleberg                                              ,Not Adjusted,15372,16086,714,4.4
1579,2006,December,Kleberg                                              ,Not Adjusted,15652,16298,646,4.0
1580,2006,March,Knox                                                 ,Not Adjusted,1640,1718,78,4.5
1581,2006,June,Knox                                                 ,Not Adjusted,1757,1845,88,4.8
1582,2006,September,Knox                                                 ,Not Adjusted,1676,1743,67,3.8
1583,2006,December,Knox                                                 ,Not Adjusted,1723,1782,59,3.3
1584,2006,March,Lamar                                                ,Not Adjusted,22059,23413,1354,5.8
1585,2006,June,Lamar                                                ,Not Adjusted,22430,23854,1424,6.0
1586,2006,September,Lamar                                                ,Not Adjusted,22498,23725,1227,5.2
1587,2006,December,Lamar                                                ,Not Adjusted,22478,23580,1102,4.7
1588,2006,March,Lamb                                                 ,Not Adjusted,6581,6925,344,5.0
1589,2006,June,Lamb                                                 ,Not Adjusted,6985,7365,380,5.2
1590,2006,September,Lamb                                                 ,Not Adjusted,6704,7020,316,4.5
1591,2006,December,Lamb                                                 ,Not Adjusted,6729,6979,250,3.6
1592,2006,March,Lampasas                                             ,Not Adjusted,9920,10344,424,4.1
1593,2006,June,Lampasas                                             ,Not Adjusted,10102,10610,508,4.8
1594,2006,September,Lampasas                                             ,Not Adjusted,10071,10471,400,3.8
1595,2006,December,Lampasas                                             ,Not Adjusted,10247,10592,345,3.3
1596,2006,March,La Salle                                             ,Not Adjusted,2443,2588,145,5.6
1597,2006,June,La Salle                                             ,Not Adjusted,2627,2792,165,5.9
1598,2006,September,La Salle                                             ,Not Adjusted,2694,2824,130,4.6
1599,2006,December,La Salle                                             ,Not Adjusted,2601,2724,123,4.5
1600,2006,March,Lavaca                                               ,Not Adjusted,9814,10224,410,4.0
1601,2006,June,Lavaca                                               ,Not Adjusted,10109,10529,420,4.0
1602,2006,September,Lavaca                                               ,Not Adjusted,9804,10163,359,3.5
1603,2006,December,Lavaca                                               ,Not Adjusted,9855,10155,300,3.0
1604,2006,March,Lee                                                  ,Not Adjusted,8257,8625,368,4.3
1605,2006,June,Lee                                                  ,Not Adjusted,8541,8967,426,4.8
1606,2006,September,Lee                                                  ,Not Adjusted,8446,8785,339,3.9
1607,2006,December,Lee                                                  ,Not Adjusted,8597,8874,277,3.1
1608,2006,March,Leon                                                 ,Not Adjusted,7141,7523,382,5.1
1609,2006,June,Leon                                                 ,Not Adjusted,7368,7807,439,5.6
1610,2006,September,Leon                                                 ,Not Adjusted,7247,7623,376,4.9
1611,2006,December,Leon                                                 ,Not Adjusted,7254,7572,318,4.2
1612,2006,March,Liberty                                              ,Not Adjusted,28601,30359,1758,5.8
1613,2006,June,Liberty                                              ,Not Adjusted,28705,30778,2073,6.7
1614,2006,September,Liberty                                              ,Not Adjusted,29072,30847,1775,5.8
1615,2006,December,Liberty                                              ,Not Adjusted,29554,31076,1522,4.9
1616,2006,March,Limestone                                            ,Not Adjusted,9690,10200,510,5.0
1617,2006,June,Limestone                                            ,Not Adjusted,9890,10452,562,5.4
1618,2006,September,Limestone                                            ,Not Adjusted,9749,10224,475,4.6
1619,2006,December,Limestone                                            ,Not Adjusted,9805,10198,393,3.9
1620,2006,March,Lipscomb                                             ,Not Adjusted,1588,1649,61,3.7
1621,2006,June,Lipscomb                                             ,Not Adjusted,1663,1728,65,3.8
1622,2006,September,Lipscomb                                             ,Not Adjusted,1699,1756,57,3.2
1623,2006,December,Lipscomb                                             ,Not Adjusted,1737,1785,48,2.7
1624,2006,March,Live Oak                                             ,Not Adjusted,4696,4927,231,4.7
1625,2006,June,Live Oak                                             ,Not Adjusted,4856,5123,267,5.2
1626,2006,September,Live Oak                                             ,Not Adjusted,4951,5174,223,4.3
1627,2006,December,Live Oak                                             ,Not Adjusted,4887,5072,185,3.6
1628,2006,March,Llano                                                ,Not Adjusted,7637,8041,404,5.0
1629,2006,June,Llano                                                ,Not Adjusted,8000,8425,425,5.0
1630,2006,September,Llano                                                ,Not Adjusted,7730,8106,376,4.6
1631,2006,December,Llano                                                ,Not Adjusted,7723,8024,301,3.8
1632,2006,March,Loving                                               ,Not Adjusted,33,37,4,10.8
1633,2006,June,Loving                                               ,Not Adjusted,35,39,4,10.3
1634,2006,September,Loving                                               ,Not Adjusted,34,38,4,10.5
1635,2006,December,Loving                                               ,Not Adjusted,37,41,4,9.8
1636,2006,March,Lubbock                                              ,Not Adjusted,131435,137479,6044,4.4
1637,2006,June,Lubbock                                              ,Not Adjusted,130207,136869,6662,4.9
1638,2006,September,Lubbock                                              ,Not Adjusted,132722,138018,5296,3.8
1639,2006,December,Lubbock                                              ,Not Adjusted,133859,138136,4277,3.1
1640,2006,March,Lynn                                                 ,Not Adjusted,2485,2649,164,6.2
1641,2006,June,Lynn                                                 ,Not Adjusted,2724,2909,185,6.4
1642,2006,September,Lynn                                                 ,Not Adjusted,2605,2760,155,5.6
1643,2006,December,Lynn                                                 ,Not Adjusted,2641,2762,121,4.4
1644,2006,March,McCulloch                                            ,Not Adjusted,3490,3667,177,4.8
1645,2006,June,McCulloch                                            ,Not Adjusted,3587,3781,194,5.1
1646,2006,September,McCulloch                                            ,Not Adjusted,3525,3690,165,4.5
1647,2006,December,McCulloch                                            ,Not Adjusted,3671,3803,132,3.5
1648,2006,March,McLennan                                             ,Not Adjusted,105538,111223,5685,5.1
1649,2006,June,McLennan                                             ,Not Adjusted,106109,112469,6360,5.7
1650,2006,September,McLennan                                             ,Not Adjusted,106991,112180,5189,4.6
1651,2006,December,McLennan                                             ,Not Adjusted,106858,111157,4299,3.9
1652,2006,March,McMullen                                             ,Not Adjusted,320,339,19,5.6
1653,2006,June,McMullen                                             ,Not Adjusted,332,355,23,6.5
1654,2006,September,McMullen                                             ,Not Adjusted,314,331,17,5.1
1655,2006,December,McMullen                                             ,Not Adjusted,324,341,17,5.0
1656,2006,March,Madison                                              ,Not Adjusted,4562,4835,273,5.6
1657,2006,June,Madison                                              ,Not Adjusted,4773,5071,298,5.9
1658,2006,September,Madison                                              ,Not Adjusted,4670,4921,251,5.1
1659,2006,December,Madison                                              ,Not Adjusted,4803,5020,217,4.3
1660,2006,March,Marion                                               ,Not Adjusted,4716,5002,286,5.7
1661,2006,June,Marion                                               ,Not Adjusted,4743,5035,292,5.8
1662,2006,September,Marion                                               ,Not Adjusted,4690,4948,258,5.2
1663,2006,December,Marion                                               ,Not Adjusted,4741,4958,217,4.4
1664,2006,March,Martin                                               ,Not Adjusted,1957,2055,98,4.8
1665,2006,June,Martin                                               ,Not Adjusted,2107,2210,103,4.7
1666,2006,September,Martin                                               ,Not Adjusted,2044,2127,83,3.9
1667,2006,December,Martin                                               ,Not Adjusted,2098,2163,65,3.0
1668,2006,March,Mason                                                ,Not Adjusted,2344,2414,70,2.9
1669,2006,June,Mason                                                ,Not Adjusted,2430,2521,91,3.6
1670,2006,September,Mason                                                ,Not Adjusted,2414,2488,74,3.0
1671,2006,December,Mason                                                ,Not Adjusted,2392,2454,62,2.5
1672,2006,March,Matagorda                                            ,Not Adjusted,14613,15751,1138,7.2
1673,2006,June,Matagorda                                            ,Not Adjusted,15083,16434,1351,8.2
1674,2006,September,Matagorda                                            ,Not Adjusted,14990,16056,1066,6.6
1675,2006,December,Matagorda                                            ,Not Adjusted,15211,16159,948,5.9
1676,2006,March,Maverick                                             ,Not Adjusted,16909,20276,3367,16.6
1677,2006,June,Maverick                                             ,Not Adjusted,16913,19258,2345,12.2
1678,2006,September,Maverick                                             ,Not Adjusted,17063,18728,1665,8.9
1679,2006,December,Maverick                                             ,Not Adjusted,17624,20305,2681,13.2
1680,2006,March,Medina                                               ,Not Adjusted,18677,19608,931,4.7
1681,2006,June,Medina                                               ,Not Adjusted,18858,19864,1006,5.1
1682,2006,September,Medina                                               ,Not Adjusted,18931,19829,898,4.5
1683,2006,December,Medina                                               ,Not Adjusted,19065,19827,762,3.8
1684,2006,March,Menard                                               ,Not Adjusted,1003,1044,41,3.9
1685,2006,June,Menard                                               ,Not Adjusted,1033,1083,50,4.6
1686,2006,September,Menard                                               ,Not Adjusted,1030,1074,44,4.1
1687,2006,December,Menard                                               ,Not Adjusted,1049,1088,39,3.6
1688,2006,March,Midland                                              ,Not Adjusted,65550,67937,2387,3.5
1689,2006,June,Midland                                              ,Not Adjusted,67271,70006,2735,3.9
1690,2006,September,Midland                                              ,Not Adjusted,68211,70548,2337,3.3
1691,2006,December,Midland                                              ,Not Adjusted,68933,70811,1878,2.7
1692,2006,March,Milam                                                ,Not Adjusted,11123,11709,586,5.0
1693,2006,June,Milam                                                ,Not Adjusted,11559,12199,640,5.2
1694,2006,September,Milam                                                ,Not Adjusted,11682,12213,531,4.3
1695,2006,December,Milam                                                ,Not Adjusted,12046,12481,435,3.5
1696,2006,March,Mills                                                ,Not Adjusted,2295,2388,93,3.9
1697,2006,June,Mills                                                ,Not Adjusted,2427,2549,122,4.8
1698,2006,September,Mills                                                ,Not Adjusted,2230,2327,97,4.2
1699,2006,December,Mills                                                ,Not Adjusted,2294,2376,82,3.5
1700,2006,March,Mitchell                                             ,Not Adjusted,3139,3358,219,6.5
1701,2006,June,Mitchell                                             ,Not Adjusted,3190,3419,229,6.7
1702,2006,September,Mitchell                                             ,Not Adjusted,3160,3347,187,5.6
1703,2006,December,Mitchell                                             ,Not Adjusted,3172,3318,146,4.4
1704,2006,March,Montague                                             ,Not Adjusted,9301,9736,435,4.5
1705,2006,June,Montague                                             ,Not Adjusted,9720,10191,471,4.6
1706,2006,September,Montague                                             ,Not Adjusted,9637,10034,397,4.0
1707,2006,December,Montague                                             ,Not Adjusted,9719,10048,329,3.3
1708,2006,March,Montgomery                                           ,Not Adjusted,184789,193844,9055,4.7
1709,2006,June,Montgomery                                           ,Not Adjusted,185458,195237,9779,5.0
1710,2006,September,Montgomery                                           ,Not Adjusted,187830,196190,8360,4.3
1711,2006,December,Montgomery                                           ,Not Adjusted,190940,198049,7109,3.6
1712,2006,March,Moore                                                ,Not Adjusted,9718,10083,365,3.6
1713,2006,June,Moore                                                ,Not Adjusted,10251,10674,423,4.0
1714,2006,September,Moore                                                ,Not Adjusted,10017,10364,347,3.3
1715,2006,December,Moore                                                ,Not Adjusted,9982,10258,276,2.7
1716,2006,March,Morris                                               ,Not Adjusted,5795,6120,325,5.3
1717,2006,June,Morris                                               ,Not Adjusted,5870,6242,372,6.0
1718,2006,September,Morris                                               ,Not Adjusted,5820,6159,339,5.5
1719,2006,December,Morris                                               ,Not Adjusted,5797,6096,299,4.9
1720,2006,March,Motley                                               ,Not Adjusted,573,599,26,4.3
1721,2006,June,Motley                                               ,Not Adjusted,636,664,28,4.2
1722,2006,September,Motley                                               ,Not Adjusted,606,630,24,3.8
1723,2006,December,Motley                                               ,Not Adjusted,616,639,23,3.6
1724,2006,March,Nacogdoches                                          ,Not Adjusted,29319,30844,1525,4.9
1725,2006,June,Nacogdoches                                          ,Not Adjusted,29579,31339,1760,5.6
1726,2006,September,Nacogdoches                                          ,Not Adjusted,29192,30605,1413,4.6
1727,2006,December,Nacogdoches                                          ,Not Adjusted,29492,30664,1172,3.8
1728,2006,March,Navarro                                              ,Not Adjusted,19789,21024,1235,5.9
1729,2006,June,Navarro                                              ,Not Adjusted,19757,21152,1395,6.6
1730,2006,September,Navarro                                              ,Not Adjusted,19862,20998,1136,5.4
1731,2006,December,Navarro                                              ,Not Adjusted,20062,21030,968,4.6
1732,2006,March,Newton                                               ,Not Adjusted,5181,5594,413,7.4
1733,2006,June,Newton                                               ,Not Adjusted,5324,5768,444,7.7
1734,2006,September,Newton                                               ,Not Adjusted,5270,5669,399,7.0
1735,2006,December,Newton                                               ,Not Adjusted,5391,5788,397,6.9
1736,2006,March,Nolan                                                ,Not Adjusted,7247,7595,348,4.6
1737,2006,June,Nolan                                                ,Not Adjusted,7389,7757,368,4.7
1738,2006,September,Nolan                                                ,Not Adjusted,7226,7534,308,4.1
1739,2006,December,Nolan                                                ,Not Adjusted,7239,7512,273,3.6
1740,2006,March,Nueces                                               ,Not Adjusted,149587,157435,7848,5.0
1741,2006,June,Nueces                                               ,Not Adjusted,149410,158175,8765,5.5
1742,2006,September,Nueces                                               ,Not Adjusted,149712,157278,7566,4.8
1743,2006,December,Nueces                                               ,Not Adjusted,151366,158090,6724,4.3
1744,2006,March,Ochiltree                                            ,Not Adjusted,4802,4958,156,3.1
1745,2006,June,Ochiltree                                            ,Not Adjusted,5080,5260,180,3.4
1746,2006,September,Ochiltree                                            ,Not Adjusted,4951,5105,154,3.0
1747,2006,December,Ochiltree                                            ,Not Adjusted,5066,5190,124,2.4
1748,2006,March,Oldham                                               ,Not Adjusted,954,995,41,4.1
1749,2006,June,Oldham                                               ,Not Adjusted,1025,1076,51,4.7
1750,2006,September,Oldham                                               ,Not Adjusted,944,985,41,4.2
1751,2006,December,Oldham                                               ,Not Adjusted,979,1015,36,3.5
1752,2006,March,Orange                                               ,Not Adjusted,38621,41164,2543,6.2
1753,2006,June,Orange                                               ,Not Adjusted,38475,41170,2695,6.5
1754,2006,September,Orange                                               ,Not Adjusted,38611,40930,2319,5.7
1755,2006,December,Orange                                               ,Not Adjusted,39258,41331,2073,5.0
1756,2006,March,Palo Pinto                                           ,Not Adjusted,13542,14188,646,4.6
1757,2006,June,Palo Pinto                                           ,Not Adjusted,14069,14767,698,4.7
1758,2006,September,Palo Pinto                                           ,Not Adjusted,13908,14519,611,4.2
1759,2006,December,Palo Pinto                                           ,Not Adjusted,13609,14139,530,3.7
1760,2006,March,Panola                                               ,Not Adjusted,11223,11752,529,4.5
1761,2006,June,Panola                                               ,Not Adjusted,11584,12170,586,4.8
1762,2006,September,Panola                                               ,Not Adjusted,11591,12099,508,4.2
1763,2006,December,Panola                                               ,Not Adjusted,11590,12046,456,3.8
1764,2006,March,Parker                                               ,Not Adjusted,48944,51403,2459,4.8
1765,2006,June,Parker                                               ,Not Adjusted,49272,51985,2713,5.2
1766,2006,September,Parker                                               ,Not Adjusted,49667,52050,2383,4.6
1767,2006,December,Parker                                               ,Not Adjusted,50405,52459,2054,3.9
1768,2006,March,Parmer                                               ,Not Adjusted,4120,4296,176,4.1
1769,2006,June,Parmer                                               ,Not Adjusted,4274,4473,199,4.4
1770,2006,September,Parmer                                               ,Not Adjusted,4218,4377,159,3.6
1771,2006,December,Parmer                                               ,Not Adjusted,4337,4463,126,2.8
1772,2006,March,Pecos                                                ,Not Adjusted,6204,6530,326,5.0
1773,2006,June,Pecos                                                ,Not Adjusted,6570,6953,383,5.5
1774,2006,September,Pecos                                                ,Not Adjusted,6429,6725,296,4.4
1775,2006,December,Pecos                                                ,Not Adjusted,6443,6683,240,3.6
1776,2006,March,Polk                                                 ,Not Adjusted,15731,16786,1055,6.3
1777,2006,June,Polk                                                 ,Not Adjusted,16075,17222,1147,6.7
1778,2006,September,Polk                                                 ,Not Adjusted,15914,16920,1006,5.9
1779,2006,December,Polk                                                 ,Not Adjusted,15914,16804,890,5.3
1780,2006,March,Potter                                               ,Not Adjusted,54611,57173,2562,4.5
1781,2006,June,Potter                                               ,Not Adjusted,55433,58231,2798,4.8
1782,2006,September,Potter                                               ,Not Adjusted,55485,57926,2441,4.2
1783,2006,December,Potter                                               ,Not Adjusted,55525,57572,2047,3.6
1784,2006,March,Presidio                                             ,Not Adjusted,2842,3168,326,10.3
1785,2006,June,Presidio                                             ,Not Adjusted,2964,3383,419,12.4
1786,2006,September,Presidio                                             ,Not Adjusted,2863,3236,373,11.5
1787,2006,December,Presidio                                             ,Not Adjusted,2865,3164,299,9.5
1788,2006,March,Rains                                                ,Not Adjusted,4887,5149,262,5.1
1789,2006,June,Rains                                                ,Not Adjusted,4913,5197,284,5.5
1790,2006,September,Rains                                                ,Not Adjusted,4863,5097,234,4.6
1791,2006,December,Rains                                                ,Not Adjusted,4903,5105,202,4.0
1792,2006,March,Randall                                              ,Not Adjusted,63919,66193,2274,3.4
1793,2006,June,Randall                                              ,Not Adjusted,64882,67439,2557,3.8
1794,2006,September,Randall                                              ,Not Adjusted,64942,67111,2169,3.2
1795,2006,December,Randall                                              ,Not Adjusted,64989,66787,1798,2.7
1796,2006,March,Reagan                                               ,Not Adjusted,2144,2203,59,2.7
1797,2006,June,Reagan                                               ,Not Adjusted,2222,2290,68,3.0
1798,2006,September,Reagan                                               ,Not Adjusted,2180,2237,57,2.5
1799,2006,December,Reagan                                               ,Not Adjusted,2287,2330,43,1.8
1800,2006,March,Real                                                 ,Not Adjusted,1207,1273,66,5.2
1801,2006,June,Real                                                 ,Not Adjusted,1396,1477,81,5.5
1802,2006,September,Real                                                 ,Not Adjusted,1244,1311,67,5.1
1803,2006,December,Real                                                 ,Not Adjusted,1313,1363,50,3.7
1804,2006,March,Red River                                            ,Not Adjusted,5780,6135,355,5.8
1805,2006,June,Red River                                            ,Not Adjusted,5960,6333,373,5.9
1806,2006,September,Red River                                            ,Not Adjusted,5906,6238,332,5.3
1807,2006,December,Red River                                            ,Not Adjusted,5913,6225,312,5.0
1808,2006,March,Reeves                                               ,Not Adjusted,3818,4093,275,6.7
1809,2006,June,Reeves                                               ,Not Adjusted,3943,4238,295,7.0
1810,2006,September,Reeves                                               ,Not Adjusted,3870,4101,231,5.6
1811,2006,December,Reeves                                               ,Not Adjusted,3905,4097,192,4.7
1812,2006,March,Refugio                                              ,Not Adjusted,3641,3818,177,4.6
1813,2006,June,Refugio                                              ,Not Adjusted,3666,3856,190,4.9
1814,2006,September,Refugio                                              ,Not Adjusted,3625,3803,178,4.7
1815,2006,December,Refugio                                              ,Not Adjusted,3645,3794,149,3.9
1816,2006,March,Roberts                                              ,Not Adjusted,531,549,18,3.3
1817,2006,June,Roberts                                              ,Not Adjusted,548,565,17,3.0
1818,2006,September,Roberts                                              ,Not Adjusted,540,554,14,2.5
1819,2006,December,Roberts                                              ,Not Adjusted,544,557,13,2.3
1820,2006,March,Robertson                                            ,Not Adjusted,7187,7561,374,4.9
1821,2006,June,Robertson                                            ,Not Adjusted,6787,7195,408,5.7
1822,2006,September,Robertson                                            ,Not Adjusted,7225,7593,368,4.8
1823,2006,December,Robertson                                            ,Not Adjusted,7254,7556,302,4.0
1824,2006,March,Rockwall                                             ,Not Adjusted,33150,34742,1592,4.6
1825,2006,June,Rockwall                                             ,Not Adjusted,33622,35363,1741,4.9
1826,2006,September,Rockwall                                             ,Not Adjusted,33744,35329,1585,4.5
1827,2006,December,Rockwall                                             ,Not Adjusted,34122,35461,1339,3.8
1828,2006,March,Runnels                                              ,Not Adjusted,4135,4359,224,5.1
1829,2006,June,Runnels                                              ,Not Adjusted,4255,4515,260,5.8
1830,2006,September,Runnels                                              ,Not Adjusted,4106,4322,216,5.0
1831,2006,December,Runnels                                              ,Not Adjusted,4198,4383,185,4.2
1832,2006,March,Rusk                                                 ,Not Adjusted,21631,22669,1038,4.6
1833,2006,June,Rusk                                                 ,Not Adjusted,21734,22906,1172,5.1
1834,2006,September,Rusk                                                 ,Not Adjusted,21913,23010,1097,4.8
1835,2006,December,Rusk                                                 ,Not Adjusted,22247,23191,944,4.1
1836,2006,March,Sabine                                               ,Not Adjusted,3084,3397,313,9.2
1837,2006,June,Sabine                                               ,Not Adjusted,3224,3545,321,9.1
1838,2006,September,Sabine                                               ,Not Adjusted,3194,3484,290,8.3
1839,2006,December,Sabine                                               ,Not Adjusted,3054,3344,290,8.7
1840,2006,March,San Augustine                                        ,Not Adjusted,3254,3491,237,6.8
1841,2006,June,San Augustine                                        ,Not Adjusted,3430,3681,251,6.8
1842,2006,September,San Augustine                                        ,Not Adjusted,3302,3518,216,6.1
1843,2006,December,San Augustine                                        ,Not Adjusted,3305,3501,196,5.6
1844,2006,March,San Jacinto                                          ,Not Adjusted,9267,9857,590,6.0
1845,2006,June,San Jacinto                                          ,Not Adjusted,9299,9980,681,6.8
1846,2006,September,San Jacinto                                          ,Not Adjusted,9419,10004,585,5.8
1847,2006,December,San Jacinto                                          ,Not Adjusted,9574,10093,519,5.1
1848,2006,March,San Patricio                                         ,Not Adjusted,27782,29440,1658,5.6
1849,2006,June,San Patricio                                         ,Not Adjusted,27748,29534,1786,6.0
1850,2006,September,San Patricio                                         ,Not Adjusted,27804,29419,1615,5.5
1851,2006,December,San Patricio                                         ,Not Adjusted,28111,29563,1452,4.9
1852,2006,March,San Saba                                             ,Not Adjusted,2350,2477,127,5.1
1853,2006,June,San Saba                                             ,Not Adjusted,2493,2646,153,5.8
1854,2006,September,San Saba                                             ,Not Adjusted,2399,2520,121,4.8
1855,2006,December,San Saba                                             ,Not Adjusted,2497,2607,110,4.2
1856,2006,March,Schleicher                                           ,Not Adjusted,1256,1313,57,4.3
1857,2006,June,Schleicher                                           ,Not Adjusted,1353,1410,57,4.0
1858,2006,September,Schleicher                                           ,Not Adjusted,1271,1321,50,3.8
1859,2006,December,Schleicher                                           ,Not Adjusted,1338,1381,43,3.1
1860,2006,March,Scurry                                               ,Not Adjusted,6817,7175,358,5.0
1861,2006,June,Scurry                                               ,Not Adjusted,6843,7268,425,5.8
1862,2006,September,Scurry                                               ,Not Adjusted,6764,7080,316,4.5
1863,2006,December,Scurry                                               ,Not Adjusted,6885,7131,246,3.4
1864,2006,March,Shackelford                                          ,Not Adjusted,1935,1998,63,3.2
1865,2006,June,Shackelford                                          ,Not Adjusted,2008,2078,70,3.4
1866,2006,September,Shackelford                                          ,Not Adjusted,1955,2013,58,2.9
1867,2006,December,Shackelford                                          ,Not Adjusted,1974,2025,51,2.5
1868,2006,March,Shelby                                               ,Not Adjusted,11219,11816,597,5.1
1869,2006,June,Shelby                                               ,Not Adjusted,11504,12194,690,5.7
1870,2006,September,Shelby                                               ,Not Adjusted,11296,11899,603,5.1
1871,2006,December,Shelby                                               ,Not Adjusted,11556,12041,485,4.0
1872,2006,March,Sherman                                              ,Not Adjusted,1193,1244,51,4.1
1873,2006,June,Sherman                                              ,Not Adjusted,1368,1431,63,4.4
1874,2006,September,Sherman                                              ,Not Adjusted,1220,1274,54,4.2
1875,2006,December,Sherman                                              ,Not Adjusted,1291,1335,44,3.3
1876,2006,March,Smith                                                ,Not Adjusted,91239,95668,4429,4.6
1877,2006,June,Smith                                                ,Not Adjusted,91828,96726,4898,5.1
1878,2006,September,Smith                                                ,Not Adjusted,92217,96719,4502,4.7
1879,2006,December,Smith                                                ,Not Adjusted,92539,97571,5032,5.2
1880,2006,March,Somervell                                            ,Not Adjusted,3525,3700,175,4.7
1881,2006,June,Somervell                                            ,Not Adjusted,3566,3781,215,5.7
1882,2006,September,Somervell                                            ,Not Adjusted,3631,3780,149,3.9
1883,2006,December,Somervell                                            ,Not Adjusted,3614,3785,171,4.5
1884,2006,March,Starr                                                ,Not Adjusted,18852,21790,2938,13.5
1885,2006,June,Starr                                                ,Not Adjusted,19143,21622,2479,11.5
1886,2006,September,Starr                                                ,Not Adjusted,18980,20917,1937,9.3
1887,2006,December,Starr                                                ,Not Adjusted,19171,21894,2723,12.4
1888,2006,March,Stephens                                             ,Not Adjusted,4159,4347,188,4.3
1889,2006,June,Stephens                                             ,Not Adjusted,4283,4490,207,4.6
1890,2006,September,Stephens                                             ,Not Adjusted,4237,4411,174,3.9
1891,2006,December,Stephens                                             ,Not Adjusted,4338,4488,150,3.3
1892,2006,March,Sterling                                             ,Not Adjusted,782,808,26,3.2
1893,2006,June,Sterling                                             ,Not Adjusted,867,898,31,3.5
1894,2006,September,Sterling                                             ,Not Adjusted,819,849,30,3.5
1895,2006,December,Sterling                                             ,Not Adjusted,910,933,23,2.5
1896,2006,March,Stonewall                                            ,Not Adjusted,800,834,34,4.1
1897,2006,June,Stonewall                                            ,Not Adjusted,919,951,32,3.4
1898,2006,September,Stonewall                                            ,Not Adjusted,876,902,26,2.9
1899,2006,December,Stonewall                                            ,Not Adjusted,814,835,21,2.5
1900,2006,March,Sutton                                               ,Not Adjusted,2635,2706,71,2.6
1901,2006,June,Sutton                                               ,Not Adjusted,2807,2898,91,3.1
1902,2006,September,Sutton                                               ,Not Adjusted,2757,2835,78,2.8
1903,2006,December,Sutton                                               ,Not Adjusted,2865,2924,59,2.0
1904,2006,March,Swisher                                              ,Not Adjusted,3247,3411,164,4.8
1905,2006,June,Swisher                                              ,Not Adjusted,3546,3721,175,4.7
1906,2006,September,Swisher                                              ,Not Adjusted,3288,3440,152,4.4
1907,2006,December,Swisher                                              ,Not Adjusted,3422,3555,133,3.7
1908,2006,March,Tarrant                                              ,Not Adjusted,810273,852079,41806,4.9
1909,2006,June,Tarrant                                              ,Not Adjusted,815714,860845,45131,5.2
1910,2006,September,Tarrant                                              ,Not Adjusted,822247,862907,40660,4.7
1911,2006,December,Tarrant                                              ,Not Adjusted,834444,869758,35314,4.1
1912,2006,March,Taylor                                               ,Not Adjusted,63082,65780,2698,4.1
1913,2006,June,Taylor                                               ,Not Adjusted,64389,67423,3034,4.5
1914,2006,September,Taylor                                               ,Not Adjusted,63851,66325,2474,3.7
1915,2006,December,Taylor                                               ,Not Adjusted,64133,66200,2067,3.1
1916,2006,March,Terrell                                              ,Not Adjusted,351,376,25,6.6
1917,2006,June,Terrell                                              ,Not Adjusted,384,407,23,5.7
1918,2006,September,Terrell                                              ,Not Adjusted,362,381,19,5.0
1919,2006,December,Terrell                                              ,Not Adjusted,380,398,18,4.5
1920,2006,March,Terry                                                ,Not Adjusted,5130,5455,325,6.0
1921,2006,June,Terry                                                ,Not Adjusted,5516,5854,338,5.8
1922,2006,September,Terry                                                ,Not Adjusted,5411,5686,275,4.8
1923,2006,December,Terry                                                ,Not Adjusted,5482,5706,224,3.9
1924,2006,March,Throckmorton                                         ,Not Adjusted,897,935,38,4.1
1925,2006,June,Throckmorton                                         ,Not Adjusted,984,1023,39,3.8
1926,2006,September,Throckmorton                                         ,Not Adjusted,941,974,33,3.4
1927,2006,December,Throckmorton                                         ,Not Adjusted,968,996,28,2.8
1928,2006,March,Titus                                                ,Not Adjusted,13817,14463,646,4.5
1929,2006,June,Titus                                                ,Not Adjusted,13930,14641,711,4.9
1930,2006,September,Titus                                                ,Not Adjusted,13854,14462,608,4.2
1931,2006,December,Titus                                                ,Not Adjusted,13809,14340,531,3.7
1932,2006,March,Tom Green                                            ,Not Adjusted,49544,51709,2165,4.2
1933,2006,June,Tom Green                                            ,Not Adjusted,50598,53164,2566,4.8
1934,2006,September,Tom Green                                            ,Not Adjusted,49532,51701,2169,4.2
1935,2006,December,Tom Green                                            ,Not Adjusted,50078,51820,1742,3.4
1936,2006,March,Travis                                               ,Not Adjusted,484795,506862,22067,4.4
1937,2006,June,Travis                                               ,Not Adjusted,492953,516452,23499,4.6
1938,2006,September,Travis                                               ,Not Adjusted,499317,519967,20650,4.0
1939,2006,December,Travis                                               ,Not Adjusted,507589,524825,17236,3.3
1940,2006,March,Trinity                                              ,Not Adjusted,5396,5746,350,6.1
1941,2006,June,Trinity                                              ,Not Adjusted,5400,5779,379,6.6
1942,2006,September,Trinity                                              ,Not Adjusted,5505,5826,321,5.5
1943,2006,December,Trinity                                              ,Not Adjusted,5469,5759,290,5.0
1944,2006,March,Tyler                                                ,Not Adjusted,7717,8254,537,6.5
1945,2006,June,Tyler                                                ,Not Adjusted,7647,8229,582,7.1
1946,2006,September,Tyler                                                ,Not Adjusted,7736,8242,506,6.1
1947,2006,December,Tyler                                                ,Not Adjusted,7739,8171,432,5.3
1948,2006,March,Upshur                                               ,Not Adjusted,17795,18718,923,4.9
1949,2006,June,Upshur                                               ,Not Adjusted,17879,18820,941,5.0
1950,2006,September,Upshur                                               ,Not Adjusted,18027,18898,871,4.6
1951,2006,December,Upshur                                               ,Not Adjusted,18301,19018,717,3.8
1952,2006,March,Upton                                                ,Not Adjusted,1463,1522,59,3.9
1953,2006,June,Upton                                                ,Not Adjusted,1577,1651,74,4.5
1954,2006,September,Upton                                                ,Not Adjusted,1552,1616,64,4.0
1955,2006,December,Upton                                                ,Not Adjusted,1618,1662,44,2.6
1956,2006,March,Uvalde                                               ,Not Adjusted,10593,11337,744,6.6
1957,2006,June,Uvalde                                               ,Not Adjusted,11019,11757,738,6.3
1958,2006,September,Uvalde                                               ,Not Adjusted,10511,11176,665,6.0
1959,2006,December,Uvalde                                               ,Not Adjusted,10476,11061,585,5.3
1960,2006,March,Val Verde                                            ,Not Adjusted,18974,20271,1297,6.4
1961,2006,June,Val Verde                                            ,Not Adjusted,18936,20202,1266,6.3
1962,2006,September,Val Verde                                            ,Not Adjusted,18957,20010,1053,5.3
1963,2006,December,Val Verde                                            ,Not Adjusted,19145,20213,1068,5.3
1964,2006,March,Van Zandt                                            ,Not Adjusted,23593,24789,1196,4.8
1965,2006,June,Van Zandt                                            ,Not Adjusted,24310,25594,1284,5.0
1966,2006,September,Van Zandt                                            ,Not Adjusted,24119,25228,1109,4.4
1967,2006,December,Van Zandt                                            ,Not Adjusted,24415,25403,988,3.9
1968,2006,March,Victoria                                             ,Not Adjusted,42129,44060,1931,4.4
1969,2006,June,Victoria                                             ,Not Adjusted,42693,44787,2094,4.7
1970,2006,September,Victoria                                             ,Not Adjusted,42674,44424,1750,3.9
1971,2006,December,Victoria                                             ,Not Adjusted,42722,44184,1462,3.3
1972,2006,March,Walker                                               ,Not Adjusted,24555,26031,1476,5.7
1973,2006,June,Walker                                               ,Not Adjusted,24560,26270,1710,6.5
1974,2006,September,Walker                                               ,Not Adjusted,25087,26462,1375,5.2
1975,2006,December,Walker                                               ,Not Adjusted,24799,25901,1102,4.3
1976,2006,March,Waller                                               ,Not Adjusted,14722,15594,872,5.6
1977,2006,June,Waller                                               ,Not Adjusted,14776,15821,1045,6.6
1978,2006,September,Waller                                               ,Not Adjusted,14965,15753,788,5.0
1979,2006,December,Waller                                               ,Not Adjusted,15212,15856,644,4.1
1980,2006,March,Ward                                                 ,Not Adjusted,4353,4574,221,4.8
1981,2006,June,Ward                                                 ,Not Adjusted,4548,4814,266,5.5
1982,2006,September,Ward                                                 ,Not Adjusted,4509,4727,218,4.6
1983,2006,December,Ward                                                 ,Not Adjusted,4636,4805,169,3.5
1984,2006,March,Washington                                           ,Not Adjusted,15298,16020,722,4.5
1985,2006,June,Washington                                           ,Not Adjusted,15434,16232,798,4.9
1986,2006,September,Washington                                           ,Not Adjusted,15376,16032,656,4.1
1987,2006,December,Washington                                           ,Not Adjusted,15612,16169,557,3.4
1988,2006,March,Webb                                                 ,Not Adjusted,82311,87402,5091,5.8
1989,2006,June,Webb                                                 ,Not Adjusted,82163,87808,5645,6.4
1990,2006,September,Webb                                                 ,Not Adjusted,83670,88073,4403,5.0
1991,2006,December,Webb                                                 ,Not Adjusted,85248,89123,3875,4.3
1992,2006,March,Wharton                                              ,Not Adjusted,19329,20334,1005,4.9
1993,2006,June,Wharton                                              ,Not Adjusted,19878,21021,1143,5.4
1994,2006,September,Wharton                                              ,Not Adjusted,19561,20520,959,4.7
1995,2006,December,Wharton                                              ,Not Adjusted,19743,20558,815,4.0
1996,2006,March,Wheeler                                              ,Not Adjusted,2503,2601,98,3.8
1997,2006,June,Wheeler                                              ,Not Adjusted,2777,2883,106,3.7
1998,2006,September,Wheeler                                              ,Not Adjusted,2780,2867,87,3.0
1999,2006,December,Wheeler                                              ,Not Adjusted,2864,2938,74,2.5
2000,2006,March,Wichita                                              ,Not Adjusted,59907,62756,2849,4.5
2001,2006,June,Wichita                                              ,Not Adjusted,60244,63478,3234,5.1
2002,2006,September,Wichita                                              ,Not Adjusted,60053,62739,2686,4.3
2003,2006,December,Wichita                                              ,Not Adjusted,59506,61897,2391,3.9
2004,2006,March,Wilbarger                                            ,Not Adjusted,7501,7789,288,3.7
2005,2006,June,Wilbarger                                            ,Not Adjusted,7610,7951,341,4.3
2006,2006,September,Wilbarger                                            ,Not Adjusted,7537,7823,286,3.7
2007,2006,December,Wilbarger                                            ,Not Adjusted,7571,7786,215,2.8
2008,2006,March,Willacy                                              ,Not Adjusted,6799,7587,788,10.4
2009,2006,June,Willacy                                              ,Not Adjusted,7010,7796,786,10.1
2010,2006,September,Willacy                                              ,Not Adjusted,6933,7576,643,8.5
2011,2006,December,Willacy                                              ,Not Adjusted,7088,7679,591,7.7
2012,2006,March,Williamson                                           ,Not Adjusted,177236,185671,8435,4.5
2013,2006,June,Williamson                                           ,Not Adjusted,180218,189067,8849,4.7
2014,2006,September,Williamson                                           ,Not Adjusted,182545,190383,7838,4.1
2015,2006,December,Williamson                                           ,Not Adjusted,185569,191951,6382,3.3
2016,2006,March,Wilson                                               ,Not Adjusted,17268,18066,798,4.4
2017,2006,June,Wilson                                               ,Not Adjusted,17435,18405,970,5.3
2018,2006,September,Wilson                                               ,Not Adjusted,17503,18321,818,4.5
2019,2006,December,Wilson                                               ,Not Adjusted,17627,18326,699,3.8
2020,2006,March,Winkler                                              ,Not Adjusted,2993,3125,132,4.2
2021,2006,June,Winkler                                              ,Not Adjusted,3090,3231,141,4.4
2022,2006,September,Winkler                                              ,Not Adjusted,3145,3263,118,3.6
2023,2006,December,Winkler                                              ,Not Adjusted,3193,3300,107,3.2
2024,2006,March,Wise                                                 ,Not Adjusted,26356,27711,1355,4.9
2025,2006,June,Wise                                                 ,Not Adjusted,26532,28001,1469,5.2
2026,2006,September,Wise                                                 ,Not Adjusted,26746,27926,1180,4.2
2027,2006,December,Wise                                                 ,Not Adjusted,27142,28147,1005,3.6
2028,2006,March,Wood                                                 ,Not Adjusted,16785,17726,941,5.3
2029,2006,June,Wood                                                 ,Not Adjusted,17188,18221,1033,5.7
2030,2006,September,Wood                                                 ,Not Adjusted,16865,17766,901,5.1
2031,2006,December,Wood                                                 ,Not Adjusted,17181,17958,777,4.3
2032,2006,March,Yoakum                                               ,Not Adjusted,3244,3403,159,4.7
2033,2006,June,Yoakum                                               ,Not Adjusted,3564,3726,162,4.3
2034,2006,September,Yoakum                                               ,Not Adjusted,3475,3609,134,3.7
2035,2006,December,Yoakum                                               ,Not Adjusted,3650,3754,104,2.8
2036,2006,March,Young                                                ,Not Adjusted,9023,9406,383,4.1
2037,2006,June,Young                                                ,Not Adjusted,9464,9904,440,4.4
2038,2006,September,Young                                                ,Not Adjusted,9382,9737,355,3.6
2039,2006,December,Young                                                ,Not Adjusted,9482,9772,290,3.0
2040,2006,March,Zapata                                               ,Not Adjusted,4475,4813,338,7.0
2041,2006,June,Zapata                                               ,Not Adjusted,4679,5027,348,6.9
2042,2006,September,Zapata                                               ,Not Adjusted,4619,4895,276,5.6
2043,2006,December,Zapata                                               ,Not Adjusted,4681,4933,252,5.1
2044,2006,March,Zavala                                               ,Not Adjusted,3293,3778,485,12.8
2045,2006,June,Zavala                                               ,Not Adjusted,3382,3824,442,11.6
2046,2006,September,Zavala                                               ,Not Adjusted,3209,3602,393,10.9
2047,2006,December,Zavala                                               ,Not Adjusted,3347,3819,472,12.4
2048,2007,March,Texas,Not Adjusted,10890915,11373803,482888,4.2
2049,2007,March,Texas,Adjusted,10909724,11408395,498671,4.4
2050,2007,June,Texas,Not Adjusted,10931858,11467309,535451,4.7
2051,2007,June,Texas,Adjusted,10919419,11411196,491777,4.3
2052,2007,September,Texas,Not Adjusted,10968937,11479639,510702,4.4
2053,2007,September,Texas,Adjusted,10960290,11459823,499533,4.4
2054,2007,December,Texas,Not Adjusted,11050912,11549834,498922,4.3
2055,2007,December,Texas,Adjusted,11027674,11531148,503474,4.4
2056,2007,March,Anderson                                             ,Not Adjusted,19078,20103,1025,5.1
2057,2007,June,Anderson                                             ,Not Adjusted,19290,20352,1062,5.2
2058,2007,September,Anderson                                             ,Not Adjusted,18923,19992,1069,5.3
2059,2007,December,Anderson                                             ,Not Adjusted,18915,19928,1013,5.1
2060,2007,March,Andrews                                              ,Not Adjusted,6508,6726,218,3.2
2061,2007,June,Andrews                                              ,Not Adjusted,6509,6750,241,3.6
2062,2007,September,Andrews                                              ,Not Adjusted,6382,6605,223,3.4
2063,2007,December,Andrews                                              ,Not Adjusted,6381,6591,210,3.2
2064,2007,March,Angelina                                             ,Not Adjusted,38093,39799,1706,4.3
2065,2007,June,Angelina                                             ,Not Adjusted,37947,39771,1824,4.6
2066,2007,September,Angelina                                             ,Not Adjusted,37792,39481,1689,4.3
2067,2007,December,Angelina                                             ,Not Adjusted,37566,39468,1902,4.8
2068,2007,March,Aransas                                              ,Not Adjusted,10547,10974,427,3.9
2069,2007,June,Aransas                                              ,Not Adjusted,10555,11019,464,4.2
2070,2007,September,Aransas                                              ,Not Adjusted,10540,10997,457,4.2
2071,2007,December,Aransas                                              ,Not Adjusted,10702,11168,466,4.2
2072,2007,March,Archer                                               ,Not Adjusted,4981,5134,153,3.0
2073,2007,June,Archer                                               ,Not Adjusted,4928,5102,174,3.4
2074,2007,September,Archer                                               ,Not Adjusted,4968,5139,171,3.3
2075,2007,December,Archer                                               ,Not Adjusted,4879,5035,156,3.1
2076,2007,March,Armstrong                                            ,Not Adjusted,1023,1053,30,2.8
2077,2007,June,Armstrong                                            ,Not Adjusted,1027,1067,40,3.7
2078,2007,September,Armstrong                                            ,Not Adjusted,1027,1065,38,3.6
2079,2007,December,Armstrong                                            ,Not Adjusted,1035,1073,38,3.5
2080,2007,March,Atascosa                                             ,Not Adjusted,17836,18575,739,4.0
2081,2007,June,Atascosa                                             ,Not Adjusted,17971,18848,877,4.7
2082,2007,September,Atascosa                                             ,Not Adjusted,18033,18832,799,4.2
2083,2007,December,Atascosa                                             ,Not Adjusted,18119,18881,762,4.0
2084,2007,March,Austin                                               ,Not Adjusted,12247,12707,460,3.6
2085,2007,June,Austin                                               ,Not Adjusted,12336,12868,532,4.1
2086,2007,September,Austin                                               ,Not Adjusted,12384,12900,516,4.0
2087,2007,December,Austin                                               ,Not Adjusted,12492,12957,465,3.6
2088,2007,March,Bailey                                               ,Not Adjusted,3152,3297,145,4.4
2089,2007,June,Bailey                                               ,Not Adjusted,3217,3386,169,5.0
2090,2007,September,Bailey                                               ,Not Adjusted,3078,3211,133,4.1
2091,2007,December,Bailey                                               ,Not Adjusted,3155,3287,132,4.0
2092,2007,March,Bandera                                              ,Not Adjusted,9157,9518,361,3.8
2093,2007,June,Bandera                                              ,Not Adjusted,9227,9611,384,4.0
2094,2007,September,Bandera                                              ,Not Adjusted,9259,9637,378,3.9
2095,2007,December,Bandera                                              ,Not Adjusted,9304,9658,354,3.7
2096,2007,March,Bastrop                                              ,Not Adjusted,31811,33226,1415,4.3
2097,2007,June,Bastrop                                              ,Not Adjusted,31996,33557,1561,4.7
2098,2007,September,Bastrop                                              ,Not Adjusted,32138,33552,1414,4.2
2099,2007,December,Bastrop                                              ,Not Adjusted,32345,33679,1334,4.0
2100,2007,March,Baylor                                               ,Not Adjusted,1978,2055,77,3.7
2101,2007,June,Baylor                                               ,Not Adjusted,2000,2085,85,4.1
2102,2007,September,Baylor                                               ,Not Adjusted,1904,1979,75,3.8
2103,2007,December,Baylor                                               ,Not Adjusted,1946,2022,76,3.8
2104,2007,March,Bee                                                  ,Not Adjusted,10773,11439,666,5.8
2105,2007,June,Bee                                                  ,Not Adjusted,10604,11338,734,6.5
2106,2007,September,Bee                                                  ,Not Adjusted,10370,11051,681,6.2
2107,2007,December,Bee                                                  ,Not Adjusted,10471,11114,643,5.8
2108,2007,March,Bell                                                 ,Not Adjusted,112892,117997,5105,4.3
2109,2007,June,Bell                                                 ,Not Adjusted,112510,118316,5806,4.9
2110,2007,September,Bell                                                 ,Not Adjusted,113867,119386,5519,4.6
2111,2007,December,Bell                                                 ,Not Adjusted,114910,120411,5501,4.6
2112,2007,March,Bexar                                                ,Not Adjusted,698736,728788,30052,4.1
2113,2007,June,Bexar                                                ,Not Adjusted,704068,737863,33795,4.6
2114,2007,September,Bexar                                                ,Not Adjusted,706467,737944,31477,4.3
2115,2007,December,Bexar                                                ,Not Adjusted,709832,740181,30349,4.1
2116,2007,March,Blanco                                               ,Not Adjusted,4586,4736,150,3.2
2117,2007,June,Blanco                                               ,Not Adjusted,4728,4899,171,3.5
2118,2007,September,Blanco                                               ,Not Adjusted,4623,4792,169,3.5
2119,2007,December,Blanco                                               ,Not Adjusted,4615,4770,155,3.2
2120,2007,March,Borden                                               ,Not Adjusted,358,374,16,4.3
2121,2007,June,Borden                                               ,Not Adjusted,339,355,16,4.5
2122,2007,September,Borden                                               ,Not Adjusted,360,373,13,3.5
2123,2007,December,Borden                                               ,Not Adjusted,384,399,15,3.8
2124,2007,March,Bosque                                               ,Not Adjusted,7831,8176,345,4.2
2125,2007,June,Bosque                                               ,Not Adjusted,7881,8267,386,4.7
2126,2007,September,Bosque                                               ,Not Adjusted,7791,8148,357,4.4
2127,2007,December,Bosque                                               ,Not Adjusted,7833,8157,324,4.0
2128,2007,March,Bowie                                                ,Not Adjusted,40941,42960,2019,4.7
2129,2007,June,Bowie                                                ,Not Adjusted,40977,43027,2050,4.8
2130,2007,September,Bowie                                                ,Not Adjusted,40970,43020,2050,4.8
2131,2007,December,Bowie                                                ,Not Adjusted,41060,43094,2034,4.7
2132,2007,March,Brazoria                                             ,Not Adjusted,130893,136595,5702,4.2
2133,2007,June,Brazoria                                             ,Not Adjusted,131834,138438,6604,4.8
2134,2007,September,Brazoria                                             ,Not Adjusted,132345,138792,6447,4.6
2135,2007,December,Brazoria                                             ,Not Adjusted,133504,139880,6376,4.6
2136,2007,March,Brazos                                               ,Not Adjusted,85580,88626,3046,3.4
2137,2007,June,Brazos                                               ,Not Adjusted,82218,86039,3821,4.4
2138,2007,September,Brazos                                               ,Not Adjusted,86761,90182,3421,3.8
2139,2007,December,Brazos                                               ,Not Adjusted,87369,90411,3042,3.4
2140,2007,March,Brewster                                             ,Not Adjusted,5074,5246,172,3.3
2141,2007,June,Brewster                                             ,Not Adjusted,4983,5183,200,3.9
2142,2007,September,Brewster                                             ,Not Adjusted,4915,5090,175,3.4
2143,2007,December,Brewster                                             ,Not Adjusted,4970,5125,155,3.0
2144,2007,March,Briscoe                                              ,Not Adjusted,694,727,33,4.5
2145,2007,June,Briscoe                                              ,Not Adjusted,700,734,34,4.6
2146,2007,September,Briscoe                                              ,Not Adjusted,655,683,28,4.1
2147,2007,December,Briscoe                                              ,Not Adjusted,709,736,27,3.7
2148,2007,March,Brooks                                               ,Not Adjusted,2933,3109,176,5.7
2149,2007,June,Brooks                                               ,Not Adjusted,2881,3073,192,6.2
2150,2007,September,Brooks                                               ,Not Adjusted,2884,3052,168,5.5
2151,2007,December,Brooks                                               ,Not Adjusted,3008,3168,160,5.1
2152,2007,March,Brown                                                ,Not Adjusted,17801,18571,770,4.1
2153,2007,June,Brown                                                ,Not Adjusted,17898,18729,831,4.4
2154,2007,September,Brown                                                ,Not Adjusted,17851,18632,781,4.2
2155,2007,December,Brown                                                ,Not Adjusted,17560,18299,739,4.0
2156,2007,March,Burleson                                             ,Not Adjusted,7492,7788,296,3.8
2157,2007,June,Burleson                                             ,Not Adjusted,7197,7513,316,4.2
2158,2007,September,Burleson                                             ,Not Adjusted,7595,7914,319,4.0
2159,2007,December,Burleson                                             ,Not Adjusted,7648,7959,311,3.9
2160,2007,March,Burnet                                               ,Not Adjusted,20818,21591,773,3.6
2161,2007,June,Burnet                                               ,Not Adjusted,21526,22348,822,3.7
2162,2007,September,Burnet                                               ,Not Adjusted,21030,21810,780,3.6
2163,2007,December,Burnet                                               ,Not Adjusted,21161,21893,732,3.3
2164,2007,March,Caldwell                                             ,Not Adjusted,14643,15377,734,4.8
2165,2007,June,Caldwell                                             ,Not Adjusted,14727,15499,772,5.0
2166,2007,September,Caldwell                                             ,Not Adjusted,14792,15493,701,4.5
2167,2007,December,Caldwell                                             ,Not Adjusted,14889,15566,677,4.3
2168,2007,March,Calhoun                                              ,Not Adjusted,8724,9150,426,4.7
2169,2007,June,Calhoun                                              ,Not Adjusted,8855,9299,444,4.8
2170,2007,September,Calhoun                                              ,Not Adjusted,8872,9301,429,4.6
2171,2007,December,Calhoun                                              ,Not Adjusted,8890,9312,422,4.5
2172,2007,March,Callahan                                             ,Not Adjusted,6645,6869,224,3.3
2173,2007,June,Callahan                                             ,Not Adjusted,6669,6947,278,4.0
2174,2007,September,Callahan                                             ,Not Adjusted,6727,6967,240,3.4
2175,2007,December,Callahan                                             ,Not Adjusted,6737,6958,221,3.2
2176,2007,March,Cameron                                              ,Not Adjusted,134671,142910,8239,5.8
2177,2007,June,Cameron                                              ,Not Adjusted,133314,142707,9393,6.6
2178,2007,September,Cameron                                              ,Not Adjusted,132996,141391,8395,5.9
2179,2007,December,Cameron                                              ,Not Adjusted,135391,143994,8603,6.0
2180,2007,March,Camp                                                 ,Not Adjusted,5350,5585,235,4.2
2181,2007,June,Camp                                                 ,Not Adjusted,5323,5607,284,5.1
2182,2007,September,Camp                                                 ,Not Adjusted,5270,5535,265,4.8
2183,2007,December,Camp                                                 ,Not Adjusted,5380,5630,250,4.4
2184,2007,March,Carson                                               ,Not Adjusted,3218,3320,102,3.1
2185,2007,June,Carson                                               ,Not Adjusted,3234,3350,116,3.5
2186,2007,September,Carson                                               ,Not Adjusted,3229,3333,104,3.1
2187,2007,December,Carson                                               ,Not Adjusted,3254,3358,104,3.1
2188,2007,March,Cass                                                 ,Not Adjusted,12365,13065,700,5.4
2189,2007,June,Cass                                                 ,Not Adjusted,12316,13039,723,5.5
2190,2007,September,Cass                                                 ,Not Adjusted,12156,12849,693,5.4
2191,2007,December,Cass                                                 ,Not Adjusted,12252,13000,748,5.8
2192,2007,March,Castro                                               ,Not Adjusted,3296,3422,126,3.7
2193,2007,June,Castro                                               ,Not Adjusted,3399,3550,151,4.3
2194,2007,September,Castro                                               ,Not Adjusted,3291,3421,130,3.8
2195,2007,December,Castro                                               ,Not Adjusted,3450,3570,120,3.4
2196,2007,March,Chambers                                             ,Not Adjusted,13081,13707,626,4.6
2197,2007,June,Chambers                                             ,Not Adjusted,13173,13850,677,4.9
2198,2007,September,Chambers                                             ,Not Adjusted,13224,13911,687,4.9
2199,2007,December,Chambers                                             ,Not Adjusted,13340,14041,701,5.0
2200,2007,March,Cherokee                                             ,Not Adjusted,19637,20581,944,4.6
2201,2007,June,Cherokee                                             ,Not Adjusted,19608,20639,1031,5.0
2202,2007,September,Cherokee                                             ,Not Adjusted,19130,20112,982,4.9
2203,2007,December,Cherokee                                             ,Not Adjusted,18917,19976,1059,5.3
2204,2007,March,Childress                                            ,Not Adjusted,2857,3014,157,5.2
2205,2007,June,Childress                                            ,Not Adjusted,2936,3092,156,5.0
2206,2007,September,Childress                                            ,Not Adjusted,2880,3020,140,4.6
2207,2007,December,Childress                                            ,Not Adjusted,2844,2983,139,4.7
2208,2007,March,Clay                                                 ,Not Adjusted,6049,6255,206,3.3
2209,2007,June,Clay                                                 ,Not Adjusted,5984,6226,242,3.9
2210,2007,September,Clay                                                 ,Not Adjusted,6031,6241,210,3.4
2211,2007,December,Clay                                                 ,Not Adjusted,5923,6137,214,3.5
2212,2007,March,Cochran                                              ,Not Adjusted,1416,1504,88,5.9
2213,2007,June,Cochran                                              ,Not Adjusted,1425,1511,86,5.7
2214,2007,September,Cochran                                              ,Not Adjusted,1389,1459,70,4.8
2215,2007,December,Cochran                                              ,Not Adjusted,1432,1499,67,4.5
2216,2007,March,Coke                                                 ,Not Adjusted,1277,1337,60,4.5
2217,2007,June,Coke                                                 ,Not Adjusted,1325,1402,77,5.5
2218,2007,September,Coke                                                 ,Not Adjusted,1341,1411,70,5.0
2219,2007,December,Coke                                                 ,Not Adjusted,1277,1397,120,8.6
2220,2007,March,Coleman                                              ,Not Adjusted,4193,4350,157,3.6
2221,2007,June,Coleman                                              ,Not Adjusted,4259,4426,167,3.8
2222,2007,September,Coleman                                              ,Not Adjusted,4254,4404,150,3.4
2223,2007,December,Coleman                                              ,Not Adjusted,4241,4382,141,3.2
2224,2007,March,Collin                                               ,Not Adjusted,378279,393184,14905,3.8
2225,2007,June,Collin                                               ,Not Adjusted,380575,396645,16070,4.1
2226,2007,September,Collin                                               ,Not Adjusted,382193,398016,15823,4.0
2227,2007,December,Collin                                               ,Not Adjusted,384814,400458,15644,3.9
2228,2007,March,Collingsworth                                        ,Not Adjusted,1478,1533,55,3.6
2229,2007,June,Collingsworth                                        ,Not Adjusted,1550,1605,55,3.4
2230,2007,September,Collingsworth                                        ,Not Adjusted,1457,1513,56,3.7
2231,2007,December,Collingsworth                                        ,Not Adjusted,1476,1522,46,3.0
2232,2007,March,Colorado                                             ,Not Adjusted,10137,10515,378,3.6
2233,2007,June,Colorado                                             ,Not Adjusted,10186,10621,435,4.1
2234,2007,September,Colorado                                             ,Not Adjusted,9982,10360,378,3.6
2235,2007,December,Colorado                                             ,Not Adjusted,10065,10423,358,3.4
2236,2007,March,Comal                                                ,Not Adjusted,50157,52022,1865,3.6
2237,2007,June,Comal                                                ,Not Adjusted,50539,52588,2049,3.9
2238,2007,September,Comal                                                ,Not Adjusted,50711,52631,1920,3.6
2239,2007,December,Comal                                                ,Not Adjusted,50952,52820,1868,3.5
2240,2007,March,Comanche                                             ,Not Adjusted,6230,6476,246,3.8
2241,2007,June,Comanche                                             ,Not Adjusted,6286,6560,274,4.2
2242,2007,September,Comanche                                             ,Not Adjusted,6124,6379,255,4.0
2243,2007,December,Comanche                                             ,Not Adjusted,6334,6564,230,3.5
2244,2007,March,Concho                                               ,Not Adjusted,1267,1338,71,5.3
2245,2007,June,Concho                                               ,Not Adjusted,1290,1361,71,5.2
2246,2007,September,Concho                                               ,Not Adjusted,1223,1290,67,5.2
2247,2007,December,Concho                                               ,Not Adjusted,1244,1307,63,4.8
2248,2007,March,Cooke                                                ,Not Adjusted,20769,21479,710,3.3
2249,2007,June,Cooke                                                ,Not Adjusted,20875,21749,874,4.0
2250,2007,September,Cooke                                                ,Not Adjusted,20939,21762,823,3.8
2251,2007,December,Cooke                                                ,Not Adjusted,21281,22038,757,3.4
2252,2007,March,Coryell                                              ,Not Adjusted,21806,23126,1320,5.7
2253,2007,June,Coryell                                              ,Not Adjusted,21732,23260,1528,6.6
2254,2007,September,Coryell                                              ,Not Adjusted,21995,23415,1420,6.1
2255,2007,December,Coryell                                              ,Not Adjusted,22196,23582,1386,5.9
2256,2007,March,Cottle                                               ,Not Adjusted,793,829,36,4.3
2257,2007,June,Cottle                                               ,Not Adjusted,799,829,30,3.6
2258,2007,September,Cottle                                               ,Not Adjusted,782,811,29,3.6
2259,2007,December,Cottle                                               ,Not Adjusted,803,833,30,3.6
2260,2007,March,Crane                                                ,Not Adjusted,1611,1681,70,4.2
2261,2007,June,Crane                                                ,Not Adjusted,1582,1660,78,4.7
2262,2007,September,Crane                                                ,Not Adjusted,1572,1643,71,4.3
2263,2007,December,Crane                                                ,Not Adjusted,1563,1622,59,3.6
2264,2007,March,Crockett                                             ,Not Adjusted,1988,2048,60,2.9
2265,2007,June,Crockett                                             ,Not Adjusted,2003,2069,66,3.2
2266,2007,September,Crockett                                             ,Not Adjusted,2047,2110,63,3.0
2267,2007,December,Crockett                                             ,Not Adjusted,2027,2089,62,3.0
2268,2007,March,Crosby                                               ,Not Adjusted,2509,2654,145,5.5
2269,2007,June,Crosby                                               ,Not Adjusted,2474,2613,139,5.3
2270,2007,September,Crosby                                               ,Not Adjusted,2523,2638,115,4.4
2271,2007,December,Crosby                                               ,Not Adjusted,2535,2641,106,4.0
2272,2007,March,Culberson                                            ,Not Adjusted,1710,1761,51,2.9
2273,2007,June,Culberson                                            ,Not Adjusted,1727,1781,54,3.0
2274,2007,September,Culberson                                            ,Not Adjusted,1688,1732,44,2.5
2275,2007,December,Culberson                                            ,Not Adjusted,1745,1791,46,2.6
2276,2007,March,Dallam                                               ,Not Adjusted,3164,3253,89,2.7
2277,2007,June,Dallam                                               ,Not Adjusted,3206,3308,102,3.1
2278,2007,September,Dallam                                               ,Not Adjusted,3113,3212,99,3.1
2279,2007,December,Dallam                                               ,Not Adjusted,3215,3307,92,2.8
2280,2007,March,Dallas                                               ,Not Adjusted,1078233,1128343,50110,4.4
2281,2007,June,Dallas                                               ,Not Adjusted,1084775,1140091,55316,4.9
2282,2007,September,Dallas                                               ,Not Adjusted,1089387,1144211,54824,4.8
2283,2007,December,Dallas                                               ,Not Adjusted,1096860,1149756,52896,4.6
2284,2007,March,Dawson                                               ,Not Adjusted,4835,5110,275,5.4
2285,2007,June,Dawson                                               ,Not Adjusted,4821,5122,301,5.9
2286,2007,September,Dawson                                               ,Not Adjusted,4762,5024,262,5.2
2287,2007,December,Dawson                                               ,Not Adjusted,4938,5166,228,4.4
2288,2007,March,Deaf Smith                                           ,Not Adjusted,8122,8427,305,3.6
2289,2007,June,Deaf Smith                                           ,Not Adjusted,8467,8813,346,3.9
2290,2007,September,Deaf Smith                                           ,Not Adjusted,8508,8830,322,3.6
2291,2007,December,Deaf Smith                                           ,Not Adjusted,8895,9193,298,3.2
2292,2007,March,Delta                                                ,Not Adjusted,2179,2295,116,5.1
2293,2007,June,Delta                                                ,Not Adjusted,2191,2304,113,4.9
2294,2007,September,Delta                                                ,Not Adjusted,2201,2315,114,4.9
2295,2007,December,Delta                                                ,Not Adjusted,2216,2325,109,4.7
2296,2007,March,Denton                                               ,Not Adjusted,322454,334952,12498,3.7
2297,2007,June,Denton                                               ,Not Adjusted,324409,338792,14383,4.2
2298,2007,September,Denton                                               ,Not Adjusted,325789,339412,13623,4.0
2299,2007,December,Denton                                               ,Not Adjusted,328023,341157,13134,3.8
2300,2007,March,DeWitt                                               ,Not Adjusted,8691,9034,343,3.8
2301,2007,June,DeWitt                                               ,Not Adjusted,8688,9064,376,4.1
2302,2007,September,DeWitt                                               ,Not Adjusted,8590,8963,373,4.2
2303,2007,December,DeWitt                                               ,Not Adjusted,8652,9003,351,3.9
2304,2007,March,Dickens                                              ,Not Adjusted,1147,1196,49,4.1
2305,2007,June,Dickens                                              ,Not Adjusted,1179,1219,40,3.3
2306,2007,September,Dickens                                              ,Not Adjusted,1073,1129,56,5.0
2307,2007,December,Dickens                                              ,Not Adjusted,1103,1146,43,3.8
2308,2007,March,Dimmit                                               ,Not Adjusted,3730,3980,250,6.3
2309,2007,June,Dimmit                                               ,Not Adjusted,3900,4180,280,6.7
2310,2007,September,Dimmit                                               ,Not Adjusted,3686,3932,246,6.3
2311,2007,December,Dimmit                                               ,Not Adjusted,3641,3878,237,6.1
2312,2007,March,Donley                                               ,Not Adjusted,1725,1803,78,4.3
2313,2007,June,Donley                                               ,Not Adjusted,1767,1861,94,5.1
2314,2007,September,Donley                                               ,Not Adjusted,1636,1717,81,4.7
2315,2007,December,Donley                                               ,Not Adjusted,1818,1886,68,3.6
2316,2007,March,Duval                                                ,Not Adjusted,4821,5056,235,4.6
2317,2007,June,Duval                                                ,Not Adjusted,4940,5217,277,5.3
2318,2007,September,Duval                                                ,Not Adjusted,4906,5174,268,5.2
2319,2007,December,Duval                                                ,Not Adjusted,4891,5150,259,5.0
2320,2007,March,Eastland                                             ,Not Adjusted,7746,8092,346,4.3
2321,2007,June,Eastland                                             ,Not Adjusted,7842,8252,410,5.0
2322,2007,September,Eastland                                             ,Not Adjusted,7698,8061,363,4.5
2323,2007,December,Eastland                                             ,Not Adjusted,7922,8255,333,4.0
2324,2007,March,Ector                                                ,Not Adjusted,63205,65362,2157,3.3
2325,2007,June,Ector                                                ,Not Adjusted,64185,66757,2572,3.9
2326,2007,September,Ector                                                ,Not Adjusted,64892,67262,2370,3.5
2327,2007,December,Ector                                                ,Not Adjusted,65982,68146,2164,3.2
2328,2007,March,Edwards                                              ,Not Adjusted,967,1006,39,3.9
2329,2007,June,Edwards                                              ,Not Adjusted,973,1018,45,4.4
2330,2007,September,Edwards                                              ,Not Adjusted,952,994,42,4.2
2331,2007,December,Edwards                                              ,Not Adjusted,993,1030,37,3.6
2332,2007,March,Ellis                                                ,Not Adjusted,65745,68679,2934,4.3
2333,2007,June,Ellis                                                ,Not Adjusted,66142,69359,3217,4.6
2334,2007,September,Ellis                                                ,Not Adjusted,66423,69537,3114,4.5
2335,2007,December,Ellis                                                ,Not Adjusted,66880,69900,3020,4.3
2336,2007,March,El Paso                                              ,Not Adjusted,272294,289053,16759,5.8
2337,2007,June,El Paso                                              ,Not Adjusted,270492,288760,18268,6.3
2338,2007,September,El Paso                                              ,Not Adjusted,276323,293484,17161,5.8
2339,2007,December,El Paso                                              ,Not Adjusted,280610,296935,16325,5.5
2340,2007,March,Erath                                                ,Not Adjusted,17629,18275,646,3.5
2341,2007,June,Erath                                                ,Not Adjusted,17114,17871,757,4.2
2342,2007,September,Erath                                                ,Not Adjusted,17076,17746,670,3.8
2343,2007,December,Erath                                                ,Not Adjusted,17615,18218,603,3.3
2344,2007,March,Falls                                                ,Not Adjusted,6658,7005,347,5.0
2345,2007,June,Falls                                                ,Not Adjusted,6557,6954,397,5.7
2346,2007,September,Falls                                                ,Not Adjusted,6206,6581,375,5.7
2347,2007,December,Falls                                                ,Not Adjusted,6186,6546,360,5.5
2348,2007,March,Fannin                                               ,Not Adjusted,12684,13361,677,5.1
2349,2007,June,Fannin                                               ,Not Adjusted,12765,13509,744,5.5
2350,2007,September,Fannin                                               ,Not Adjusted,12736,13447,711,5.3
2351,2007,December,Fannin                                               ,Not Adjusted,12758,13438,680,5.1
2352,2007,March,Fayette                                              ,Not Adjusted,11710,12091,381,3.2
2353,2007,June,Fayette                                              ,Not Adjusted,11799,12227,428,3.5
2354,2007,September,Fayette                                              ,Not Adjusted,11561,11964,403,3.4
2355,2007,December,Fayette                                              ,Not Adjusted,11677,12043,366,3.0
2356,2007,March,Fisher                                               ,Not Adjusted,1910,1988,78,3.9
2357,2007,June,Fisher                                               ,Not Adjusted,1927,2012,85,4.2
2358,2007,September,Fisher                                               ,Not Adjusted,1861,1939,78,4.0
2359,2007,December,Fisher                                               ,Not Adjusted,1896,1967,71,3.6
2360,2007,March,Floyd                                                ,Not Adjusted,3017,3179,162,5.1
2361,2007,June,Floyd                                                ,Not Adjusted,3008,3186,178,5.6
2362,2007,September,Floyd                                                ,Not Adjusted,2885,3031,146,4.8
2363,2007,December,Floyd                                                ,Not Adjusted,2961,3106,145,4.7
2364,2007,March,Foard                                                ,Not Adjusted,677,701,24,3.4
2365,2007,June,Foard                                                ,Not Adjusted,673,706,33,4.7
2366,2007,September,Foard                                                ,Not Adjusted,652,678,26,3.8
2367,2007,December,Foard                                                ,Not Adjusted,679,706,27,3.8
2368,2007,March,Fort Bend                                            ,Not Adjusted,241007,250907,9900,3.9
2369,2007,June,Fort Bend                                            ,Not Adjusted,242741,253939,11198,4.4
2370,2007,September,Fort Bend                                            ,Not Adjusted,243684,254398,10714,4.2
2371,2007,December,Fort Bend                                            ,Not Adjusted,245815,256037,10222,4.0
2372,2007,March,Franklin                                             ,Not Adjusted,5327,5518,191,3.5
2373,2007,June,Franklin                                             ,Not Adjusted,5310,5536,226,4.1
2374,2007,September,Franklin                                             ,Not Adjusted,5251,5465,214,3.9
2375,2007,December,Franklin                                             ,Not Adjusted,5077,5283,206,3.9
2376,2007,March,Freestone                                            ,Not Adjusted,9484,9830,346,3.5
2377,2007,June,Freestone                                            ,Not Adjusted,9544,9942,398,4.0
2378,2007,September,Freestone                                            ,Not Adjusted,9671,10042,371,3.7
2379,2007,December,Freestone                                            ,Not Adjusted,9520,9900,380,3.8
2380,2007,March,Frio                                                 ,Not Adjusted,6276,6588,312,4.7
2381,2007,June,Frio                                                 ,Not Adjusted,6202,6560,358,5.5
2382,2007,September,Frio                                                 ,Not Adjusted,6143,6472,329,5.1
2383,2007,December,Frio                                                 ,Not Adjusted,6203,6526,323,4.9
2384,2007,March,Gaines                                               ,Not Adjusted,6214,6468,254,3.9
2385,2007,June,Gaines                                               ,Not Adjusted,6351,6614,263,4.0
2386,2007,September,Gaines                                               ,Not Adjusted,6065,6307,242,3.8
2387,2007,December,Gaines                                               ,Not Adjusted,6289,6514,225,3.5
2388,2007,March,Galveston                                            ,Not Adjusted,130749,136714,5965,4.4
2389,2007,June,Galveston                                            ,Not Adjusted,131690,138573,6883,5.0
2390,2007,September,Galveston                                            ,Not Adjusted,132203,138830,6627,4.8
2391,2007,December,Galveston                                            ,Not Adjusted,133357,139915,6558,4.7
2392,2007,March,Garza                                                ,Not Adjusted,2578,2656,78,2.9
2393,2007,June,Garza                                                ,Not Adjusted,2277,2365,88,3.7
2394,2007,September,Garza                                                ,Not Adjusted,2256,2343,87,3.7
2395,2007,December,Garza                                                ,Not Adjusted,2282,2375,93,3.9
2396,2007,March,Gillespie                                            ,Not Adjusted,12455,12809,354,2.8
2397,2007,June,Gillespie                                            ,Not Adjusted,12788,13172,384,2.9
2398,2007,September,Gillespie                                            ,Not Adjusted,12454,12840,386,3.0
2399,2007,December,Gillespie                                            ,Not Adjusted,12700,13054,354,2.7
2400,2007,March,Glasscock                                            ,Not Adjusted,594,614,20,3.3
2401,2007,June,Glasscock                                            ,Not Adjusted,591,617,26,4.2
2402,2007,September,Glasscock                                            ,Not Adjusted,559,581,22,3.8
2403,2007,December,Glasscock                                            ,Not Adjusted,588,608,20,3.3
2404,2007,March,Goliad                                               ,Not Adjusted,3268,3402,134,3.9
2405,2007,June,Goliad                                               ,Not Adjusted,3317,3459,142,4.1
2406,2007,September,Goliad                                               ,Not Adjusted,3324,3453,129,3.7
2407,2007,December,Goliad                                               ,Not Adjusted,3330,3449,119,3.5
2408,2007,March,Gonzales                                             ,Not Adjusted,9382,9728,346,3.6
2409,2007,June,Gonzales                                             ,Not Adjusted,9505,9918,413,4.2
2410,2007,September,Gonzales                                             ,Not Adjusted,9189,9581,392,4.1
2411,2007,December,Gonzales                                             ,Not Adjusted,9341,9701,360,3.7
2412,2007,March,Gray                                                 ,Not Adjusted,10707,11085,378,3.4
2413,2007,June,Gray                                                 ,Not Adjusted,10843,11255,412,3.7
2414,2007,September,Gray                                                 ,Not Adjusted,10774,11183,409,3.7
2415,2007,December,Gray                                                 ,Not Adjusted,10906,11278,372,3.3
2416,2007,March,Grayson                                              ,Not Adjusted,52777,55235,2458,4.5
2417,2007,June,Grayson                                              ,Not Adjusted,52700,55330,2630,4.8
2418,2007,September,Grayson                                              ,Not Adjusted,52849,55524,2675,4.8
2419,2007,December,Grayson                                              ,Not Adjusted,52591,55232,2641,4.8
2420,2007,March,Gregg                                                ,Not Adjusted,60014,62246,2232,3.6
2421,2007,June,Gregg                                                ,Not Adjusted,59844,62484,2640,4.2
2422,2007,September,Gregg                                                ,Not Adjusted,60419,62844,2425,3.9
2423,2007,December,Gregg                                                ,Not Adjusted,60605,62942,2337,3.7
2424,2007,March,Grimes                                               ,Not Adjusted,9891,10376,485,4.7
2425,2007,June,Grimes                                               ,Not Adjusted,9839,10361,522,5.0
2426,2007,September,Grimes                                               ,Not Adjusted,10067,10567,500,4.7
2427,2007,December,Grimes                                               ,Not Adjusted,10067,10554,487,4.6
2428,2007,March,Guadalupe                                            ,Not Adjusted,53003,55074,2071,3.8
2429,2007,June,Guadalupe                                            ,Not Adjusted,53408,55722,2314,4.2
2430,2007,September,Guadalupe                                            ,Not Adjusted,53589,55781,2192,3.9
2431,2007,December,Guadalupe                                            ,Not Adjusted,53845,55878,2033,3.6
2432,2007,March,Hale                                                 ,Not Adjusted,15373,16151,778,4.8
2433,2007,June,Hale                                                 ,Not Adjusted,15461,16368,907,5.5
2434,2007,September,Hale                                                 ,Not Adjusted,15417,16163,746,4.6
2435,2007,December,Hale                                                 ,Not Adjusted,15578,16276,698,4.3
2436,2007,March,Hall                                                 ,Not Adjusted,1365,1450,85,5.9
2437,2007,June,Hall                                                 ,Not Adjusted,1342,1423,81,5.7
2438,2007,September,Hall                                                 ,Not Adjusted,1311,1379,68,4.9
2439,2007,December,Hall                                                 ,Not Adjusted,1319,1384,65,4.7
2440,2007,March,Hamilton                                             ,Not Adjusted,3905,4044,139,3.4
2441,2007,June,Hamilton                                             ,Not Adjusted,3916,4072,156,3.8
2442,2007,September,Hamilton                                             ,Not Adjusted,3788,3932,144,3.7
2443,2007,December,Hamilton                                             ,Not Adjusted,4013,4154,141,3.4
2444,2007,March,Hansford                                             ,Not Adjusted,2420,2496,76,3.0
2445,2007,June,Hansford                                             ,Not Adjusted,2466,2554,88,3.4
2446,2007,September,Hansford                                             ,Not Adjusted,2418,2499,81,3.2
2447,2007,December,Hansford                                             ,Not Adjusted,2500,2573,73,2.8
2448,2007,March,Hardeman                                             ,Not Adjusted,2242,2319,77,3.3
2449,2007,June,Hardeman                                             ,Not Adjusted,2271,2372,101,4.3
2450,2007,September,Hardeman                                             ,Not Adjusted,2231,2319,88,3.8
2451,2007,December,Hardeman                                             ,Not Adjusted,2246,2325,79,3.4
2452,2007,March,Hardin                                               ,Not Adjusted,24820,25902,1082,4.2
2453,2007,June,Hardin                                               ,Not Adjusted,24581,25827,1246,4.8
2454,2007,September,Hardin                                               ,Not Adjusted,24542,25794,1252,4.9
2455,2007,December,Hardin                                               ,Not Adjusted,24392,25746,1354,5.3
2456,2007,March,Harris                                               ,Not Adjusted,1804210,1882891,78681,4.2
2457,2007,June,Harris                                               ,Not Adjusted,1817191,1903666,86475,4.5
2458,2007,September,Harris                                               ,Not Adjusted,1824246,1908749,84503,4.4
2459,2007,December,Harris                                               ,Not Adjusted,1840211,1922066,81855,4.3
2460,2007,March,Harrison                                             ,Not Adjusted,30307,31615,1308,4.1
2461,2007,June,Harrison                                             ,Not Adjusted,30608,32118,1510,4.7
2462,2007,September,Harrison                                             ,Not Adjusted,30703,32163,1460,4.5
2463,2007,December,Harrison                                             ,Not Adjusted,31154,32524,1370,4.2
2464,2007,March,Hartley                                              ,Not Adjusted,2228,2302,74,3.2
2465,2007,June,Hartley                                              ,Not Adjusted,2255,2334,79,3.4
2466,2007,September,Hartley                                              ,Not Adjusted,2191,2268,77,3.4
2467,2007,December,Hartley                                              ,Not Adjusted,2263,2335,72,3.1
2468,2007,March,Haskell                                              ,Not Adjusted,2956,3062,106,3.5
2469,2007,June,Haskell                                              ,Not Adjusted,3025,3134,109,3.5
2470,2007,September,Haskell                                              ,Not Adjusted,2921,3038,117,3.9
2471,2007,December,Haskell                                              ,Not Adjusted,2970,3083,113,3.7
2472,2007,March,Hays                                                 ,Not Adjusted,70127,72806,2679,3.7
2473,2007,June,Hays                                                 ,Not Adjusted,70538,73592,3054,4.1
2474,2007,September,Hays                                                 ,Not Adjusted,70848,73712,2864,3.9
2475,2007,December,Hays                                                 ,Not Adjusted,71305,74085,2780,3.8
2476,2007,March,Hemphill                                             ,Not Adjusted,2377,2430,53,2.2
2477,2007,June,Hemphill                                             ,Not Adjusted,2690,2753,63,2.3
2478,2007,September,Hemphill                                             ,Not Adjusted,2669,2728,59,2.2
2479,2007,December,Hemphill                                             ,Not Adjusted,2779,2838,59,2.1
2480,2007,March,Henderson                                            ,Not Adjusted,32694,34172,1478,4.3
2481,2007,June,Henderson                                            ,Not Adjusted,32824,34463,1639,4.8
2482,2007,September,Henderson                                            ,Not Adjusted,32564,34141,1577,4.6
2483,2007,December,Henderson                                            ,Not Adjusted,32596,34163,1567,4.6
2484,2007,March,Hidalgo                                              ,Not Adjusted,252991,270730,17739,6.6
2485,2007,June,Hidalgo                                              ,Not Adjusted,251637,270722,19085,7.0
2486,2007,September,Hidalgo                                              ,Not Adjusted,253116,270290,17174,6.4
2487,2007,December,Hidalgo                                              ,Not Adjusted,259429,278105,18676,6.7
2488,2007,March,Hill                                                 ,Not Adjusted,14593,15307,714,4.7
2489,2007,June,Hill                                                 ,Not Adjusted,14741,15528,787,5.1
2490,2007,September,Hill                                                 ,Not Adjusted,14572,15298,726,4.7
2491,2007,December,Hill                                                 ,Not Adjusted,14890,15579,689,4.4
2492,2007,March,Hockley                                              ,Not Adjusted,11056,11472,416,3.6
2493,2007,June,Hockley                                              ,Not Adjusted,10880,11346,466,4.1
2494,2007,September,Hockley                                              ,Not Adjusted,10845,11282,437,3.9
2495,2007,December,Hockley                                              ,Not Adjusted,11190,11578,388,3.4
2496,2007,March,Hood                                                 ,Not Adjusted,22845,23794,949,4.0
2497,2007,June,Hood                                                 ,Not Adjusted,22761,23844,1083,4.5
2498,2007,September,Hood                                                 ,Not Adjusted,22919,23935,1016,4.2
2499,2007,December,Hood                                                 ,Not Adjusted,23088,24056,968,4.0
2500,2007,March,Hopkins                                              ,Not Adjusted,16295,16936,641,3.8
2501,2007,June,Hopkins                                              ,Not Adjusted,16349,17045,696,4.1
2502,2007,September,Hopkins                                              ,Not Adjusted,16347,17001,654,3.8
2503,2007,December,Hopkins                                              ,Not Adjusted,16349,17026,677,4.0
2504,2007,March,Houston                                              ,Not Adjusted,7409,7862,453,5.8
2505,2007,June,Houston                                              ,Not Adjusted,7431,7965,534,6.7
2506,2007,September,Houston                                              ,Not Adjusted,7346,7821,475,6.1
2507,2007,December,Houston                                              ,Not Adjusted,7443,7892,449,5.7
2508,2007,March,Howard                                               ,Not Adjusted,13173,13754,581,4.2
2509,2007,June,Howard                                               ,Not Adjusted,13400,14027,627,4.5
2510,2007,September,Howard                                               ,Not Adjusted,13332,13913,581,4.2
2511,2007,December,Howard                                               ,Not Adjusted,13382,13944,562,4.0
2512,2007,March,Hudspeth                                             ,Not Adjusted,1411,1499,88,5.9
2513,2007,June,Hudspeth                                             ,Not Adjusted,1501,1583,82,5.2
2514,2007,September,Hudspeth                                             ,Not Adjusted,1457,1530,73,4.8
2515,2007,December,Hudspeth                                             ,Not Adjusted,1444,1514,70,4.6
2516,2007,March,Hunt                                                 ,Not Adjusted,35657,37307,1650,4.4
2517,2007,June,Hunt                                                 ,Not Adjusted,35873,37706,1833,4.9
2518,2007,September,Hunt                                                 ,Not Adjusted,36026,37831,1805,4.8
2519,2007,December,Hunt                                                 ,Not Adjusted,36272,38070,1798,4.7
2520,2007,March,Hutchinson                                           ,Not Adjusted,10833,11245,412,3.7
2521,2007,June,Hutchinson                                           ,Not Adjusted,10875,11358,483,4.3
2522,2007,September,Hutchinson                                           ,Not Adjusted,10489,10979,490,4.5
2523,2007,December,Hutchinson                                           ,Not Adjusted,10588,11022,434,3.9
2524,2007,March,Irion                                                ,Not Adjusted,892,919,27,2.9
2525,2007,June,Irion                                                ,Not Adjusted,898,928,30,3.2
2526,2007,September,Irion                                                ,Not Adjusted,893,925,32,3.5
2527,2007,December,Irion                                                ,Not Adjusted,899,925,26,2.8
2528,2007,March,Jack                                                 ,Not Adjusted,4566,4713,147,3.1
2529,2007,June,Jack                                                 ,Not Adjusted,4830,4994,164,3.3
2530,2007,September,Jack                                                 ,Not Adjusted,5104,5260,156,3.0
2531,2007,December,Jack                                                 ,Not Adjusted,5133,5281,148,2.8
2532,2007,March,Jackson                                              ,Not Adjusted,6170,6416,246,3.8
2533,2007,June,Jackson                                              ,Not Adjusted,6481,6762,281,4.2
2534,2007,September,Jackson                                              ,Not Adjusted,6373,6631,258,3.9
2535,2007,December,Jackson                                              ,Not Adjusted,6521,6764,243,3.6
2536,2007,March,Jasper                                               ,Not Adjusted,14826,15653,827,5.3
2537,2007,June,Jasper                                               ,Not Adjusted,14747,15653,906,5.8
2538,2007,September,Jasper                                               ,Not Adjusted,14459,15335,876,5.7
2539,2007,December,Jasper                                               ,Not Adjusted,14648,15616,968,6.2
2540,2007,March,Jeff Davis                                           ,Not Adjusted,1138,1177,39,3.3
2541,2007,June,Jeff Davis                                           ,Not Adjusted,1158,1200,42,3.5
2542,2007,September,Jeff Davis                                           ,Not Adjusted,1148,1187,39,3.3
2543,2007,December,Jeff Davis                                           ,Not Adjusted,1164,1201,37,3.1
2544,2007,March,Jefferson                                            ,Not Adjusted,107217,112747,5530,4.9
2545,2007,June,Jefferson                                            ,Not Adjusted,106188,112584,6396,5.7
2546,2007,September,Jefferson                                            ,Not Adjusted,106020,112464,6444,5.7
2547,2007,December,Jefferson                                            ,Not Adjusted,105373,112277,6904,6.1
2548,2007,March,Jim Hogg                                             ,Not Adjusted,2604,2700,96,3.6
2549,2007,June,Jim Hogg                                             ,Not Adjusted,2664,2785,121,4.3
2550,2007,September,Jim Hogg                                             ,Not Adjusted,2621,2732,111,4.1
2551,2007,December,Jim Hogg                                             ,Not Adjusted,2622,2718,96,3.5
2552,2007,March,Jim Wells                                            ,Not Adjusted,19989,20788,799,3.8
2553,2007,June,Jim Wells                                            ,Not Adjusted,20452,21386,934,4.4
2554,2007,September,Jim Wells                                            ,Not Adjusted,20560,21429,869,4.1
2555,2007,December,Jim Wells                                            ,Not Adjusted,20298,21122,824,3.9
2556,2007,March,Johnson                                              ,Not Adjusted,68532,71539,3007,4.2
2557,2007,June,Johnson                                              ,Not Adjusted,68492,71759,3267,4.6
2558,2007,September,Johnson                                              ,Not Adjusted,69022,72045,3023,4.2
2559,2007,December,Johnson                                              ,Not Adjusted,69460,72359,2899,4.0
2560,2007,March,Jones                                                ,Not Adjusted,7218,7590,372,4.9
2561,2007,June,Jones                                                ,Not Adjusted,7244,7641,397,5.2
2562,2007,September,Jones                                                ,Not Adjusted,7306,7680,374,4.9
2563,2007,December,Jones                                                ,Not Adjusted,7316,7671,355,4.6
2564,2007,March,Karnes                                               ,Not Adjusted,4952,5221,269,5.2
2565,2007,June,Karnes                                               ,Not Adjusted,4981,5303,322,6.1
2566,2007,September,Karnes                                               ,Not Adjusted,4858,5171,313,6.1
2567,2007,December,Karnes                                               ,Not Adjusted,4877,5154,277,5.4
2568,2007,March,Kaufman                                              ,Not Adjusted,42829,44888,2059,4.6
2569,2007,June,Kaufman                                              ,Not Adjusted,43088,45392,2304,5.1
2570,2007,September,Kaufman                                              ,Not Adjusted,43271,45419,2148,4.7
2571,2007,December,Kaufman                                              ,Not Adjusted,43567,45774,2207,4.8
2572,2007,March,Kendall                                              ,Not Adjusted,14742,15268,526,3.4
2573,2007,June,Kendall                                              ,Not Adjusted,14854,15416,562,3.6
2574,2007,September,Kendall                                              ,Not Adjusted,14904,15478,574,3.7
2575,2007,December,Kendall                                              ,Not Adjusted,14976,15495,519,3.3
2576,2007,March,Kenedy                                               ,Not Adjusted,234,239,5,2.1
2577,2007,June,Kenedy                                               ,Not Adjusted,226,232,6,2.6
2578,2007,September,Kenedy                                               ,Not Adjusted,224,230,6,2.6
2579,2007,December,Kenedy                                               ,Not Adjusted,229,241,12,5.0
2580,2007,March,Kent                                                 ,Not Adjusted,408,420,12,2.9
2581,2007,June,Kent                                                 ,Not Adjusted,429,444,15,3.4
2582,2007,September,Kent                                                 ,Not Adjusted,400,414,14,3.4
2583,2007,December,Kent                                                 ,Not Adjusted,416,429,13,3.0
2584,2007,March,Kerr                                                 ,Not Adjusted,21345,22121,776,3.5
2585,2007,June,Kerr                                                 ,Not Adjusted,22040,22875,835,3.7
2586,2007,September,Kerr                                                 ,Not Adjusted,21800,22624,824,3.6
2587,2007,December,Kerr                                                 ,Not Adjusted,21887,22649,762,3.4
2588,2007,March,Kimble                                               ,Not Adjusted,2145,2215,70,3.2
2589,2007,June,Kimble                                               ,Not Adjusted,2242,2317,75,3.2
2590,2007,September,Kimble                                               ,Not Adjusted,2143,2218,75,3.4
2591,2007,December,Kimble                                               ,Not Adjusted,2113,2199,86,3.9
2592,2007,March,King                                                 ,Not Adjusted,158,166,8,4.8
2593,2007,June,King                                                 ,Not Adjusted,184,192,8,4.2
2594,2007,September,King                                                 ,Not Adjusted,184,191,7,3.7
2595,2007,December,King                                                 ,Not Adjusted,165,172,7,4.1
2596,2007,March,Kinney                                               ,Not Adjusted,1314,1386,72,5.2
2597,2007,June,Kinney                                               ,Not Adjusted,1297,1357,60,4.4
2598,2007,September,Kinney                                               ,Not Adjusted,1257,1316,59,4.5
2599,2007,December,Kinney                                               ,Not Adjusted,1326,1396,70,5.0
2600,2007,March,Kleberg                                              ,Not Adjusted,15616,16246,630,3.9
2601,2007,June,Kleberg                                              ,Not Adjusted,15130,15883,753,4.7
2602,2007,September,Kleberg                                              ,Not Adjusted,14929,15619,690,4.4
2603,2007,December,Kleberg                                              ,Not Adjusted,15302,15960,658,4.1
2604,2007,March,Knox                                                 ,Not Adjusted,1748,1818,70,3.9
2605,2007,June,Knox                                                 ,Not Adjusted,1788,1867,79,4.2
2606,2007,September,Knox                                                 ,Not Adjusted,1707,1770,63,3.6
2607,2007,December,Knox                                                 ,Not Adjusted,1751,1814,63,3.5
2608,2007,March,Lamar                                                ,Not Adjusted,22681,23788,1107,4.7
2609,2007,June,Lamar                                                ,Not Adjusted,23176,24394,1218,5.0
2610,2007,September,Lamar                                                ,Not Adjusted,23284,24468,1184,4.8
2611,2007,December,Lamar                                                ,Not Adjusted,22953,24049,1096,4.6
2612,2007,March,Lamb                                                 ,Not Adjusted,6747,7028,281,4.0
2613,2007,June,Lamb                                                 ,Not Adjusted,6786,7104,318,4.5
2614,2007,September,Lamb                                                 ,Not Adjusted,6590,6873,283,4.1
2615,2007,December,Lamb                                                 ,Not Adjusted,6755,7028,273,3.9
2616,2007,March,Lampasas                                             ,Not Adjusted,9702,10076,374,3.7
2617,2007,June,Lampasas                                             ,Not Adjusted,9670,10085,415,4.1
2618,2007,September,Lampasas                                             ,Not Adjusted,9787,10174,387,3.8
2619,2007,December,Lampasas                                             ,Not Adjusted,9876,10240,364,3.6
2620,2007,March,La Salle                                             ,Not Adjusted,2604,2726,122,4.5
2621,2007,June,La Salle                                             ,Not Adjusted,2695,2847,152,5.3
2622,2007,September,La Salle                                             ,Not Adjusted,2620,2762,142,5.1
2623,2007,December,La Salle                                             ,Not Adjusted,2602,2750,148,5.4
2624,2007,March,Lavaca                                               ,Not Adjusted,9947,10246,299,2.9
2625,2007,June,Lavaca                                               ,Not Adjusted,10036,10363,327,3.2
2626,2007,September,Lavaca                                               ,Not Adjusted,9557,9908,351,3.5
2627,2007,December,Lavaca                                               ,Not Adjusted,9606,9933,327,3.3
2628,2007,March,Lee                                                  ,Not Adjusted,8632,8923,291,3.3
2629,2007,June,Lee                                                  ,Not Adjusted,8634,8992,358,4.0
2630,2007,September,Lee                                                  ,Not Adjusted,8538,8867,329,3.7
2631,2007,December,Lee                                                  ,Not Adjusted,8495,8812,317,3.6
2632,2007,March,Leon                                                 ,Not Adjusted,7279,7584,305,4.0
2633,2007,June,Leon                                                 ,Not Adjusted,7245,7587,342,4.5
2634,2007,September,Leon                                                 ,Not Adjusted,7313,7638,325,4.3
2635,2007,December,Leon                                                 ,Not Adjusted,7254,7572,318,4.2
2636,2007,March,Liberty                                              ,Not Adjusted,28813,30340,1527,5.0
2637,2007,June,Liberty                                              ,Not Adjusted,29019,30733,1714,5.6
2638,2007,September,Liberty                                              ,Not Adjusted,29132,30827,1695,5.5
2639,2007,December,Liberty                                              ,Not Adjusted,29388,31047,1659,5.3
2640,2007,March,Limestone                                            ,Not Adjusted,9901,10299,398,3.9
2641,2007,June,Limestone                                            ,Not Adjusted,9984,10468,484,4.6
2642,2007,September,Limestone                                            ,Not Adjusted,9809,10279,470,4.6
2643,2007,December,Limestone                                            ,Not Adjusted,9897,10341,444,4.3
2644,2007,March,Lipscomb                                             ,Not Adjusted,1790,1835,45,2.5
2645,2007,June,Lipscomb                                             ,Not Adjusted,1814,1865,51,2.7
2646,2007,September,Lipscomb                                             ,Not Adjusted,1748,1804,56,3.1
2647,2007,December,Lipscomb                                             ,Not Adjusted,1848,1893,45,2.4
2648,2007,March,Live Oak                                             ,Not Adjusted,4844,5038,194,3.9
2649,2007,June,Live Oak                                             ,Not Adjusted,4873,5079,206,4.1
2650,2007,September,Live Oak                                             ,Not Adjusted,4752,4955,203,4.1
2651,2007,December,Live Oak                                             ,Not Adjusted,4893,5093,200,3.9
2652,2007,March,Llano                                                ,Not Adjusted,7650,7978,328,4.1
2653,2007,June,Llano                                                ,Not Adjusted,8134,8476,342,4.0
2654,2007,September,Llano                                                ,Not Adjusted,7873,8209,336,4.1
2655,2007,December,Llano                                                ,Not Adjusted,7719,8043,324,4.0
2656,2007,March,Loving                                               ,Not Adjusted,46,50,4,8.0
2657,2007,June,Loving                                               ,Not Adjusted,35,38,3,7.9
2658,2007,September,Loving                                               ,Not Adjusted,34,38,4,10.5
2659,2007,December,Loving                                               ,Not Adjusted,42,45,3,6.7
2660,2007,March,Lubbock                                              ,Not Adjusted,130905,136073,5168,3.8
2661,2007,June,Lubbock                                              ,Not Adjusted,129061,134801,5740,4.3
2662,2007,September,Lubbock                                              ,Not Adjusted,131627,136587,4960,3.6
2663,2007,December,Lubbock                                              ,Not Adjusted,132261,136902,4641,3.4
2664,2007,March,Lynn                                                 ,Not Adjusted,2605,2742,137,5.0
2665,2007,June,Lynn                                                 ,Not Adjusted,2602,2754,152,5.5
2666,2007,September,Lynn                                                 ,Not Adjusted,2484,2610,126,4.8
2667,2007,December,Lynn                                                 ,Not Adjusted,2555,2666,111,4.2
2668,2007,March,McCulloch                                            ,Not Adjusted,3457,3596,139,3.9
2669,2007,June,McCulloch                                            ,Not Adjusted,3688,3839,151,3.9
2670,2007,September,McCulloch                                            ,Not Adjusted,3527,3680,153,4.2
2671,2007,December,McCulloch                                            ,Not Adjusted,3713,3855,142,3.7
2672,2007,March,McLennan                                             ,Not Adjusted,106257,110817,4560,4.1
2673,2007,June,McLennan                                             ,Not Adjusted,105758,111114,5356,4.8
2674,2007,September,McLennan                                             ,Not Adjusted,105720,110555,4835,4.4
2675,2007,December,McLennan                                             ,Not Adjusted,104827,109355,4528,4.1
2676,2007,March,McMullen                                             ,Not Adjusted,324,343,19,5.5
2677,2007,June,McMullen                                             ,Not Adjusted,320,336,16,4.8
2678,2007,September,McMullen                                             ,Not Adjusted,313,330,17,5.2
2679,2007,December,McMullen                                             ,Not Adjusted,321,341,20,5.9
2680,2007,March,Madison                                              ,Not Adjusted,4819,5047,228,4.5
2681,2007,June,Madison                                              ,Not Adjusted,4826,5077,251,4.9
2682,2007,September,Madison                                              ,Not Adjusted,4756,5003,247,4.9
2683,2007,December,Madison                                              ,Not Adjusted,4695,4912,217,4.4
2684,2007,March,Marion                                               ,Not Adjusted,4831,5055,224,4.4
2685,2007,June,Marion                                               ,Not Adjusted,4907,5144,237,4.6
2686,2007,September,Marion                                               ,Not Adjusted,4785,5031,246,4.9
2687,2007,December,Marion                                               ,Not Adjusted,4826,5075,249,4.9
2688,2007,March,Martin                                               ,Not Adjusted,2045,2132,87,4.1
2689,2007,June,Martin                                               ,Not Adjusted,2072,2154,82,3.8
2690,2007,September,Martin                                               ,Not Adjusted,2055,2128,73,3.4
2691,2007,December,Martin                                               ,Not Adjusted,2086,2151,65,3.0
2692,2007,March,Mason                                                ,Not Adjusted,2274,2340,66,2.8
2693,2007,June,Mason                                                ,Not Adjusted,2385,2462,77,3.1
2694,2007,September,Mason                                                ,Not Adjusted,2292,2358,66,2.8
2695,2007,December,Mason                                                ,Not Adjusted,2291,2355,64,2.7
2696,2007,March,Matagorda                                            ,Not Adjusted,15710,16575,865,5.2
2697,2007,June,Matagorda                                            ,Not Adjusted,15865,16969,1104,6.5
2698,2007,September,Matagorda                                            ,Not Adjusted,15350,16357,1007,6.2
2699,2007,December,Matagorda                                            ,Not Adjusted,15577,16614,1037,6.2
2700,2007,March,Maverick                                             ,Not Adjusted,17548,20504,2956,14.4
2701,2007,June,Maverick                                             ,Not Adjusted,17662,19695,2033,10.3
2702,2007,September,Maverick                                             ,Not Adjusted,17665,19149,1484,7.7
2703,2007,December,Maverick                                             ,Not Adjusted,17941,20070,2129,10.6
2704,2007,March,Medina                                               ,Not Adjusted,18467,19246,779,4.0
2705,2007,June,Medina                                               ,Not Adjusted,18607,19447,840,4.3
2706,2007,September,Medina                                               ,Not Adjusted,18671,19587,916,4.7
2707,2007,December,Medina                                               ,Not Adjusted,18760,19622,862,4.4
2708,2007,March,Menard                                               ,Not Adjusted,1061,1098,37,3.4
2709,2007,June,Menard                                               ,Not Adjusted,1092,1131,39,3.4
2710,2007,September,Menard                                               ,Not Adjusted,1000,1037,37,3.6
2711,2007,December,Menard                                               ,Not Adjusted,1006,1046,40,3.8
2712,2007,March,Midland                                              ,Not Adjusted,68210,70210,2000,2.8
2713,2007,June,Midland                                              ,Not Adjusted,69278,71581,2303,3.2
2714,2007,September,Midland                                              ,Not Adjusted,69941,72089,2148,3.0
2715,2007,December,Midland                                              ,Not Adjusted,70756,72692,1936,2.7
2716,2007,March,Milam                                                ,Not Adjusted,11797,12277,480,3.9
2717,2007,June,Milam                                                ,Not Adjusted,11859,12415,556,4.5
2718,2007,September,Milam                                                ,Not Adjusted,11642,12201,559,4.6
2719,2007,December,Milam                                                ,Not Adjusted,11422,11949,527,4.4
2720,2007,March,Mills                                                ,Not Adjusted,2220,2302,82,3.6
2721,2007,June,Mills                                                ,Not Adjusted,2222,2318,96,4.1
2722,2007,September,Mills                                                ,Not Adjusted,2230,2321,91,3.9
2723,2007,December,Mills                                                ,Not Adjusted,2209,2292,83,3.6
2724,2007,March,Mitchell                                             ,Not Adjusted,3182,3358,176,5.2
2725,2007,June,Mitchell                                             ,Not Adjusted,3144,3336,192,5.8
2726,2007,September,Mitchell                                             ,Not Adjusted,3048,3220,172,5.3
2727,2007,December,Mitchell                                             ,Not Adjusted,3092,3245,153,4.7
2728,2007,March,Montague                                             ,Not Adjusted,9861,10215,354,3.5
2729,2007,June,Montague                                             ,Not Adjusted,10065,10457,392,3.7
2730,2007,September,Montague                                             ,Not Adjusted,9893,10285,392,3.8
2731,2007,December,Montague                                             ,Not Adjusted,10072,10438,366,3.5
2732,2007,March,Montgomery                                           ,Not Adjusted,193500,201176,7676,3.8
2733,2007,June,Montgomery                                           ,Not Adjusted,194893,203381,8488,4.2
2734,2007,September,Montgomery                                           ,Not Adjusted,195649,203785,8136,4.0
2735,2007,December,Montgomery                                           ,Not Adjusted,197362,205068,7706,3.8
2736,2007,March,Moore                                                ,Not Adjusted,10152,10462,310,3.0
2737,2007,June,Moore                                                ,Not Adjusted,10569,10921,352,3.2
2738,2007,September,Moore                                                ,Not Adjusted,10264,10588,324,3.1
2739,2007,December,Moore                                                ,Not Adjusted,10540,10838,298,2.7
2740,2007,March,Morris                                               ,Not Adjusted,5835,6121,286,4.7
2741,2007,June,Morris                                               ,Not Adjusted,5764,6123,359,5.9
2742,2007,September,Morris                                               ,Not Adjusted,5728,6047,319,5.3
2743,2007,December,Morris                                               ,Not Adjusted,5529,5874,345,5.9
2744,2007,March,Motley                                               ,Not Adjusted,640,666,26,3.9
2745,2007,June,Motley                                               ,Not Adjusted,686,709,23,3.2
2746,2007,September,Motley                                               ,Not Adjusted,652,687,35,5.1
2747,2007,December,Motley                                               ,Not Adjusted,676,707,31,4.4
2748,2007,March,Nacogdoches                                          ,Not Adjusted,29344,30591,1247,4.1
2749,2007,June,Nacogdoches                                          ,Not Adjusted,28892,30366,1474,4.9
2750,2007,September,Nacogdoches                                          ,Not Adjusted,29061,30346,1285,4.2
2751,2007,December,Nacogdoches                                          ,Not Adjusted,29307,30476,1169,3.8
2752,2007,March,Navarro                                              ,Not Adjusted,19630,20631,1001,4.9
2753,2007,June,Navarro                                              ,Not Adjusted,19486,20620,1134,5.5
2754,2007,September,Navarro                                              ,Not Adjusted,19642,20686,1044,5.0
2755,2007,December,Navarro                                              ,Not Adjusted,19763,20747,984,4.7
2756,2007,March,Newton                                               ,Not Adjusted,5406,5748,342,5.9
2757,2007,June,Newton                                               ,Not Adjusted,5378,5769,391,6.8
2758,2007,September,Newton                                               ,Not Adjusted,5371,5756,385,6.7
2759,2007,December,Newton                                               ,Not Adjusted,5454,5877,423,7.2
2760,2007,March,Nolan                                                ,Not Adjusted,7264,7552,288,3.8
2761,2007,June,Nolan                                                ,Not Adjusted,7338,7655,317,4.1
2762,2007,September,Nolan                                                ,Not Adjusted,7205,7475,270,3.6
2763,2007,December,Nolan                                                ,Not Adjusted,7162,7415,253,3.4
2764,2007,March,Nueces                                               ,Not Adjusted,150904,157469,6565,4.2
2765,2007,June,Nueces                                               ,Not Adjusted,151025,158400,7375,4.7
2766,2007,September,Nueces                                               ,Not Adjusted,150802,157716,6914,4.4
2767,2007,December,Nueces                                               ,Not Adjusted,153123,159877,6754,4.2
2768,2007,March,Ochiltree                                            ,Not Adjusted,5012,5144,132,2.6
2769,2007,June,Ochiltree                                            ,Not Adjusted,5184,5339,155,2.9
2770,2007,September,Ochiltree                                            ,Not Adjusted,5067,5214,147,2.8
2771,2007,December,Ochiltree                                            ,Not Adjusted,5213,5346,133,2.5
2772,2007,March,Oldham                                               ,Not Adjusted,889,925,36,3.9
2773,2007,June,Oldham                                               ,Not Adjusted,914,959,45,4.7
2774,2007,September,Oldham                                               ,Not Adjusted,889,925,36,3.9
2775,2007,December,Oldham                                               ,Not Adjusted,904,935,31,3.3
2776,2007,March,Orange                                               ,Not Adjusted,38925,40883,1958,4.8
2777,2007,June,Orange                                               ,Not Adjusted,38552,40792,2240,5.5
2778,2007,September,Orange                                               ,Not Adjusted,38490,40713,2223,5.5
2779,2007,December,Orange                                               ,Not Adjusted,38256,40639,2383,5.9
2780,2007,March,Palo Pinto                                           ,Not Adjusted,13479,13990,511,3.7
2781,2007,June,Palo Pinto                                           ,Not Adjusted,13553,14099,546,3.9
2782,2007,September,Palo Pinto                                           ,Not Adjusted,13221,13753,532,3.9
2783,2007,December,Palo Pinto                                           ,Not Adjusted,13184,13685,501,3.7
2784,2007,March,Panola                                               ,Not Adjusted,11600,12048,448,3.7
2785,2007,June,Panola                                               ,Not Adjusted,11906,12409,503,4.1
2786,2007,September,Panola                                               ,Not Adjusted,12193,12673,480,3.8
2787,2007,December,Panola                                               ,Not Adjusted,12107,12562,455,3.6
2788,2007,March,Parker                                               ,Not Adjusted,49833,51935,2102,4.0
2789,2007,June,Parker                                               ,Not Adjusted,49804,52122,2318,4.4
2790,2007,September,Parker                                               ,Not Adjusted,50188,52323,2135,4.1
2791,2007,December,Parker                                               ,Not Adjusted,50507,52577,2070,3.9
2792,2007,March,Parmer                                               ,Not Adjusted,4239,4378,139,3.2
2793,2007,June,Parmer                                               ,Not Adjusted,4299,4457,158,3.5
2794,2007,September,Parmer                                               ,Not Adjusted,4186,4325,139,3.2
2795,2007,December,Parmer                                               ,Not Adjusted,4219,4352,133,3.1
2796,2007,March,Pecos                                                ,Not Adjusted,6231,6495,264,4.1
2797,2007,June,Pecos                                                ,Not Adjusted,6440,6767,327,4.8
2798,2007,September,Pecos                                                ,Not Adjusted,6217,6504,287,4.4
2799,2007,December,Pecos                                                ,Not Adjusted,6330,6593,263,4.0
2800,2007,March,Polk                                                 ,Not Adjusted,15765,16717,952,5.7
2801,2007,June,Polk                                                 ,Not Adjusted,15731,16731,1000,6.0
2802,2007,September,Polk                                                 ,Not Adjusted,15721,16691,970,5.8
2803,2007,December,Polk                                                 ,Not Adjusted,15145,16345,1200,7.3
2804,2007,March,Potter                                               ,Not Adjusted,54087,56237,2150,3.8
2805,2007,June,Potter                                               ,Not Adjusted,54333,56717,2384,4.2
2806,2007,September,Potter                                               ,Not Adjusted,54248,56549,2301,4.1
2807,2007,December,Potter                                               ,Not Adjusted,54681,56795,2114,3.7
2808,2007,March,Presidio                                             ,Not Adjusted,2914,3166,252,8.0
2809,2007,June,Presidio                                             ,Not Adjusted,2927,3225,298,9.2
2810,2007,September,Presidio                                             ,Not Adjusted,2918,3264,346,10.6
2811,2007,December,Presidio                                             ,Not Adjusted,2965,3248,283,8.7
2812,2007,March,Rains                                                ,Not Adjusted,5090,5293,203,3.8
2813,2007,June,Rains                                                ,Not Adjusted,4893,5119,226,4.4
2814,2007,September,Rains                                                ,Not Adjusted,4840,5068,228,4.5
2815,2007,December,Rains                                                ,Not Adjusted,4700,4929,229,4.6
2816,2007,March,Randall                                              ,Not Adjusted,64488,66420,1932,2.9
2817,2007,June,Randall                                              ,Not Adjusted,64780,66952,2172,3.2
2818,2007,September,Randall                                              ,Not Adjusted,64679,66692,2013,3.0
2819,2007,December,Randall                                              ,Not Adjusted,65196,67106,1910,2.8
2820,2007,March,Reagan                                               ,Not Adjusted,2359,2408,49,2.0
2821,2007,June,Reagan                                               ,Not Adjusted,2397,2453,56,2.3
2822,2007,September,Reagan                                               ,Not Adjusted,2286,2338,52,2.2
2823,2007,December,Reagan                                               ,Not Adjusted,2244,2289,45,2.0
2824,2007,March,Real                                                 ,Not Adjusted,1292,1343,51,3.8
2825,2007,June,Real                                                 ,Not Adjusted,1349,1408,59,4.2
2826,2007,September,Real                                                 ,Not Adjusted,1312,1371,59,4.3
2827,2007,December,Real                                                 ,Not Adjusted,1325,1382,57,4.1
2828,2007,March,Red River                                            ,Not Adjusted,5730,6035,305,5.1
2829,2007,June,Red River                                            ,Not Adjusted,5796,6106,310,5.1
2830,2007,September,Red River                                            ,Not Adjusted,5748,6035,287,4.8
2831,2007,December,Red River                                            ,Not Adjusted,5745,6102,357,5.9
2832,2007,March,Reeves                                               ,Not Adjusted,3859,4065,206,5.1
2833,2007,June,Reeves                                               ,Not Adjusted,3945,4202,257,6.1
2834,2007,September,Reeves                                               ,Not Adjusted,3844,4054,210,5.2
2835,2007,December,Reeves                                               ,Not Adjusted,3934,4150,216,5.2
2836,2007,March,Refugio                                              ,Not Adjusted,3671,3811,140,3.7
2837,2007,June,Refugio                                              ,Not Adjusted,3698,3856,158,4.1
2838,2007,September,Refugio                                              ,Not Adjusted,3734,3878,144,3.7
2839,2007,December,Refugio                                              ,Not Adjusted,3853,3982,129,3.2
2840,2007,March,Roberts                                              ,Not Adjusted,544,556,12,2.2
2841,2007,June,Roberts                                              ,Not Adjusted,551,565,14,2.5
2842,2007,September,Roberts                                              ,Not Adjusted,547,560,13,2.3
2843,2007,December,Roberts                                              ,Not Adjusted,554,566,12,2.1
2844,2007,March,Robertson                                            ,Not Adjusted,6611,6999,388,5.5
2845,2007,June,Robertson                                            ,Not Adjusted,6352,6760,408,6.0
2846,2007,September,Robertson                                            ,Not Adjusted,6702,7037,335,4.8
2847,2007,December,Robertson                                            ,Not Adjusted,6750,7039,289,4.1
2848,2007,March,Rockwall                                             ,Not Adjusted,35256,36704,1448,3.9
2849,2007,June,Rockwall                                             ,Not Adjusted,35471,36990,1519,4.1
2850,2007,September,Rockwall                                             ,Not Adjusted,35621,37164,1543,4.2
2851,2007,December,Rockwall                                             ,Not Adjusted,35865,37285,1420,3.8
2852,2007,March,Runnels                                              ,Not Adjusted,4210,4409,199,4.5
2853,2007,June,Runnels                                              ,Not Adjusted,4294,4508,214,4.7
2854,2007,September,Runnels                                              ,Not Adjusted,4169,4351,182,4.2
2855,2007,December,Runnels                                              ,Not Adjusted,4257,4435,178,4.0
2856,2007,March,Rusk                                                 ,Not Adjusted,22439,23406,967,4.1
2857,2007,June,Rusk                                                 ,Not Adjusted,22376,23433,1057,4.5
2858,2007,September,Rusk                                                 ,Not Adjusted,22589,23597,1008,4.3
2859,2007,December,Rusk                                                 ,Not Adjusted,22660,23634,974,4.1
2860,2007,March,Sabine                                               ,Not Adjusted,3119,3394,275,8.1
2861,2007,June,Sabine                                               ,Not Adjusted,3177,3459,282,8.2
2862,2007,September,Sabine                                               ,Not Adjusted,3075,3338,263,7.9
2863,2007,December,Sabine                                               ,Not Adjusted,3108,3389,281,8.3
2864,2007,March,San Augustine                                        ,Not Adjusted,3290,3483,193,5.5
2865,2007,June,San Augustine                                        ,Not Adjusted,3350,3545,195,5.5
2866,2007,September,San Augustine                                        ,Not Adjusted,3289,3468,179,5.2
2867,2007,December,San Augustine                                        ,Not Adjusted,3369,3566,197,5.5
2868,2007,March,San Jacinto                                          ,Not Adjusted,9388,9879,491,5.0
2869,2007,June,San Jacinto                                          ,Not Adjusted,9455,10058,603,6.0
2870,2007,September,San Jacinto                                          ,Not Adjusted,9492,10035,543,5.4
2871,2007,December,San Jacinto                                          ,Not Adjusted,9575,10102,527,5.2
2872,2007,March,San Patricio                                         ,Not Adjusted,27648,29040,1392,4.8
2873,2007,June,San Patricio                                         ,Not Adjusted,27672,29197,1525,5.2
2874,2007,September,San Patricio                                         ,Not Adjusted,27631,29074,1443,5.0
2875,2007,December,San Patricio                                         ,Not Adjusted,28055,29520,1465,5.0
2876,2007,March,San Saba                                             ,Not Adjusted,2455,2559,104,4.1
2877,2007,June,San Saba                                             ,Not Adjusted,2451,2580,129,5.0
2878,2007,September,San Saba                                             ,Not Adjusted,2124,2258,134,5.9
2879,2007,December,San Saba                                             ,Not Adjusted,2224,2351,127,5.4
2880,2007,March,Schleicher                                           ,Not Adjusted,1371,1422,51,3.6
2881,2007,June,Schleicher                                           ,Not Adjusted,1410,1468,58,4.0
2882,2007,September,Schleicher                                           ,Not Adjusted,1323,1372,49,3.6
2883,2007,December,Schleicher                                           ,Not Adjusted,1377,1425,48,3.4
2884,2007,March,Scurry                                               ,Not Adjusted,7019,7302,283,3.9
2885,2007,June,Scurry                                               ,Not Adjusted,7037,7374,337,4.6
2886,2007,September,Scurry                                               ,Not Adjusted,7009,7283,274,3.8
2887,2007,December,Scurry                                               ,Not Adjusted,7065,7336,271,3.7
2888,2007,March,Shackelford                                          ,Not Adjusted,1942,1997,55,2.8
2889,2007,June,Shackelford                                          ,Not Adjusted,2030,2089,59,2.8
2890,2007,September,Shackelford                                          ,Not Adjusted,1999,2052,53,2.6
2891,2007,December,Shackelford                                          ,Not Adjusted,2025,2075,50,2.4
2892,2007,March,Shelby                                               ,Not Adjusted,11573,12078,505,4.2
2893,2007,June,Shelby                                               ,Not Adjusted,11884,12459,575,4.6
2894,2007,September,Shelby                                               ,Not Adjusted,11659,12180,521,4.3
2895,2007,December,Shelby                                               ,Not Adjusted,11697,12209,512,4.2
2896,2007,March,Sherman                                              ,Not Adjusted,1313,1357,44,3.2
2897,2007,June,Sherman                                              ,Not Adjusted,1339,1391,52,3.7
2898,2007,September,Sherman                                              ,Not Adjusted,1263,1311,48,3.7
2899,2007,December,Sherman                                              ,Not Adjusted,1351,1399,48,3.4
2900,2007,March,Smith                                                ,Not Adjusted,92575,96499,3924,4.1
2901,2007,June,Smith                                                ,Not Adjusted,92711,96982,4271,4.4
2902,2007,September,Smith                                                ,Not Adjusted,92480,96593,4113,4.3
2903,2007,December,Smith                                                ,Not Adjusted,93175,97484,4309,4.4
2904,2007,March,Somervell                                            ,Not Adjusted,3724,3870,146,3.8
2905,2007,June,Somervell                                            ,Not Adjusted,3709,3910,201,5.1
2906,2007,September,Somervell                                            ,Not Adjusted,3735,3906,171,4.4
2907,2007,December,Somervell                                            ,Not Adjusted,3763,3919,156,4.0
2908,2007,March,Starr                                                ,Not Adjusted,19243,21747,2504,11.5
2909,2007,June,Starr                                                ,Not Adjusted,18964,21200,2236,10.5
2910,2007,September,Starr                                                ,Not Adjusted,18638,20382,1744,8.6
2911,2007,December,Starr                                                ,Not Adjusted,19390,22088,2698,12.2
2912,2007,March,Stephens                                             ,Not Adjusted,4190,4355,165,3.8
2913,2007,June,Stephens                                             ,Not Adjusted,4336,4513,177,3.9
2914,2007,September,Stephens                                             ,Not Adjusted,4366,4530,164,3.6
2915,2007,December,Stephens                                             ,Not Adjusted,4414,4562,148,3.2
2916,2007,March,Sterling                                             ,Not Adjusted,765,787,22,2.8
2917,2007,June,Sterling                                             ,Not Adjusted,772,798,26,3.3
2918,2007,September,Sterling                                             ,Not Adjusted,776,801,25,3.1
2919,2007,December,Sterling                                             ,Not Adjusted,769,790,21,2.7
2920,2007,March,Stonewall                                            ,Not Adjusted,834,864,30,3.5
2921,2007,June,Stonewall                                            ,Not Adjusted,898,931,33,3.5
2922,2007,September,Stonewall                                            ,Not Adjusted,859,888,29,3.3
2923,2007,December,Stonewall                                            ,Not Adjusted,815,839,24,2.9
2924,2007,March,Sutton                                               ,Not Adjusted,2960,3028,68,2.2
2925,2007,June,Sutton                                               ,Not Adjusted,2964,3035,71,2.3
2926,2007,September,Sutton                                               ,Not Adjusted,3104,3177,73,2.3
2927,2007,December,Sutton                                               ,Not Adjusted,3161,3224,63,2.0
2928,2007,March,Swisher                                              ,Not Adjusted,3389,3541,152,4.3
2929,2007,June,Swisher                                              ,Not Adjusted,3413,3583,170,4.7
2930,2007,September,Swisher                                              ,Not Adjusted,3258,3400,142,4.2
2931,2007,December,Swisher                                              ,Not Adjusted,3359,3507,148,4.2
2932,2007,March,Tarrant                                              ,Not Adjusted,828856,865030,36174,4.2
2933,2007,June,Tarrant                                              ,Not Adjusted,828377,867932,39555,4.6
2934,2007,September,Tarrant                                              ,Not Adjusted,834780,872750,37970,4.4
2935,2007,December,Tarrant                                              ,Not Adjusted,840068,876631,36563,4.2
2936,2007,March,Taylor                                               ,Not Adjusted,62754,64941,2187,3.4
2937,2007,June,Taylor                                               ,Not Adjusted,62980,65529,2549,3.9
2938,2007,September,Taylor                                               ,Not Adjusted,63523,65909,2386,3.6
2939,2007,December,Taylor                                               ,Not Adjusted,63614,65840,2226,3.4
2940,2007,March,Terrell                                              ,Not Adjusted,333,353,20,5.7
2941,2007,June,Terrell                                              ,Not Adjusted,349,367,18,4.9
2942,2007,September,Terrell                                              ,Not Adjusted,334,351,17,4.8
2943,2007,December,Terrell                                              ,Not Adjusted,340,361,21,5.8
2944,2007,March,Terry                                                ,Not Adjusted,5600,5887,287,4.9
2945,2007,June,Terry                                                ,Not Adjusted,5613,5897,284,4.8
2946,2007,September,Terry                                                ,Not Adjusted,5265,5524,259,4.7
2947,2007,December,Terry                                                ,Not Adjusted,5467,5700,233,4.1
2948,2007,March,Throckmorton                                         ,Not Adjusted,949,981,32,3.3
2949,2007,June,Throckmorton                                         ,Not Adjusted,946,985,39,4.0
2950,2007,September,Throckmorton                                         ,Not Adjusted,925,964,39,4.0
2951,2007,December,Throckmorton                                         ,Not Adjusted,962,996,34,3.4
2952,2007,March,Titus                                                ,Not Adjusted,13874,14373,499,3.5
2953,2007,June,Titus                                                ,Not Adjusted,13772,14388,616,4.3
2954,2007,September,Titus                                                ,Not Adjusted,13656,14208,552,3.9
2955,2007,December,Titus                                                ,Not Adjusted,13577,14129,552,3.9
2956,2007,March,Tom Green                                            ,Not Adjusted,49563,51404,1841,3.6
2957,2007,June,Tom Green                                            ,Not Adjusted,49908,52031,2123,4.1
2958,2007,September,Tom Green                                            ,Not Adjusted,49595,51562,1967,3.8
2959,2007,December,Tom Green                                            ,Not Adjusted,49909,51785,1876,3.6
2960,2007,March,Travis                                               ,Not Adjusted,507054,525347,18293,3.5
2961,2007,June,Travis                                               ,Not Adjusted,510020,530593,20573,3.9
2962,2007,September,Travis                                               ,Not Adjusted,512263,532582,20319,3.8
2963,2007,December,Travis                                               ,Not Adjusted,515573,535089,19516,3.6
2964,2007,March,Trinity                                              ,Not Adjusted,5561,5845,284,4.9
2965,2007,June,Trinity                                              ,Not Adjusted,5540,5853,313,5.3
2966,2007,September,Trinity                                              ,Not Adjusted,5596,5881,285,4.8
2967,2007,December,Trinity                                              ,Not Adjusted,5527,5807,280,4.8
2968,2007,March,Tyler                                                ,Not Adjusted,7636,8068,432,5.4
2969,2007,June,Tyler                                                ,Not Adjusted,7622,8063,441,5.5
2970,2007,September,Tyler                                                ,Not Adjusted,7577,8025,448,5.6
2971,2007,December,Tyler                                                ,Not Adjusted,7713,8234,521,6.3
2972,2007,March,Upshur                                               ,Not Adjusted,18378,19143,765,4.0
2973,2007,June,Upshur                                               ,Not Adjusted,18327,19136,809,4.2
2974,2007,September,Upshur                                               ,Not Adjusted,18502,19296,794,4.1
2975,2007,December,Upshur                                               ,Not Adjusted,18558,19332,774,4.0
2976,2007,March,Upton                                                ,Not Adjusted,1590,1637,47,2.9
2977,2007,June,Upton                                                ,Not Adjusted,1631,1687,56,3.3
2978,2007,September,Upton                                                ,Not Adjusted,1597,1653,56,3.4
2979,2007,December,Upton                                                ,Not Adjusted,1622,1675,53,3.2
2980,2007,March,Uvalde                                               ,Not Adjusted,10347,10946,599,5.5
2981,2007,June,Uvalde                                               ,Not Adjusted,10654,11276,622,5.5
2982,2007,September,Uvalde                                               ,Not Adjusted,10267,10851,584,5.4
2983,2007,December,Uvalde                                               ,Not Adjusted,10311,10859,548,5.0
2984,2007,March,Val Verde                                            ,Not Adjusted,19219,20295,1076,5.3
2985,2007,June,Val Verde                                            ,Not Adjusted,19220,20364,1144,5.6
2986,2007,September,Val Verde                                            ,Not Adjusted,19075,20093,1018,5.1
2987,2007,December,Val Verde                                            ,Not Adjusted,19141,20191,1050,5.2
2988,2007,March,Van Zandt                                            ,Not Adjusted,24285,25259,974,3.9
2989,2007,June,Van Zandt                                            ,Not Adjusted,24465,25516,1051,4.1
2990,2007,September,Van Zandt                                            ,Not Adjusted,24380,25387,1007,4.0
2991,2007,December,Van Zandt                                            ,Not Adjusted,24479,25480,1001,3.9
2992,2007,March,Victoria                                             ,Not Adjusted,42369,43824,1455,3.3
2993,2007,June,Victoria                                             ,Not Adjusted,42999,44676,1677,3.8
2994,2007,September,Victoria                                             ,Not Adjusted,43087,44722,1635,3.7
2995,2007,December,Victoria                                             ,Not Adjusted,43174,44704,1530,3.4
2996,2007,March,Walker                                               ,Not Adjusted,24782,25977,1195,4.6
2997,2007,June,Walker                                               ,Not Adjusted,24331,25778,1447,5.6
2998,2007,September,Walker                                               ,Not Adjusted,24698,25987,1289,5.0
2999,2007,December,Walker                                               ,Not Adjusted,24418,25619,1201,4.7
3000,2007,March,Waller                                               ,Not Adjusted,15195,15911,716,4.5
3001,2007,June,Waller                                               ,Not Adjusted,15305,16150,845,5.2
3002,2007,September,Waller                                               ,Not Adjusted,15364,16103,739,4.6
3003,2007,December,Waller                                               ,Not Adjusted,15499,16217,718,4.4
3004,2007,March,Ward                                                 ,Not Adjusted,4603,4773,170,3.6
3005,2007,June,Ward                                                 ,Not Adjusted,4718,4920,202,4.1
3006,2007,September,Ward                                                 ,Not Adjusted,4737,4929,192,3.9
3007,2007,December,Ward                                                 ,Not Adjusted,4739,4915,176,3.6
3008,2007,March,Washington                                           ,Not Adjusted,15525,16118,593,3.7
3009,2007,June,Washington                                           ,Not Adjusted,15653,16340,687,4.2
3010,2007,September,Washington                                           ,Not Adjusted,15424,16033,609,3.8
3011,2007,December,Washington                                           ,Not Adjusted,15503,16067,564,3.5
3012,2007,March,Webb                                                 ,Not Adjusted,84527,88696,4169,4.7
3013,2007,June,Webb                                                 ,Not Adjusted,84851,89659,4808,5.4
3014,2007,September,Webb                                                 ,Not Adjusted,85702,89861,4159,4.6
3015,2007,December,Webb                                                 ,Not Adjusted,86178,90406,4228,4.7
3016,2007,March,Wharton                                              ,Not Adjusted,19741,20595,854,4.1
3017,2007,June,Wharton                                              ,Not Adjusted,19796,20767,971,4.7
3018,2007,September,Wharton                                              ,Not Adjusted,19664,20536,872,4.2
3019,2007,December,Wharton                                              ,Not Adjusted,19975,20794,819,3.9
3020,2007,March,Wheeler                                              ,Not Adjusted,2982,3057,75,2.5
3021,2007,June,Wheeler                                              ,Not Adjusted,2953,3038,85,2.8
3022,2007,September,Wheeler                                              ,Not Adjusted,2950,3031,81,2.7
3023,2007,December,Wheeler                                              ,Not Adjusted,3056,3130,74,2.4
3024,2007,March,Wichita                                              ,Not Adjusted,59674,62234,2560,4.1
3025,2007,June,Wichita                                              ,Not Adjusted,59036,61920,2884,4.7
3026,2007,September,Wichita                                              ,Not Adjusted,59507,62241,2734,4.4
3027,2007,December,Wichita                                              ,Not Adjusted,58437,61046,2609,4.3
3028,2007,March,Wilbarger                                            ,Not Adjusted,7567,7817,250,3.2
3029,2007,June,Wilbarger                                            ,Not Adjusted,7434,7747,313,4.0
3030,2007,September,Wilbarger                                            ,Not Adjusted,7275,7548,273,3.6
3031,2007,December,Wilbarger                                            ,Not Adjusted,7234,7487,253,3.4
3032,2007,March,Willacy                                              ,Not Adjusted,7127,7744,617,8.0
3033,2007,June,Willacy                                              ,Not Adjusted,6898,7577,679,9.0
3034,2007,September,Willacy                                              ,Not Adjusted,6810,7365,555,7.5
3035,2007,December,Willacy                                              ,Not Adjusted,6987,7606,619,8.1
3036,2007,March,Williamson                                           ,Not Adjusted,184895,191790,6895,3.6
3037,2007,June,Williamson                                           ,Not Adjusted,185976,193555,7579,3.9
3038,2007,September,Williamson                                           ,Not Adjusted,186795,194529,7734,4.0
3039,2007,December,Williamson                                           ,Not Adjusted,188002,195530,7528,3.9
3040,2007,March,Wilson                                               ,Not Adjusted,17298,18039,741,4.1
3041,2007,June,Wilson                                               ,Not Adjusted,17431,18268,837,4.6
3042,2007,September,Wilson                                               ,Not Adjusted,17490,18232,742,4.1
3043,2007,December,Wilson                                               ,Not Adjusted,17574,18303,729,4.0
3044,2007,March,Winkler                                              ,Not Adjusted,3236,3339,103,3.1
3045,2007,June,Winkler                                              ,Not Adjusted,3259,3376,117,3.5
3046,2007,September,Winkler                                              ,Not Adjusted,3284,3393,109,3.2
3047,2007,December,Winkler                                              ,Not Adjusted,3252,3355,103,3.1
3048,2007,March,Wise                                                 ,Not Adjusted,26099,27290,1191,4.4
3049,2007,June,Wise                                                 ,Not Adjusted,26085,27395,1310,4.8
3050,2007,September,Wise                                                 ,Not Adjusted,26286,27451,1165,4.2
3051,2007,December,Wise                                                 ,Not Adjusted,26452,27570,1118,4.1
3052,2007,March,Wood                                                 ,Not Adjusted,17152,17916,764,4.3
3053,2007,June,Wood                                                 ,Not Adjusted,17283,18130,847,4.7
3054,2007,September,Wood                                                 ,Not Adjusted,17026,17890,864,4.8
3055,2007,December,Wood                                                 ,Not Adjusted,17061,17896,835,4.7
3056,2007,March,Yoakum                                               ,Not Adjusted,3748,3876,128,3.3
3057,2007,June,Yoakum                                               ,Not Adjusted,3837,3980,143,3.6
3058,2007,September,Yoakum                                               ,Not Adjusted,3765,3890,125,3.2
3059,2007,December,Yoakum                                               ,Not Adjusted,3782,3897,115,3.0
3060,2007,March,Young                                                ,Not Adjusted,9075,9379,304,3.2
3061,2007,June,Young                                                ,Not Adjusted,9420,9766,346,3.5
3062,2007,September,Young                                                ,Not Adjusted,9401,9720,319,3.3
3063,2007,December,Young                                                ,Not Adjusted,9245,9547,302,3.2
3064,2007,March,Zapata                                               ,Not Adjusted,4743,5011,268,5.3
3065,2007,June,Zapata                                               ,Not Adjusted,4729,5020,291,5.8
3066,2007,September,Zapata                                               ,Not Adjusted,4584,4858,274,5.6
3067,2007,December,Zapata                                               ,Not Adjusted,4697,4962,265,5.3
3068,2007,March,Zavala                                               ,Not Adjusted,3409,3836,427,11.1
3069,2007,June,Zavala                                               ,Not Adjusted,3474,3884,410,10.6
3070,2007,September,Zavala                                               ,Not Adjusted,3233,3589,356,9.9
3071,2007,December,Zavala                                               ,Not Adjusted,3348,3717,369,9.9
3072,2008,March,Texas,Not Adjusted,11047823,11546621,498798,4.3
3073,2008,March,Texas,Adjusted,11084171,11587968,503797,4.3
3074,2008,June,Texas,Not Adjusted,11124638,11707776,583138,5.0
3075,2008,June,Texas,Adjusted,11121171,11666163,544992,4.7
3076,2008,September,Texas,Not Adjusted,11135375,11743686,608311,5.2
3077,2008,September,Texas,Adjusted,11141801,11751993,610192,5.2
3078,2008,December,Texas,Not Adjusted,11137898,11786983,649085,5.5
3079,2008,December,Texas,Adjusted,11101977,11791925,689948,5.9
3080,2008,March,Anderson                                             ,Not Adjusted,18825,19835,1010,5.1
3081,2008,June,Anderson                                             ,Not Adjusted,19319,20487,1168,5.7
3082,2008,September,Anderson                                             ,Not Adjusted,19380,20627,1247,6.0
3083,2008,December,Anderson                                             ,Not Adjusted,18993,20214,1221,6.0
3084,2008,March,Andrews                                              ,Not Adjusted,6483,6694,211,3.2
3085,2008,June,Andrews                                              ,Not Adjusted,6649,6893,244,3.5
3086,2008,September,Andrews                                              ,Not Adjusted,6788,7033,245,3.5
3087,2008,December,Andrews                                              ,Not Adjusted,6811,7053,242,3.4
3088,2008,March,Angelina                                             ,Not Adjusted,36998,38746,1748,4.5
3089,2008,June,Angelina                                             ,Not Adjusted,37302,39240,1938,4.9
3090,2008,September,Angelina                                             ,Not Adjusted,37499,39407,1908,4.8
3091,2008,December,Angelina                                             ,Not Adjusted,37330,39449,2119,5.4
3092,2008,March,Aransas                                              ,Not Adjusted,10909,11351,442,3.9
3093,2008,June,Aransas                                              ,Not Adjusted,10915,11429,514,4.5
3094,2008,September,Aransas                                              ,Not Adjusted,10891,11434,543,4.7
3095,2008,December,Aransas                                              ,Not Adjusted,10878,11455,577,5.0
3096,2008,March,Archer                                               ,Not Adjusted,4972,5127,155,3.0
3097,2008,June,Archer                                               ,Not Adjusted,4956,5144,188,3.7
3098,2008,September,Archer                                               ,Not Adjusted,4927,5136,209,4.1
3099,2008,December,Archer                                               ,Not Adjusted,4893,5124,231,4.5
3100,2008,March,Armstrong                                            ,Not Adjusted,1043,1078,35,3.2
3101,2008,June,Armstrong                                            ,Not Adjusted,1047,1086,39,3.6
3102,2008,September,Armstrong                                            ,Not Adjusted,1053,1091,38,3.5
3103,2008,December,Armstrong                                            ,Not Adjusted,1054,1095,41,3.7
3104,2008,March,Atascosa                                             ,Not Adjusted,17912,18645,733,3.9
3105,2008,June,Atascosa                                             ,Not Adjusted,18141,19118,977,5.1
3106,2008,September,Atascosa                                             ,Not Adjusted,18088,19056,968,5.1
3107,2008,December,Atascosa                                             ,Not Adjusted,18037,18991,954,5.0
3108,2008,March,Austin                                               ,Not Adjusted,12376,12857,481,3.7
3109,2008,June,Austin                                               ,Not Adjusted,12495,13084,589,4.5
3110,2008,September,Austin                                               ,Not Adjusted,12449,13049,600,4.6
3111,2008,December,Austin                                               ,Not Adjusted,12566,13175,609,4.6
3112,2008,March,Bailey                                               ,Not Adjusted,3187,3318,131,3.9
3113,2008,June,Bailey                                               ,Not Adjusted,3195,3349,154,4.6
3114,2008,September,Bailey                                               ,Not Adjusted,3303,3437,134,3.9
3115,2008,December,Bailey                                               ,Not Adjusted,3232,3382,150,4.4
3116,2008,March,Bandera                                              ,Not Adjusted,9183,9547,364,3.8
3117,2008,June,Bandera                                              ,Not Adjusted,9301,9767,466,4.8
3118,2008,September,Bandera                                              ,Not Adjusted,9275,9747,472,4.8
3119,2008,December,Bandera                                              ,Not Adjusted,9248,9728,480,4.9
3120,2008,March,Bastrop                                              ,Not Adjusted,31928,33340,1412,4.2
3121,2008,June,Bastrop                                              ,Not Adjusted,32020,33761,1741,5.2
3122,2008,September,Bastrop                                              ,Not Adjusted,32094,33927,1833,5.4
3123,2008,December,Bastrop                                              ,Not Adjusted,32039,34002,1963,5.8
3124,2008,March,Baylor                                               ,Not Adjusted,1960,2033,73,3.6
3125,2008,June,Baylor                                               ,Not Adjusted,2038,2120,82,3.9
3126,2008,September,Baylor                                               ,Not Adjusted,1962,2048,86,4.2
3127,2008,December,Baylor                                               ,Not Adjusted,1932,2005,73,3.6
3128,2008,March,Bee                                                  ,Not Adjusted,10496,11114,618,5.6
3129,2008,June,Bee                                                  ,Not Adjusted,10554,11283,729,6.5
3130,2008,September,Bee                                                  ,Not Adjusted,10694,11453,759,6.6
3131,2008,December,Bee                                                  ,Not Adjusted,10641,11414,773,6.8
3132,2008,March,Bell                                                 ,Not Adjusted,115599,120968,5369,4.4
3133,2008,June,Bell                                                 ,Not Adjusted,116561,122864,6303,5.1
3134,2008,September,Bell                                                 ,Not Adjusted,116810,123199,6389,5.2
3135,2008,December,Bell                                                 ,Not Adjusted,116792,123476,6684,5.4
3136,2008,March,Bexar                                                ,Not Adjusted,709521,739762,30241,4.1
3137,2008,June,Bexar                                                ,Not Adjusted,718621,755266,36645,4.9
3138,2008,September,Bexar                                                ,Not Adjusted,716559,754672,38113,5.1
3139,2008,December,Bexar                                                ,Not Adjusted,714503,754499,39996,5.3
3140,2008,March,Blanco                                               ,Not Adjusted,4615,4779,164,3.4
3141,2008,June,Blanco                                               ,Not Adjusted,4746,4931,185,3.8
3142,2008,September,Blanco                                               ,Not Adjusted,4812,5003,191,3.8
3143,2008,December,Blanco                                               ,Not Adjusted,4778,4967,189,3.8
3144,2008,March,Borden                                               ,Not Adjusted,368,381,13,3.4
3145,2008,June,Borden                                               ,Not Adjusted,381,397,16,4.0
3146,2008,September,Borden                                               ,Not Adjusted,410,424,14,3.3
3147,2008,December,Borden                                               ,Not Adjusted,422,436,14,3.2
3148,2008,March,Bosque                                               ,Not Adjusted,7782,8104,322,4.0
3149,2008,June,Bosque                                               ,Not Adjusted,7952,8346,394,4.7
3150,2008,September,Bosque                                               ,Not Adjusted,8004,8421,417,5.0
3151,2008,December,Bosque                                               ,Not Adjusted,7914,8346,432,5.2
3152,2008,March,Bowie                                                ,Not Adjusted,41020,42904,1884,4.4
3153,2008,June,Bowie                                                ,Not Adjusted,41775,43971,2196,5.0
3154,2008,September,Bowie                                                ,Not Adjusted,41744,44116,2372,5.4
3155,2008,December,Bowie                                                ,Not Adjusted,41330,43683,2353,5.4
3156,2008,March,Brazoria                                             ,Not Adjusted,134098,140342,6244,4.4
3157,2008,June,Brazoria                                             ,Not Adjusted,135393,143051,7658,5.4
3158,2008,September,Brazoria                                             ,Not Adjusted,134886,142695,7809,5.5
3159,2008,December,Brazoria                                             ,Not Adjusted,136163,144471,8308,5.8
3160,2008,March,Brazos                                               ,Not Adjusted,88070,91179,3109,3.4
3161,2008,June,Brazos                                               ,Not Adjusted,84836,88977,4141,4.7
3162,2008,September,Brazos                                               ,Not Adjusted,90428,94380,3952,4.2
3163,2008,December,Brazos                                               ,Not Adjusted,91292,94875,3583,3.8
3164,2008,March,Brewster                                             ,Not Adjusted,4915,5072,157,3.1
3165,2008,June,Brewster                                             ,Not Adjusted,4729,4932,203,4.1
3166,2008,September,Brewster                                             ,Not Adjusted,4963,5171,208,4.0
3167,2008,December,Brewster                                             ,Not Adjusted,5033,5230,197,3.8
3168,2008,March,Briscoe                                              ,Not Adjusted,658,688,30,4.4
3169,2008,June,Briscoe                                              ,Not Adjusted,680,713,33,4.6
3170,2008,September,Briscoe                                              ,Not Adjusted,720,751,31,4.1
3171,2008,December,Briscoe                                              ,Not Adjusted,705,735,30,4.1
3172,2008,March,Brooks                                               ,Not Adjusted,3049,3203,154,4.8
3173,2008,June,Brooks                                               ,Not Adjusted,3071,3270,199,6.1
3174,2008,September,Brooks                                               ,Not Adjusted,3209,3382,173,5.1
3175,2008,December,Brooks                                               ,Not Adjusted,3169,3339,170,5.1
3176,2008,March,Brown                                                ,Not Adjusted,17381,18083,702,3.9
3177,2008,June,Brown                                                ,Not Adjusted,17596,18468,872,4.7
3178,2008,September,Brown                                                ,Not Adjusted,17744,18624,880,4.7
3179,2008,December,Brown                                                ,Not Adjusted,17917,18853,936,5.0
3180,2008,March,Burleson                                             ,Not Adjusted,7531,7825,294,3.8
3181,2008,June,Burleson                                             ,Not Adjusted,7254,7611,357,4.7
3182,2008,September,Burleson                                             ,Not Adjusted,7733,8113,380,4.7
3183,2008,December,Burleson                                             ,Not Adjusted,7807,8245,438,5.3
3184,2008,March,Burnet                                               ,Not Adjusted,21121,21849,728,3.3
3185,2008,June,Burnet                                               ,Not Adjusted,21769,22641,872,3.9
3186,2008,September,Burnet                                               ,Not Adjusted,21306,22254,948,4.3
3187,2008,December,Burnet                                               ,Not Adjusted,20937,21959,1022,4.7
3188,2008,March,Caldwell                                             ,Not Adjusted,14524,15250,726,4.8
3189,2008,June,Caldwell                                             ,Not Adjusted,14567,15424,857,5.6
3190,2008,September,Caldwell                                             ,Not Adjusted,14600,15460,860,5.6
3191,2008,December,Caldwell                                             ,Not Adjusted,14575,15519,944,6.1
3192,2008,March,Calhoun                                              ,Not Adjusted,8923,9304,381,4.1
3193,2008,June,Calhoun                                              ,Not Adjusted,9000,9458,458,4.8
3194,2008,September,Calhoun                                              ,Not Adjusted,8931,9428,497,5.3
3195,2008,December,Calhoun                                              ,Not Adjusted,8910,9484,574,6.1
3196,2008,March,Callahan                                             ,Not Adjusted,6798,7017,219,3.1
3197,2008,June,Callahan                                             ,Not Adjusted,6875,7149,274,3.8
3198,2008,September,Callahan                                             ,Not Adjusted,6893,7172,279,3.9
3199,2008,December,Callahan                                             ,Not Adjusted,6852,7140,288,4.0
3200,2008,March,Cameron                                              ,Not Adjusted,136811,145309,8498,5.8
3201,2008,June,Cameron                                              ,Not Adjusted,135886,145953,10067,6.9
3202,2008,September,Cameron                                              ,Not Adjusted,134741,145323,10582,7.3
3203,2008,December,Cameron                                              ,Not Adjusted,135812,147306,11494,7.8
3204,2008,March,Camp                                                 ,Not Adjusted,5265,5507,242,4.4
3205,2008,June,Camp                                                 ,Not Adjusted,5396,5677,281,4.9
3206,2008,September,Camp                                                 ,Not Adjusted,5387,5661,274,4.8
3207,2008,December,Camp                                                 ,Not Adjusted,5254,5598,344,6.1
3208,2008,March,Carson                                               ,Not Adjusted,3142,3243,101,3.1
3209,2008,June,Carson                                               ,Not Adjusted,3156,3278,122,3.7
3210,2008,September,Carson                                               ,Not Adjusted,3178,3301,123,3.7
3211,2008,December,Carson                                               ,Not Adjusted,3180,3288,108,3.3
3212,2008,March,Cass                                                 ,Not Adjusted,12077,12810,733,5.7
3213,2008,June,Cass                                                 ,Not Adjusted,12137,12952,815,6.3
3214,2008,September,Cass                                                 ,Not Adjusted,12224,13068,844,6.5
3215,2008,December,Cass                                                 ,Not Adjusted,12073,12976,903,7.0
3216,2008,March,Castro                                               ,Not Adjusted,3367,3478,111,3.2
3217,2008,June,Castro                                               ,Not Adjusted,3513,3654,141,3.9
3218,2008,September,Castro                                               ,Not Adjusted,3670,3808,138,3.6
3219,2008,December,Castro                                               ,Not Adjusted,3608,3737,129,3.5
3220,2008,March,Chambers                                             ,Not Adjusted,13363,14054,691,4.9
3221,2008,June,Chambers                                             ,Not Adjusted,13493,14367,874,6.1
3222,2008,September,Chambers                                             ,Not Adjusted,13441,14276,835,5.8
3223,2008,December,Chambers                                             ,Not Adjusted,13569,14501,932,6.4
3224,2008,March,Cherokee                                             ,Not Adjusted,18987,19936,949,4.8
3225,2008,June,Cherokee                                             ,Not Adjusted,19248,20470,1222,6.0
3226,2008,September,Cherokee                                             ,Not Adjusted,19403,20732,1329,6.4
3227,2008,December,Cherokee                                             ,Not Adjusted,19359,20834,1475,7.1
3228,2008,March,Childress                                            ,Not Adjusted,2804,2954,150,5.1
3229,2008,June,Childress                                            ,Not Adjusted,2883,3041,158,5.2
3230,2008,September,Childress                                            ,Not Adjusted,3010,3175,165,5.2
3231,2008,December,Childress                                            ,Not Adjusted,2997,3157,160,5.1
3232,2008,March,Clay                                                 ,Not Adjusted,5839,6048,209,3.5
3233,2008,June,Clay                                                 ,Not Adjusted,5821,6047,226,3.7
3234,2008,September,Clay                                                 ,Not Adjusted,5786,6073,287,4.7
3235,2008,December,Clay                                                 ,Not Adjusted,5746,6032,286,4.7
3236,2008,March,Cochran                                              ,Not Adjusted,1404,1477,73,4.9
3237,2008,June,Cochran                                              ,Not Adjusted,1462,1545,83,5.4
3238,2008,September,Cochran                                              ,Not Adjusted,1493,1564,71,4.5
3239,2008,December,Cochran                                              ,Not Adjusted,1442,1507,65,4.3
3240,2008,March,Coke                                                 ,Not Adjusted,1180,1281,101,7.9
3241,2008,June,Coke                                                 ,Not Adjusted,1152,1253,101,8.1
3242,2008,September,Coke                                                 ,Not Adjusted,1226,1325,99,7.5
3243,2008,December,Coke                                                 ,Not Adjusted,1257,1353,96,7.1
3244,2008,March,Coleman                                              ,Not Adjusted,4168,4324,156,3.6
3245,2008,June,Coleman                                              ,Not Adjusted,4197,4384,187,4.3
3246,2008,September,Coleman                                              ,Not Adjusted,4295,4486,191,4.3
3247,2008,December,Coleman                                              ,Not Adjusted,4198,4404,206,4.7
3248,2008,March,Collin                                               ,Not Adjusted,387432,403766,16334,4.0
3249,2008,June,Collin                                               ,Not Adjusted,388629,407149,18520,4.5
3250,2008,September,Collin                                               ,Not Adjusted,387077,406504,19427,4.8
3251,2008,December,Collin                                               ,Not Adjusted,385062,406776,21714,5.3
3252,2008,March,Collingsworth                                        ,Not Adjusted,1398,1451,53,3.7
3253,2008,June,Collingsworth                                        ,Not Adjusted,1429,1491,62,4.2
3254,2008,September,Collingsworth                                        ,Not Adjusted,1487,1548,61,3.9
3255,2008,December,Collingsworth                                        ,Not Adjusted,1396,1456,60,4.1
3256,2008,March,Colorado                                             ,Not Adjusted,10349,10723,374,3.5
3257,2008,June,Colorado                                             ,Not Adjusted,10638,11102,464,4.2
3258,2008,September,Colorado                                             ,Not Adjusted,10608,11050,442,4.0
3259,2008,December,Colorado                                             ,Not Adjusted,10594,11095,501,4.5
3260,2008,March,Comal                                                ,Not Adjusted,52154,54094,1940,3.6
3261,2008,June,Comal                                                ,Not Adjusted,52822,55092,2270,4.1
3262,2008,September,Comal                                                ,Not Adjusted,52671,55085,2414,4.4
3263,2008,December,Comal                                                ,Not Adjusted,52520,55075,2555,4.6
3264,2008,March,Comanche                                             ,Not Adjusted,6092,6309,217,3.4
3265,2008,June,Comanche                                             ,Not Adjusted,6387,6650,263,4.0
3266,2008,September,Comanche                                             ,Not Adjusted,6637,6903,266,3.9
3267,2008,December,Comanche                                             ,Not Adjusted,6402,6671,269,4.0
3268,2008,March,Concho                                               ,Not Adjusted,1238,1301,63,4.8
3269,2008,June,Concho                                               ,Not Adjusted,1249,1318,69,5.2
3270,2008,September,Concho                                               ,Not Adjusted,1318,1391,73,5.2
3271,2008,December,Concho                                               ,Not Adjusted,1309,1383,74,5.4
3272,2008,March,Cooke                                                ,Not Adjusted,21388,22104,716,3.2
3273,2008,June,Cooke                                                ,Not Adjusted,21931,22750,819,3.6
3274,2008,September,Cooke                                                ,Not Adjusted,22152,22964,812,3.5
3275,2008,December,Cooke                                                ,Not Adjusted,21473,22311,838,3.8
3276,2008,March,Coryell                                              ,Not Adjusted,21844,23154,1310,5.7
3277,2008,June,Coryell                                              ,Not Adjusted,22026,23577,1551,6.6
3278,2008,September,Coryell                                              ,Not Adjusted,22072,23662,1590,6.7
3279,2008,December,Coryell                                              ,Not Adjusted,22069,23610,1541,6.5
3280,2008,March,Cottle                                               ,Not Adjusted,791,828,37,4.5
3281,2008,June,Cottle                                               ,Not Adjusted,813,847,34,4.0
3282,2008,September,Cottle                                               ,Not Adjusted,834,864,30,3.5
3283,2008,December,Cottle                                               ,Not Adjusted,787,821,34,4.1
3284,2008,March,Crane                                                ,Not Adjusted,1578,1635,57,3.5
3285,2008,June,Crane                                                ,Not Adjusted,1620,1699,79,4.6
3286,2008,September,Crane                                                ,Not Adjusted,1698,1773,75,4.2
3287,2008,December,Crane                                                ,Not Adjusted,1673,1756,83,4.7
3288,2008,March,Crockett                                             ,Not Adjusted,2078,2135,57,2.7
3289,2008,June,Crockett                                             ,Not Adjusted,2151,2218,67,3.0
3290,2008,September,Crockett                                             ,Not Adjusted,2184,2256,72,3.2
3291,2008,December,Crockett                                             ,Not Adjusted,2233,2298,65,2.8
3292,2008,March,Crosby                                               ,Not Adjusted,2463,2595,132,5.1
3293,2008,June,Crosby                                               ,Not Adjusted,2439,2580,141,5.5
3294,2008,September,Crosby                                               ,Not Adjusted,2496,2617,121,4.6
3295,2008,December,Crosby                                               ,Not Adjusted,2492,2617,125,4.8
3296,2008,March,Culberson                                            ,Not Adjusted,1713,1757,44,2.5
3297,2008,June,Culberson                                            ,Not Adjusted,1709,1767,58,3.3
3298,2008,September,Culberson                                            ,Not Adjusted,1748,1805,57,3.2
3299,2008,December,Culberson                                            ,Not Adjusted,1707,1761,54,3.1
3300,2008,March,Dallam                                               ,Not Adjusted,3325,3418,93,2.7
3301,2008,June,Dallam                                               ,Not Adjusted,3518,3633,115,3.2
3302,2008,September,Dallam                                               ,Not Adjusted,3632,3753,121,3.2
3303,2008,December,Dallam                                               ,Not Adjusted,3602,3715,113,3.0
3304,2008,March,Dallas                                               ,Not Adjusted,1079657,1133342,53685,4.7
3305,2008,June,Dallas                                               ,Not Adjusted,1082989,1144089,61100,5.3
3306,2008,September,Dallas                                               ,Not Adjusted,1078665,1145179,66514,5.8
3307,2008,December,Dallas                                               ,Not Adjusted,1073050,1145160,72110,6.3
3308,2008,March,Dawson                                               ,Not Adjusted,4789,5020,231,4.6
3309,2008,June,Dawson                                               ,Not Adjusted,4804,5110,306,6.0
3310,2008,September,Dawson                                               ,Not Adjusted,4980,5286,306,5.8
3311,2008,December,Dawson                                               ,Not Adjusted,5004,5278,274,5.2
3312,2008,March,Deaf Smith                                           ,Not Adjusted,8555,8863,308,3.5
3313,2008,June,Deaf Smith                                           ,Not Adjusted,8602,8970,368,4.1
3314,2008,September,Deaf Smith                                           ,Not Adjusted,8754,9125,371,4.1
3315,2008,December,Deaf Smith                                           ,Not Adjusted,8821,9169,348,3.8
3316,2008,March,Delta                                                ,Not Adjusted,2172,2272,100,4.4
3317,2008,June,Delta                                                ,Not Adjusted,2181,2296,115,5.0
3318,2008,September,Delta                                                ,Not Adjusted,2172,2317,145,6.3
3319,2008,December,Delta                                                ,Not Adjusted,2160,2300,140,6.1
3320,2008,March,Denton                                               ,Not Adjusted,329197,342611,13414,3.9
3321,2008,June,Denton                                               ,Not Adjusted,330213,346077,15864,4.6
3322,2008,September,Denton                                               ,Not Adjusted,328893,345196,16303,4.7
3323,2008,December,Denton                                               ,Not Adjusted,327181,344790,17609,5.1
3324,2008,March,DeWitt                                               ,Not Adjusted,8672,8990,318,3.5
3325,2008,June,DeWitt                                               ,Not Adjusted,8783,9184,401,4.4
3326,2008,September,DeWitt                                               ,Not Adjusted,8679,9097,418,4.6
3327,2008,December,DeWitt                                               ,Not Adjusted,8596,9008,412,4.6
3328,2008,March,Dickens                                              ,Not Adjusted,941,985,44,4.5
3329,2008,June,Dickens                                              ,Not Adjusted,970,1021,51,5.0
3330,2008,September,Dickens                                              ,Not Adjusted,978,1023,45,4.4
3331,2008,December,Dickens                                              ,Not Adjusted,941,1011,70,6.9
3332,2008,March,Dimmit                                               ,Not Adjusted,3679,3910,231,5.9
3333,2008,June,Dimmit                                               ,Not Adjusted,3684,3971,287,7.2
3334,2008,September,Dimmit                                               ,Not Adjusted,3832,4113,281,6.8
3335,2008,December,Dimmit                                               ,Not Adjusted,3847,4143,296,7.1
3336,2008,March,Donley                                               ,Not Adjusted,1756,1832,76,4.1
3337,2008,June,Donley                                               ,Not Adjusted,1848,1945,97,5.0
3338,2008,September,Donley                                               ,Not Adjusted,1826,1911,85,4.4
3339,2008,December,Donley                                               ,Not Adjusted,1862,1933,71,3.7
3340,2008,March,Duval                                                ,Not Adjusted,4788,5035,247,4.9
3341,2008,June,Duval                                                ,Not Adjusted,4904,5214,310,5.9
3342,2008,September,Duval                                                ,Not Adjusted,4972,5260,288,5.5
3343,2008,December,Duval                                                ,Not Adjusted,5017,5333,316,5.9
3344,2008,March,Eastland                                             ,Not Adjusted,8056,8392,336,4.0
3345,2008,June,Eastland                                             ,Not Adjusted,8005,8421,416,4.9
3346,2008,September,Eastland                                             ,Not Adjusted,8352,8760,408,4.7
3347,2008,December,Eastland                                             ,Not Adjusted,8212,8636,424,4.9
3348,2008,March,Ector                                                ,Not Adjusted,66922,69017,2095,3.0
3349,2008,June,Ector                                                ,Not Adjusted,67757,70386,2629,3.7
3350,2008,September,Ector                                                ,Not Adjusted,69705,72322,2617,3.6
3351,2008,December,Ector                                                ,Not Adjusted,69779,72463,2684,3.7
3352,2008,March,Edwards                                              ,Not Adjusted,957,993,36,3.6
3353,2008,June,Edwards                                              ,Not Adjusted,1039,1083,44,4.1
3354,2008,September,Edwards                                              ,Not Adjusted,1072,1112,40,3.6
3355,2008,December,Edwards                                              ,Not Adjusted,1031,1076,45,4.2
3356,2008,March,Ellis                                                ,Not Adjusted,66689,69861,3172,4.5
3357,2008,June,Ellis                                                ,Not Adjusted,66896,70579,3683,5.2
3358,2008,September,Ellis                                                ,Not Adjusted,66628,70342,3714,5.3
3359,2008,December,Ellis                                                ,Not Adjusted,66282,70372,4090,5.8
3360,2008,March,El Paso                                              ,Not Adjusted,280463,297336,16873,5.7
3361,2008,June,El Paso                                              ,Not Adjusted,277377,296387,19010,6.4
3362,2008,September,El Paso                                              ,Not Adjusted,279684,299294,19610,6.6
3363,2008,December,El Paso                                              ,Not Adjusted,281166,301891,20725,6.9
3364,2008,March,Erath                                                ,Not Adjusted,17848,18457,609,3.3
3365,2008,June,Erath                                                ,Not Adjusted,17785,18580,795,4.3
3366,2008,September,Erath                                                ,Not Adjusted,18311,19074,763,4.0
3367,2008,December,Erath                                                ,Not Adjusted,18414,19122,708,3.7
3368,2008,March,Falls                                                ,Not Adjusted,6215,6566,351,5.3
3369,2008,June,Falls                                                ,Not Adjusted,6165,6562,397,6.0
3370,2008,September,Falls                                                ,Not Adjusted,6294,6696,402,6.0
3371,2008,December,Falls                                                ,Not Adjusted,6091,6523,432,6.6
3372,2008,March,Fannin                                               ,Not Adjusted,12770,13447,677,5.0
3373,2008,June,Fannin                                               ,Not Adjusted,12709,13497,788,5.8
3374,2008,September,Fannin                                               ,Not Adjusted,12699,13557,858,6.3
3375,2008,December,Fannin                                               ,Not Adjusted,12434,13358,924,6.9
3376,2008,March,Fayette                                              ,Not Adjusted,11789,12181,392,3.2
3377,2008,June,Fayette                                              ,Not Adjusted,12106,12557,451,3.6
3378,2008,September,Fayette                                              ,Not Adjusted,12000,12462,462,3.7
3379,2008,December,Fayette                                              ,Not Adjusted,11769,12234,465,3.8
3380,2008,March,Fisher                                               ,Not Adjusted,1860,1936,76,3.9
3381,2008,June,Fisher                                               ,Not Adjusted,1939,2011,72,3.6
3382,2008,September,Fisher                                               ,Not Adjusted,1989,2072,83,4.0
3383,2008,December,Fisher                                               ,Not Adjusted,1933,2007,74,3.7
3384,2008,March,Floyd                                                ,Not Adjusted,3035,3185,150,4.7
3385,2008,June,Floyd                                                ,Not Adjusted,3144,3302,158,4.8
3386,2008,September,Floyd                                                ,Not Adjusted,3129,3287,158,4.8
3387,2008,December,Floyd                                                ,Not Adjusted,3122,3286,164,5.0
3388,2008,March,Foard                                                ,Not Adjusted,675,699,24,3.4
3389,2008,June,Foard                                                ,Not Adjusted,706,735,29,3.9
3390,2008,September,Foard                                                ,Not Adjusted,703,734,31,4.2
3391,2008,December,Foard                                                ,Not Adjusted,687,724,37,5.1
3392,2008,March,Fort Bend                                            ,Not Adjusted,251886,262289,10403,4.0
3393,2008,June,Fort Bend                                            ,Not Adjusted,254321,266435,12114,4.5
3394,2008,September,Fort Bend                                            ,Not Adjusted,253366,266108,12742,4.8
3395,2008,December,Fort Bend                                            ,Not Adjusted,255766,268858,13092,4.9
3396,2008,March,Franklin                                             ,Not Adjusted,5068,5267,199,3.8
3397,2008,June,Franklin                                             ,Not Adjusted,5129,5355,226,4.2
3398,2008,September,Franklin                                             ,Not Adjusted,5098,5336,238,4.5
3399,2008,December,Franklin                                             ,Not Adjusted,5131,5386,255,4.7
3400,2008,March,Freestone                                            ,Not Adjusted,9572,9931,359,3.6
3401,2008,June,Freestone                                            ,Not Adjusted,9853,10266,413,4.0
3402,2008,September,Freestone                                            ,Not Adjusted,9983,10437,454,4.3
3403,2008,December,Freestone                                            ,Not Adjusted,9953,10396,443,4.3
3404,2008,March,Frio                                                 ,Not Adjusted,6380,6701,321,4.8
3405,2008,June,Frio                                                 ,Not Adjusted,6478,6875,397,5.8
3406,2008,September,Frio                                                 ,Not Adjusted,6700,7089,389,5.5
3407,2008,December,Frio                                                 ,Not Adjusted,6696,7107,411,5.8
3408,2008,March,Gaines                                               ,Not Adjusted,6363,6599,236,3.6
3409,2008,June,Gaines                                               ,Not Adjusted,6726,7015,289,4.1
3410,2008,September,Gaines                                               ,Not Adjusted,6790,7073,283,4.0
3411,2008,December,Gaines                                               ,Not Adjusted,6679,6941,262,3.8
3412,2008,March,Galveston                                            ,Not Adjusted,132882,139298,6416,4.6
3413,2008,June,Galveston                                            ,Not Adjusted,134166,141892,7726,5.4
3414,2008,September,Galveston                                            ,Not Adjusted,133662,141712,8050,5.7
3415,2008,December,Galveston                                            ,Not Adjusted,134927,145462,10535,7.2
3416,2008,March,Garza                                                ,Not Adjusted,2260,2350,90,3.8
3417,2008,June,Garza                                                ,Not Adjusted,2316,2418,102,4.2
3418,2008,September,Garza                                                ,Not Adjusted,2379,2477,98,4.0
3419,2008,December,Garza                                                ,Not Adjusted,2307,2395,88,3.7
3420,2008,March,Gillespie                                            ,Not Adjusted,12638,12981,343,2.6
3421,2008,June,Gillespie                                            ,Not Adjusted,12842,13246,404,3.0
3422,2008,September,Gillespie                                            ,Not Adjusted,12927,13369,442,3.3
3423,2008,December,Gillespie                                            ,Not Adjusted,13012,13468,456,3.4
3424,2008,March,Glasscock                                            ,Not Adjusted,586,610,24,3.9
3425,2008,June,Glasscock                                            ,Not Adjusted,606,635,29,4.6
3426,2008,September,Glasscock                                            ,Not Adjusted,663,691,28,4.1
3427,2008,December,Glasscock                                            ,Not Adjusted,640,663,23,3.5
3428,2008,March,Goliad                                               ,Not Adjusted,3333,3439,106,3.1
3429,2008,June,Goliad                                               ,Not Adjusted,3361,3500,139,4.0
3430,2008,September,Goliad                                               ,Not Adjusted,3337,3472,135,3.9
3431,2008,December,Goliad                                               ,Not Adjusted,3328,3483,155,4.5
3432,2008,March,Gonzales                                             ,Not Adjusted,9226,9574,348,3.6
3433,2008,June,Gonzales                                             ,Not Adjusted,9493,9890,397,4.0
3434,2008,September,Gonzales                                             ,Not Adjusted,9569,9981,412,4.1
3435,2008,December,Gonzales                                             ,Not Adjusted,9521,9945,424,4.3
3436,2008,March,Gray                                                 ,Not Adjusted,10720,11072,352,3.2
3437,2008,June,Gray                                                 ,Not Adjusted,11044,11468,424,3.7
3438,2008,September,Gray                                                 ,Not Adjusted,11257,11683,426,3.6
3439,2008,December,Gray                                                 ,Not Adjusted,11007,11431,424,3.7
3440,2008,March,Grayson                                              ,Not Adjusted,52421,55057,2636,4.8
3441,2008,June,Grayson                                              ,Not Adjusted,52906,55817,2911,5.2
3442,2008,September,Grayson                                              ,Not Adjusted,53072,56032,2960,5.3
3443,2008,December,Grayson                                              ,Not Adjusted,52826,56146,3320,5.9
3444,2008,March,Gregg                                                ,Not Adjusted,61126,63361,2235,3.5
3445,2008,June,Gregg                                                ,Not Adjusted,61695,64303,2608,4.1
3446,2008,September,Gregg                                                ,Not Adjusted,61631,64339,2708,4.2
3447,2008,December,Gregg                                                ,Not Adjusted,61633,64340,2707,4.2
3448,2008,March,Grimes                                               ,Not Adjusted,10091,10577,486,4.6
3449,2008,June,Grimes                                               ,Not Adjusted,10210,10784,574,5.3
3450,2008,September,Grimes                                               ,Not Adjusted,10507,11122,615,5.5
3451,2008,December,Grimes                                               ,Not Adjusted,10495,11113,618,5.6
3452,2008,March,Guadalupe                                            ,Not Adjusted,54939,57104,2165,3.8
3453,2008,June,Guadalupe                                            ,Not Adjusted,55644,58229,2585,4.4
3454,2008,September,Guadalupe                                            ,Not Adjusted,55484,58147,2663,4.6
3455,2008,December,Guadalupe                                            ,Not Adjusted,55325,58140,2815,4.8
3456,2008,March,Hale                                                 ,Not Adjusted,15784,16463,679,4.1
3457,2008,June,Hale                                                 ,Not Adjusted,15988,16866,878,5.2
3458,2008,September,Hale                                                 ,Not Adjusted,16437,17225,788,4.6
3459,2008,December,Hale                                                 ,Not Adjusted,16265,16991,726,4.3
3460,2008,March,Hall                                                 ,Not Adjusted,1312,1386,74,5.3
3461,2008,June,Hall                                                 ,Not Adjusted,1377,1456,79,5.4
3462,2008,September,Hall                                                 ,Not Adjusted,1444,1525,81,5.3
3463,2008,December,Hall                                                 ,Not Adjusted,1410,1501,91,6.1
3464,2008,March,Hamilton                                             ,Not Adjusted,4073,4223,150,3.6
3465,2008,June,Hamilton                                             ,Not Adjusted,4186,4349,163,3.7
3466,2008,September,Hamilton                                             ,Not Adjusted,4219,4377,158,3.6
3467,2008,December,Hamilton                                             ,Not Adjusted,4240,4394,154,3.5
3468,2008,March,Hansford                                             ,Not Adjusted,2486,2567,81,3.2
3469,2008,June,Hansford                                             ,Not Adjusted,2587,2680,93,3.5
3470,2008,September,Hansford                                             ,Not Adjusted,2706,2797,91,3.3
3471,2008,December,Hansford                                             ,Not Adjusted,2676,2762,86,3.1
3472,2008,March,Hardeman                                             ,Not Adjusted,2252,2318,66,2.8
3473,2008,June,Hardeman                                             ,Not Adjusted,2297,2373,76,3.2
3474,2008,September,Hardeman                                             ,Not Adjusted,2348,2436,88,3.6
3475,2008,December,Hardeman                                             ,Not Adjusted,2095,2217,122,5.5
3476,2008,March,Hardin                                               ,Not Adjusted,24672,25900,1228,4.7
3477,2008,June,Hardin                                               ,Not Adjusted,24784,26217,1433,5.5
3478,2008,September,Hardin                                               ,Not Adjusted,24547,26067,1520,5.8
3479,2008,December,Hardin                                               ,Not Adjusted,25055,26495,1440,5.4
3480,2008,March,Harris                                               ,Not Adjusted,1828833,1909146,80313,4.2
3481,2008,June,Harris                                               ,Not Adjusted,1846495,1940786,94291,4.9
3482,2008,September,Harris                                               ,Not Adjusted,1839576,1938618,99042,5.1
3483,2008,December,Harris                                               ,Not Adjusted,1856992,1961031,104039,5.3
3484,2008,March,Harrison                                             ,Not Adjusted,30773,32118,1345,4.2
3485,2008,June,Harrison                                             ,Not Adjusted,30929,32479,1550,4.8
3486,2008,September,Harrison                                             ,Not Adjusted,30946,32502,1556,4.8
3487,2008,December,Harrison                                             ,Not Adjusted,30719,32418,1699,5.2
3488,2008,March,Hartley                                              ,Not Adjusted,2280,2350,70,3.0
3489,2008,June,Hartley                                              ,Not Adjusted,2414,2499,85,3.4
3490,2008,September,Hartley                                              ,Not Adjusted,2493,2579,86,3.3
3491,2008,December,Hartley                                              ,Not Adjusted,2470,2560,90,3.5
3492,2008,March,Haskell                                              ,Not Adjusted,3046,3146,100,3.2
3493,2008,June,Haskell                                              ,Not Adjusted,3159,3267,108,3.3
3494,2008,September,Haskell                                              ,Not Adjusted,3329,3438,109,3.2
3495,2008,December,Haskell                                              ,Not Adjusted,3268,3381,113,3.3
3496,2008,March,Hays                                                 ,Not Adjusted,73106,75904,2798,3.7
3497,2008,June,Hays                                                 ,Not Adjusted,73322,76834,3512,4.6
3498,2008,September,Hays                                                 ,Not Adjusted,73490,77095,3605,4.7
3499,2008,December,Hays                                                 ,Not Adjusted,73365,77059,3694,4.8
3500,2008,March,Hemphill                                             ,Not Adjusted,2925,2978,53,1.8
3501,2008,June,Hemphill                                             ,Not Adjusted,2915,2981,66,2.2
3502,2008,September,Hemphill                                             ,Not Adjusted,3278,3343,65,1.9
3503,2008,December,Hemphill                                             ,Not Adjusted,3272,3333,61,1.8
3504,2008,March,Henderson                                            ,Not Adjusted,32730,34352,1622,4.7
3505,2008,June,Henderson                                            ,Not Adjusted,33067,34892,1825,5.2
3506,2008,September,Henderson                                            ,Not Adjusted,33069,35019,1950,5.6
3507,2008,December,Henderson                                            ,Not Adjusted,32401,34542,2141,6.2
3508,2008,March,Hidalgo                                              ,Not Adjusted,261769,279808,18039,6.4
3509,2008,June,Hidalgo                                              ,Not Adjusted,260936,281617,20681,7.3
3510,2008,September,Hidalgo                                              ,Not Adjusted,261581,283541,21960,7.7
3511,2008,December,Hidalgo                                              ,Not Adjusted,266339,291274,24935,8.6
3512,2008,March,Hill                                                 ,Not Adjusted,15086,15773,687,4.4
3513,2008,June,Hill                                                 ,Not Adjusted,15069,15881,812,5.1
3514,2008,September,Hill                                                 ,Not Adjusted,15299,16181,882,5.5
3515,2008,December,Hill                                                 ,Not Adjusted,15314,16225,911,5.6
3516,2008,March,Hockley                                              ,Not Adjusted,11273,11683,410,3.5
3517,2008,June,Hockley                                              ,Not Adjusted,11396,11885,489,4.1
3518,2008,September,Hockley                                              ,Not Adjusted,11800,12255,455,3.7
3519,2008,December,Hockley                                              ,Not Adjusted,11674,12125,451,3.7
3520,2008,March,Hood                                                 ,Not Adjusted,23878,24783,905,3.7
3521,2008,June,Hood                                                 ,Not Adjusted,24313,25391,1078,4.2
3522,2008,September,Hood                                                 ,Not Adjusted,24910,26074,1164,4.5
3523,2008,December,Hood                                                 ,Not Adjusted,24400,25623,1223,4.8
3524,2008,March,Hopkins                                              ,Not Adjusted,16632,17303,671,3.9
3525,2008,June,Hopkins                                              ,Not Adjusted,16724,17455,731,4.2
3526,2008,September,Hopkins                                              ,Not Adjusted,17300,18050,750,4.2
3527,2008,December,Hopkins                                              ,Not Adjusted,17068,17846,778,4.4
3528,2008,March,Houston                                              ,Not Adjusted,7343,7810,467,6.0
3529,2008,June,Houston                                              ,Not Adjusted,7512,8048,536,6.7
3530,2008,September,Houston                                              ,Not Adjusted,7562,8109,547,6.7
3531,2008,December,Houston                                              ,Not Adjusted,7629,8197,568,6.9
3532,2008,March,Howard                                               ,Not Adjusted,13277,13832,555,4.0
3533,2008,June,Howard                                               ,Not Adjusted,13572,14241,669,4.7
3534,2008,September,Howard                                               ,Not Adjusted,13375,14100,725,5.1
3535,2008,December,Howard                                               ,Not Adjusted,13366,14077,711,5.1
3536,2008,March,Hudspeth                                             ,Not Adjusted,1466,1523,57,3.7
3537,2008,June,Hudspeth                                             ,Not Adjusted,1534,1603,69,4.3
3538,2008,September,Hudspeth                                             ,Not Adjusted,1594,1663,69,4.1
3539,2008,December,Hudspeth                                             ,Not Adjusted,1606,1663,57,3.4
3540,2008,March,Hunt                                                 ,Not Adjusted,34961,36773,1812,4.9
3541,2008,June,Hunt                                                 ,Not Adjusted,35067,37075,2008,5.4
3542,2008,September,Hunt                                                 ,Not Adjusted,34927,37016,2089,5.6
3543,2008,December,Hunt                                                 ,Not Adjusted,34746,36989,2243,6.1
3544,2008,March,Hutchinson                                           ,Not Adjusted,10568,10978,410,3.7
3545,2008,June,Hutchinson                                           ,Not Adjusted,10885,11375,490,4.3
3546,2008,September,Hutchinson                                           ,Not Adjusted,10797,11290,493,4.4
3547,2008,December,Hutchinson                                           ,Not Adjusted,10785,11258,473,4.2
3548,2008,March,Irion                                                ,Not Adjusted,861,886,25,2.8
3549,2008,June,Irion                                                ,Not Adjusted,854,885,31,3.5
3550,2008,September,Irion                                                ,Not Adjusted,858,893,35,3.9
3551,2008,December,Irion                                                ,Not Adjusted,852,887,35,3.9
3552,2008,March,Jack                                                 ,Not Adjusted,5278,5431,153,2.8
3553,2008,June,Jack                                                 ,Not Adjusted,5179,5362,183,3.4
3554,2008,September,Jack                                                 ,Not Adjusted,5347,5530,183,3.3
3555,2008,December,Jack                                                 ,Not Adjusted,5293,5477,184,3.4
3556,2008,March,Jackson                                              ,Not Adjusted,6389,6636,247,3.7
3557,2008,June,Jackson                                              ,Not Adjusted,6638,6929,291,4.2
3558,2008,September,Jackson                                              ,Not Adjusted,6674,6963,289,4.2
3559,2008,December,Jackson                                              ,Not Adjusted,6649,6971,322,4.6
3560,2008,March,Jasper                                               ,Not Adjusted,14634,15520,886,5.7
3561,2008,June,Jasper                                               ,Not Adjusted,14591,15566,975,6.3
3562,2008,September,Jasper                                               ,Not Adjusted,14452,15516,1064,6.9
3563,2008,December,Jasper                                               ,Not Adjusted,14521,15627,1106,7.1
3564,2008,March,Jeff Davis                                           ,Not Adjusted,1144,1185,41,3.5
3565,2008,June,Jeff Davis                                           ,Not Adjusted,1181,1228,47,3.8
3566,2008,September,Jeff Davis                                           ,Not Adjusted,1176,1223,47,3.8
3567,2008,December,Jeff Davis                                           ,Not Adjusted,1131,1176,45,3.8
3568,2008,March,Jefferson                                            ,Not Adjusted,105951,112239,6288,5.6
3569,2008,June,Jefferson                                            ,Not Adjusted,106433,113889,7456,6.5
3570,2008,September,Jefferson                                            ,Not Adjusted,105414,113675,8261,7.3
3571,2008,December,Jefferson                                            ,Not Adjusted,107594,116560,8966,7.7
3572,2008,March,Jim Hogg                                             ,Not Adjusted,2581,2668,87,3.3
3573,2008,June,Jim Hogg                                             ,Not Adjusted,2620,2733,113,4.1
3574,2008,September,Jim Hogg                                             ,Not Adjusted,2714,2830,116,4.1
3575,2008,December,Jim Hogg                                             ,Not Adjusted,2738,2858,120,4.2
3576,2008,March,Jim Wells                                            ,Not Adjusted,20484,21295,811,3.8
3577,2008,June,Jim Wells                                            ,Not Adjusted,20605,21606,1001,4.6
3578,2008,September,Jim Wells                                            ,Not Adjusted,20360,21340,980,4.6
3579,2008,December,Jim Wells                                            ,Not Adjusted,20744,21693,949,4.4
3580,2008,March,Johnson                                              ,Not Adjusted,69534,72498,2964,4.1
3581,2008,June,Johnson                                              ,Not Adjusted,70056,73589,3533,4.8
3582,2008,September,Johnson                                              ,Not Adjusted,69968,73539,3571,4.9
3583,2008,December,Johnson                                              ,Not Adjusted,69649,73455,3806,5.2
3584,2008,March,Jones                                                ,Not Adjusted,7331,7683,352,4.6
3585,2008,June,Jones                                                ,Not Adjusted,7416,7813,397,5.1
3586,2008,September,Jones                                                ,Not Adjusted,7435,7849,414,5.3
3587,2008,December,Jones                                                ,Not Adjusted,7390,7814,424,5.4
3588,2008,March,Karnes                                               ,Not Adjusted,4969,5240,271,5.2
3589,2008,June,Karnes                                               ,Not Adjusted,5005,5340,335,6.3
3590,2008,September,Karnes                                               ,Not Adjusted,4965,5301,336,6.3
3591,2008,December,Karnes                                               ,Not Adjusted,4992,5311,319,6.0
3592,2008,March,Kaufman                                              ,Not Adjusted,43873,45965,2092,4.6
3593,2008,June,Kaufman                                              ,Not Adjusted,44010,46461,2451,5.3
3594,2008,September,Kaufman                                              ,Not Adjusted,43834,46490,2656,5.7
3595,2008,December,Kaufman                                              ,Not Adjusted,43604,46516,2912,6.3
3596,2008,March,Kendall                                              ,Not Adjusted,15431,15951,520,3.3
3597,2008,June,Kendall                                              ,Not Adjusted,15630,16267,637,3.9
3598,2008,September,Kendall                                              ,Not Adjusted,15584,16274,690,4.2
3599,2008,December,Kendall                                              ,Not Adjusted,15538,16206,668,4.1
3600,2008,March,Kenedy                                               ,Not Adjusted,226,234,8,3.4
3601,2008,June,Kenedy                                               ,Not Adjusted,225,234,9,3.8
3602,2008,September,Kenedy                                               ,Not Adjusted,241,248,7,2.8
3603,2008,December,Kenedy                                               ,Not Adjusted,232,240,8,3.3
3604,2008,March,Kent                                                 ,Not Adjusted,407,424,17,4.0
3605,2008,June,Kent                                                 ,Not Adjusted,423,445,22,4.9
3606,2008,September,Kent                                                 ,Not Adjusted,456,475,19,4.0
3607,2008,December,Kent                                                 ,Not Adjusted,442,459,17,3.7
3608,2008,March,Kerr                                                 ,Not Adjusted,22117,22889,772,3.4
3609,2008,June,Kerr                                                 ,Not Adjusted,22463,23382,919,3.9
3610,2008,September,Kerr                                                 ,Not Adjusted,22120,23121,1001,4.3
3611,2008,December,Kerr                                                 ,Not Adjusted,21759,22860,1101,4.8
3612,2008,March,Kimble                                               ,Not Adjusted,2074,2143,69,3.2
3613,2008,June,Kimble                                               ,Not Adjusted,2176,2259,83,3.7
3614,2008,September,Kimble                                               ,Not Adjusted,2143,2232,89,4.0
3615,2008,December,Kimble                                               ,Not Adjusted,2133,2226,93,4.2
3616,2008,March,King                                                 ,Not Adjusted,166,173,7,4.0
3617,2008,June,King                                                 ,Not Adjusted,179,187,8,4.3
3618,2008,September,King                                                 ,Not Adjusted,188,197,9,4.6
3619,2008,December,King                                                 ,Not Adjusted,174,182,8,4.4
3620,2008,March,Kinney                                               ,Not Adjusted,1266,1346,80,5.9
3621,2008,June,Kinney                                               ,Not Adjusted,1295,1361,66,4.8
3622,2008,September,Kinney                                               ,Not Adjusted,1350,1415,65,4.6
3623,2008,December,Kinney                                               ,Not Adjusted,1313,1390,77,5.5
3624,2008,March,Kleberg                                              ,Not Adjusted,15552,16188,636,3.9
3625,2008,June,Kleberg                                              ,Not Adjusted,15429,16178,749,4.6
3626,2008,September,Kleberg                                              ,Not Adjusted,16538,17257,719,4.2
3627,2008,December,Kleberg                                              ,Not Adjusted,15925,16676,751,4.5
3628,2008,March,Knox                                                 ,Not Adjusted,1673,1742,69,4.0
3629,2008,June,Knox                                                 ,Not Adjusted,1759,1834,75,4.1
3630,2008,September,Knox                                                 ,Not Adjusted,1846,1915,69,3.6
3631,2008,December,Knox                                                 ,Not Adjusted,1796,1867,71,3.8
3632,2008,March,Lamar                                                ,Not Adjusted,22447,23577,1130,4.8
3633,2008,June,Lamar                                                ,Not Adjusted,22500,23786,1286,5.4
3634,2008,September,Lamar                                                ,Not Adjusted,22145,23504,1359,5.8
3635,2008,December,Lamar                                                ,Not Adjusted,21650,23094,1444,6.3
3636,2008,March,Lamb                                                 ,Not Adjusted,6641,6981,340,4.9
3637,2008,June,Lamb                                                 ,Not Adjusted,6906,7245,339,4.7
3638,2008,September,Lamb                                                 ,Not Adjusted,7052,7382,330,4.5
3639,2008,December,Lamb                                                 ,Not Adjusted,6856,7178,322,4.5
3640,2008,March,Lampasas                                             ,Not Adjusted,9801,10163,362,3.6
3641,2008,June,Lampasas                                             ,Not Adjusted,9881,10327,446,4.3
3642,2008,September,Lampasas                                             ,Not Adjusted,9903,10372,469,4.5
3643,2008,December,Lampasas                                             ,Not Adjusted,9902,10335,433,4.2
3644,2008,March,La Salle                                             ,Not Adjusted,2803,2935,132,4.5
3645,2008,June,La Salle                                             ,Not Adjusted,2774,2938,164,5.6
3646,2008,September,La Salle                                             ,Not Adjusted,2806,2966,160,5.4
3647,2008,December,La Salle                                             ,Not Adjusted,2692,2879,187,6.5
3648,2008,March,Lavaca                                               ,Not Adjusted,9524,9826,302,3.1
3649,2008,June,Lavaca                                               ,Not Adjusted,9671,10015,344,3.4
3650,2008,September,Lavaca                                               ,Not Adjusted,9640,10008,368,3.7
3651,2008,December,Lavaca                                               ,Not Adjusted,9552,9938,386,3.9
3652,2008,March,Lee                                                  ,Not Adjusted,8499,8810,311,3.5
3653,2008,June,Lee                                                  ,Not Adjusted,8788,9174,386,4.2
3654,2008,September,Lee                                                  ,Not Adjusted,8811,9189,378,4.1
3655,2008,December,Lee                                                  ,Not Adjusted,8729,9140,411,4.5
3656,2008,March,Leon                                                 ,Not Adjusted,7164,7465,301,4.0
3657,2008,June,Leon                                                 ,Not Adjusted,7437,7796,359,4.6
3658,2008,September,Leon                                                 ,Not Adjusted,7657,8009,352,4.4
3659,2008,December,Leon                                                 ,Not Adjusted,7919,8283,364,4.4
3660,2008,March,Liberty                                              ,Not Adjusted,28812,30402,1590,5.2
3661,2008,June,Liberty                                              ,Not Adjusted,29090,30948,1858,6.0
3662,2008,September,Liberty                                              ,Not Adjusted,28981,30944,1963,6.3
3663,2008,December,Liberty                                              ,Not Adjusted,29255,31468,2213,7.0
3664,2008,March,Limestone                                            ,Not Adjusted,10028,10451,423,4.0
3665,2008,June,Limestone                                            ,Not Adjusted,10327,10824,497,4.6
3666,2008,September,Limestone                                            ,Not Adjusted,10488,10979,491,4.5
3667,2008,December,Limestone                                            ,Not Adjusted,10396,10906,510,4.7
3668,2008,March,Lipscomb                                             ,Not Adjusted,1728,1772,44,2.5
3669,2008,June,Lipscomb                                             ,Not Adjusted,1878,1934,56,2.9
3670,2008,September,Lipscomb                                             ,Not Adjusted,1828,1880,52,2.8
3671,2008,December,Lipscomb                                             ,Not Adjusted,1649,1712,63,3.7
3672,2008,March,Live Oak                                             ,Not Adjusted,4915,5104,189,3.7
3673,2008,June,Live Oak                                             ,Not Adjusted,4904,5133,229,4.5
3674,2008,September,Live Oak                                             ,Not Adjusted,4886,5122,236,4.6
3675,2008,December,Live Oak                                             ,Not Adjusted,4863,5101,238,4.7
3676,2008,March,Llano                                                ,Not Adjusted,7807,8126,319,3.9
3677,2008,June,Llano                                                ,Not Adjusted,8383,8743,360,4.1
3678,2008,September,Llano                                                ,Not Adjusted,8165,8549,384,4.5
3679,2008,December,Llano                                                ,Not Adjusted,8007,8448,441,5.2
3680,2008,March,Loving                                               ,Not Adjusted,38,41,3,7.3
3681,2008,June,Loving                                               ,Not Adjusted,41,44,3,6.8
3682,2008,September,Loving                                               ,Not Adjusted,42,45,3,6.7
3683,2008,December,Loving                                               ,Not Adjusted,44,47,3,6.4
3684,2008,March,Lubbock                                              ,Not Adjusted,132795,137325,4530,3.3
3685,2008,June,Lubbock                                              ,Not Adjusted,131493,137412,5919,4.3
3686,2008,September,Lubbock                                              ,Not Adjusted,134539,140038,5499,3.9
3687,2008,December,Lubbock                                              ,Not Adjusted,134370,139515,5145,3.7
3688,2008,March,Lynn                                                 ,Not Adjusted,2609,2722,113,4.2
3689,2008,June,Lynn                                                 ,Not Adjusted,2657,2803,146,5.2
3690,2008,September,Lynn                                                 ,Not Adjusted,2804,2938,134,4.6
3691,2008,December,Lynn                                                 ,Not Adjusted,2700,2825,125,4.4
3692,2008,March,McCulloch                                            ,Not Adjusted,3698,3842,144,3.7
3693,2008,June,McCulloch                                            ,Not Adjusted,3826,3997,171,4.3
3694,2008,September,McCulloch                                            ,Not Adjusted,3971,4143,172,4.2
3695,2008,December,McCulloch                                            ,Not Adjusted,3927,4089,162,4.0
3696,2008,March,McLennan                                             ,Not Adjusted,104630,109079,4449,4.1
3697,2008,June,McLennan                                             ,Not Adjusted,106590,112065,5475,4.9
3698,2008,September,McLennan                                             ,Not Adjusted,106779,112159,5380,4.8
3699,2008,December,McLennan                                             ,Not Adjusted,106367,111738,5371,4.8
3700,2008,March,McMullen                                             ,Not Adjusted,309,325,16,4.9
3701,2008,June,McMullen                                             ,Not Adjusted,319,338,19,5.6
3702,2008,September,McMullen                                             ,Not Adjusted,336,354,18,5.1
3703,2008,December,McMullen                                             ,Not Adjusted,339,362,23,6.4
3704,2008,March,Madison                                              ,Not Adjusted,4629,4853,224,4.6
3705,2008,June,Madison                                              ,Not Adjusted,4781,5047,266,5.3
3706,2008,September,Madison                                              ,Not Adjusted,4878,5152,274,5.3
3707,2008,December,Madison                                              ,Not Adjusted,4807,5076,269,5.3
3708,2008,March,Marion                                               ,Not Adjusted,4720,4943,223,4.5
3709,2008,June,Marion                                               ,Not Adjusted,4774,5017,243,4.8
3710,2008,September,Marion                                               ,Not Adjusted,4751,5007,256,5.1
3711,2008,December,Marion                                               ,Not Adjusted,4778,5114,336,6.6
3712,2008,March,Martin                                               ,Not Adjusted,2114,2184,70,3.2
3713,2008,June,Martin                                               ,Not Adjusted,2180,2273,93,4.1
3714,2008,September,Martin                                               ,Not Adjusted,2245,2331,86,3.7
3715,2008,December,Martin                                               ,Not Adjusted,2212,2290,78,3.4
3716,2008,March,Mason                                                ,Not Adjusted,2184,2244,60,2.7
3717,2008,June,Mason                                                ,Not Adjusted,2336,2409,73,3.0
3718,2008,September,Mason                                                ,Not Adjusted,2346,2427,81,3.3
3719,2008,December,Mason                                                ,Not Adjusted,2367,2442,75,3.1
3720,2008,March,Matagorda                                            ,Not Adjusted,15757,16739,982,5.9
3721,2008,June,Matagorda                                            ,Not Adjusted,16084,17310,1226,7.1
3722,2008,September,Matagorda                                            ,Not Adjusted,16214,17408,1194,6.9
3723,2008,December,Matagorda                                            ,Not Adjusted,15872,17226,1354,7.9
3724,2008,March,Maverick                                             ,Not Adjusted,18197,20791,2594,12.5
3725,2008,June,Maverick                                             ,Not Adjusted,18637,20706,2069,10.0
3726,2008,September,Maverick                                             ,Not Adjusted,19039,20809,1770,8.5
3727,2008,December,Maverick                                             ,Not Adjusted,19305,21833,2528,11.6
3728,2008,March,Medina                                               ,Not Adjusted,18612,19444,832,4.3
3729,2008,June,Medina                                               ,Not Adjusted,18851,19858,1007,5.1
3730,2008,September,Medina                                               ,Not Adjusted,18798,19912,1114,5.6
3731,2008,December,Medina                                               ,Not Adjusted,18744,19807,1063,5.4
3732,2008,March,Menard                                               ,Not Adjusted,990,1039,49,4.7
3733,2008,June,Menard                                               ,Not Adjusted,1063,1113,50,4.5
3734,2008,September,Menard                                               ,Not Adjusted,1130,1175,45,3.8
3735,2008,December,Menard                                               ,Not Adjusted,1082,1128,46,4.1
3736,2008,March,Midland                                              ,Not Adjusted,71887,73811,1924,2.6
3737,2008,June,Midland                                              ,Not Adjusted,73336,75710,2374,3.1
3738,2008,September,Midland                                              ,Not Adjusted,74327,76700,2373,3.1
3739,2008,December,Midland                                              ,Not Adjusted,73901,76112,2211,2.9
3740,2008,March,Milam                                                ,Not Adjusted,11386,11906,520,4.4
3741,2008,June,Milam                                                ,Not Adjusted,11581,12196,615,5.0
3742,2008,September,Milam                                                ,Not Adjusted,11458,12149,691,5.7
3743,2008,December,Milam                                                ,Not Adjusted,10777,11888,1111,9.3
3744,2008,March,Mills                                                ,Not Adjusted,2175,2251,76,3.4
3745,2008,June,Mills                                                ,Not Adjusted,2253,2350,97,4.1
3746,2008,September,Mills                                                ,Not Adjusted,2345,2447,102,4.2
3747,2008,December,Mills                                                ,Not Adjusted,2306,2401,95,4.0
3748,2008,March,Mitchell                                             ,Not Adjusted,3165,3319,154,4.6
3749,2008,June,Mitchell                                             ,Not Adjusted,3152,3355,203,6.1
3750,2008,September,Mitchell                                             ,Not Adjusted,3200,3395,195,5.7
3751,2008,December,Mitchell                                             ,Not Adjusted,3083,3260,177,5.4
3752,2008,March,Montague                                             ,Not Adjusted,10121,10461,340,3.3
3753,2008,June,Montague                                             ,Not Adjusted,10317,10707,390,3.6
3754,2008,September,Montague                                             ,Not Adjusted,10479,10883,404,3.7
3755,2008,December,Montague                                             ,Not Adjusted,10378,10790,412,3.8
3756,2008,March,Montgomery                                           ,Not Adjusted,201884,209894,8010,3.8
3757,2008,June,Montgomery                                           ,Not Adjusted,203834,213165,9331,4.4
3758,2008,September,Montgomery                                           ,Not Adjusted,203070,212789,9719,4.6
3759,2008,December,Montgomery                                           ,Not Adjusted,204993,215047,10054,4.7
3760,2008,March,Moore                                                ,Not Adjusted,10608,10930,322,2.9
3761,2008,June,Moore                                                ,Not Adjusted,10933,11313,380,3.4
3762,2008,September,Moore                                                ,Not Adjusted,11247,11631,384,3.3
3763,2008,December,Moore                                                ,Not Adjusted,11036,11392,356,3.1
3764,2008,March,Morris                                               ,Not Adjusted,5611,5940,329,5.5
3765,2008,June,Morris                                               ,Not Adjusted,5682,6049,367,6.1
3766,2008,September,Morris                                               ,Not Adjusted,5765,6155,390,6.3
3767,2008,December,Morris                                               ,Not Adjusted,5874,6297,423,6.7
3768,2008,March,Motley                                               ,Not Adjusted,626,653,27,4.1
3769,2008,June,Motley                                               ,Not Adjusted,712,745,33,4.4
3770,2008,September,Motley                                               ,Not Adjusted,696,726,30,4.1
3771,2008,December,Motley                                               ,Not Adjusted,664,692,28,4.0
3772,2008,March,Nacogdoches                                          ,Not Adjusted,29575,30769,1194,3.9
3773,2008,June,Nacogdoches                                          ,Not Adjusted,29122,30630,1508,4.9
3774,2008,September,Nacogdoches                                          ,Not Adjusted,30001,31438,1437,4.6
3775,2008,December,Nacogdoches                                          ,Not Adjusted,29863,31220,1357,4.3
3776,2008,March,Navarro                                              ,Not Adjusted,19342,20462,1120,5.5
3777,2008,June,Navarro                                              ,Not Adjusted,19625,20837,1212,5.8
3778,2008,September,Navarro                                              ,Not Adjusted,20145,21351,1206,5.6
3779,2008,December,Navarro                                              ,Not Adjusted,19878,21109,1231,5.8
3780,2008,March,Newton                                               ,Not Adjusted,5333,5725,392,6.8
3781,2008,June,Newton                                               ,Not Adjusted,5372,5794,422,7.3
3782,2008,September,Newton                                               ,Not Adjusted,5292,5764,472,8.2
3783,2008,December,Newton                                               ,Not Adjusted,5313,5765,452,7.8
3784,2008,March,Nolan                                                ,Not Adjusted,7316,7586,270,3.6
3785,2008,June,Nolan                                                ,Not Adjusted,7367,7684,317,4.1
3786,2008,September,Nolan                                                ,Not Adjusted,7602,7925,323,4.1
3787,2008,December,Nolan                                                ,Not Adjusted,7467,7798,331,4.2
3788,2008,March,Nueces                                               ,Not Adjusted,155423,161897,6474,4.0
3789,2008,June,Nueces                                               ,Not Adjusted,155512,163183,7671,4.7
3790,2008,September,Nueces                                               ,Not Adjusted,155176,163174,7998,4.9
3791,2008,December,Nueces                                               ,Not Adjusted,154982,163123,8141,5.0
3792,2008,March,Ochiltree                                            ,Not Adjusted,5270,5412,142,2.6
3793,2008,June,Ochiltree                                            ,Not Adjusted,5530,5698,168,2.9
3794,2008,September,Ochiltree                                            ,Not Adjusted,5750,5919,169,2.9
3795,2008,December,Ochiltree                                            ,Not Adjusted,5654,5811,157,2.7
3796,2008,March,Oldham                                               ,Not Adjusted,857,891,34,3.8
3797,2008,June,Oldham                                               ,Not Adjusted,888,935,47,5.0
3798,2008,September,Oldham                                               ,Not Adjusted,895,942,47,5.0
3799,2008,December,Oldham                                               ,Not Adjusted,871,916,45,4.9
3800,2008,March,Orange                                               ,Not Adjusted,38452,40606,2154,5.3
3801,2008,June,Orange                                               ,Not Adjusted,38626,41273,2647,6.4
3802,2008,September,Orange                                               ,Not Adjusted,38257,41016,2759,6.7
3803,2008,December,Orange                                               ,Not Adjusted,39048,42319,3271,7.7
3804,2008,March,Palo Pinto                                           ,Not Adjusted,13291,13788,497,3.6
3805,2008,June,Palo Pinto                                           ,Not Adjusted,13537,14127,590,4.2
3806,2008,September,Palo Pinto                                           ,Not Adjusted,13508,14127,619,4.4
3807,2008,December,Palo Pinto                                           ,Not Adjusted,13508,14224,716,5.0
3808,2008,March,Panola                                               ,Not Adjusted,12344,12793,449,3.5
3809,2008,June,Panola                                               ,Not Adjusted,12579,13095,516,3.9
3810,2008,September,Panola                                               ,Not Adjusted,12741,13264,523,3.9
3811,2008,December,Panola                                               ,Not Adjusted,12538,13133,595,4.5
3812,2008,March,Parker                                               ,Not Adjusted,50700,52784,2084,3.9
3813,2008,June,Parker                                               ,Not Adjusted,51083,53503,2420,4.5
3814,2008,September,Parker                                               ,Not Adjusted,51018,53538,2520,4.7
3815,2008,December,Parker                                               ,Not Adjusted,50785,53451,2666,5.0
3816,2008,March,Parmer                                               ,Not Adjusted,4209,4347,138,3.2
3817,2008,June,Parmer                                               ,Not Adjusted,4326,4491,165,3.7
3818,2008,September,Parmer                                               ,Not Adjusted,4539,4713,174,3.7
3819,2008,December,Parmer                                               ,Not Adjusted,4462,4619,157,3.4
3820,2008,March,Pecos                                                ,Not Adjusted,6387,6652,265,4.0
3821,2008,June,Pecos                                                ,Not Adjusted,6696,7048,352,5.0
3822,2008,September,Pecos                                                ,Not Adjusted,6931,7277,346,4.8
3823,2008,December,Pecos                                                ,Not Adjusted,7329,7675,346,4.5
3824,2008,March,Polk                                                 ,Not Adjusted,15466,16383,917,5.6
3825,2008,June,Polk                                                 ,Not Adjusted,15858,16916,1058,6.3
3826,2008,September,Polk                                                 ,Not Adjusted,15701,16786,1085,6.5
3827,2008,December,Polk                                                 ,Not Adjusted,16048,17205,1157,6.7
3828,2008,March,Potter                                               ,Not Adjusted,53769,55789,2020,3.6
3829,2008,June,Potter                                               ,Not Adjusted,54010,56428,2418,4.3
3830,2008,September,Potter                                               ,Not Adjusted,54366,56833,2467,4.3
3831,2008,December,Potter                                               ,Not Adjusted,54423,56852,2429,4.3
3832,2008,March,Presidio                                             ,Not Adjusted,2934,3240,306,9.4
3833,2008,June,Presidio                                             ,Not Adjusted,2991,3377,386,11.4
3834,2008,September,Presidio                                             ,Not Adjusted,3087,3488,401,11.5
3835,2008,December,Presidio                                             ,Not Adjusted,3006,3424,418,12.2
3836,2008,March,Rains                                                ,Not Adjusted,4790,5018,228,4.5
3837,2008,June,Rains                                                ,Not Adjusted,4832,5095,263,5.2
3838,2008,September,Rains                                                ,Not Adjusted,4868,5143,275,5.3
3839,2008,December,Rains                                                ,Not Adjusted,4699,5005,306,6.1
3840,2008,March,Randall                                              ,Not Adjusted,64890,66774,1884,2.8
3841,2008,June,Randall                                              ,Not Adjusted,65180,67447,2267,3.4
3842,2008,September,Randall                                              ,Not Adjusted,65611,67929,2318,3.4
3843,2008,December,Randall                                              ,Not Adjusted,65680,67866,2186,3.2
3844,2008,March,Reagan                                               ,Not Adjusted,2434,2483,49,2.0
3845,2008,June,Reagan                                               ,Not Adjusted,2628,2686,58,2.2
3846,2008,September,Reagan                                               ,Not Adjusted,2502,2557,55,2.2
3847,2008,December,Reagan                                               ,Not Adjusted,2289,2344,55,2.3
3848,2008,March,Real                                                 ,Not Adjusted,1331,1383,52,3.8
3849,2008,June,Real                                                 ,Not Adjusted,1483,1545,62,4.0
3850,2008,September,Real                                                 ,Not Adjusted,1440,1497,57,3.8
3851,2008,December,Real                                                 ,Not Adjusted,1412,1467,55,3.7
3852,2008,March,Red River                                            ,Not Adjusted,5570,5970,400,6.7
3853,2008,June,Red River                                            ,Not Adjusted,5573,5962,389,6.5
3854,2008,September,Red River                                            ,Not Adjusted,5676,6058,382,6.3
3855,2008,December,Red River                                            ,Not Adjusted,5476,5897,421,7.1
3856,2008,March,Reeves                                               ,Not Adjusted,3863,4062,199,4.9
3857,2008,June,Reeves                                               ,Not Adjusted,3908,4193,285,6.8
3858,2008,September,Reeves                                               ,Not Adjusted,4078,4341,263,6.1
3859,2008,December,Reeves                                               ,Not Adjusted,4020,4295,275,6.4
3860,2008,March,Refugio                                              ,Not Adjusted,3821,3960,139,3.5
3861,2008,June,Refugio                                              ,Not Adjusted,3911,4078,167,4.1
3862,2008,September,Refugio                                              ,Not Adjusted,3929,4102,173,4.2
3863,2008,December,Refugio                                              ,Not Adjusted,3972,4137,165,4.0
3864,2008,March,Roberts                                              ,Not Adjusted,542,556,14,2.5
3865,2008,June,Roberts                                              ,Not Adjusted,557,572,15,2.6
3866,2008,September,Roberts                                              ,Not Adjusted,568,583,15,2.6
3867,2008,December,Roberts                                              ,Not Adjusted,556,570,14,2.5
3868,2008,March,Robertson                                            ,Not Adjusted,6588,6870,282,4.1
3869,2008,June,Robertson                                            ,Not Adjusted,6347,6700,353,5.3
3870,2008,September,Robertson                                            ,Not Adjusted,6765,7132,367,5.1
3871,2008,December,Robertson                                            ,Not Adjusted,6830,7259,429,5.9
3872,2008,March,Rockwall                                             ,Not Adjusted,36419,37872,1453,3.8
3873,2008,June,Rockwall                                             ,Not Adjusted,36531,38284,1753,4.6
3874,2008,September,Rockwall                                             ,Not Adjusted,36386,38345,1959,5.1
3875,2008,December,Rockwall                                             ,Not Adjusted,36196,38190,1994,5.2
3876,2008,March,Runnels                                              ,Not Adjusted,4214,4409,195,4.4
3877,2008,June,Runnels                                              ,Not Adjusted,4254,4482,228,5.1
3878,2008,September,Runnels                                              ,Not Adjusted,4328,4589,261,5.7
3879,2008,December,Runnels                                              ,Not Adjusted,4288,4497,209,4.6
3880,2008,March,Rusk                                                 ,Not Adjusted,22925,23861,936,3.9
3881,2008,June,Rusk                                                 ,Not Adjusted,23140,24272,1132,4.7
3882,2008,September,Rusk                                                 ,Not Adjusted,23114,24209,1095,4.5
3883,2008,December,Rusk                                                 ,Not Adjusted,23115,24172,1057,4.4
3884,2008,March,Sabine                                               ,Not Adjusted,3019,3294,275,8.3
3885,2008,June,Sabine                                               ,Not Adjusted,3082,3378,296,8.8
3886,2008,September,Sabine                                               ,Not Adjusted,3219,3534,315,8.9
3887,2008,December,Sabine                                               ,Not Adjusted,3116,3511,395,11.3
3888,2008,March,San Augustine                                        ,Not Adjusted,3278,3483,205,5.9
3889,2008,June,San Augustine                                        ,Not Adjusted,3351,3575,224,6.3
3890,2008,September,San Augustine                                        ,Not Adjusted,3325,3533,208,5.9
3891,2008,December,San Augustine                                        ,Not Adjusted,3245,3500,255,7.3
3892,2008,March,San Jacinto                                          ,Not Adjusted,9424,9922,498,5.0
3893,2008,June,San Jacinto                                          ,Not Adjusted,9515,10140,625,6.2
3894,2008,September,San Jacinto                                          ,Not Adjusted,9480,10130,650,6.4
3895,2008,December,San Jacinto                                          ,Not Adjusted,9569,10173,604,5.9
3896,2008,March,San Patricio                                         ,Not Adjusted,28344,29755,1411,4.7
3897,2008,June,San Patricio                                         ,Not Adjusted,28360,30110,1750,5.8
3898,2008,September,San Patricio                                         ,Not Adjusted,28299,29976,1677,5.6
3899,2008,December,San Patricio                                         ,Not Adjusted,28264,30022,1758,5.9
3900,2008,March,San Saba                                             ,Not Adjusted,2274,2388,114,4.8
3901,2008,June,San Saba                                             ,Not Adjusted,2324,2469,145,5.9
3902,2008,September,San Saba                                             ,Not Adjusted,2350,2510,160,6.4
3903,2008,December,San Saba                                             ,Not Adjusted,2269,2400,131,5.5
3904,2008,March,Schleicher                                           ,Not Adjusted,1348,1393,45,3.2
3905,2008,June,Schleicher                                           ,Not Adjusted,1416,1466,50,3.4
3906,2008,September,Schleicher                                           ,Not Adjusted,1447,1497,50,3.3
3907,2008,December,Schleicher                                           ,Not Adjusted,1538,1598,60,3.8
3908,2008,March,Scurry                                               ,Not Adjusted,7062,7327,265,3.6
3909,2008,June,Scurry                                               ,Not Adjusted,7312,7656,344,4.5
3910,2008,September,Scurry                                               ,Not Adjusted,7376,7696,320,4.2
3911,2008,December,Scurry                                               ,Not Adjusted,7367,7683,316,4.1
3912,2008,March,Shackelford                                          ,Not Adjusted,2091,2140,49,2.3
3913,2008,June,Shackelford                                          ,Not Adjusted,2203,2265,62,2.7
3914,2008,September,Shackelford                                          ,Not Adjusted,2060,2125,65,3.1
3915,2008,December,Shackelford                                          ,Not Adjusted,2100,2155,55,2.6
3916,2008,March,Shelby                                               ,Not Adjusted,11605,12126,521,4.3
3917,2008,June,Shelby                                               ,Not Adjusted,11938,12572,634,5.0
3918,2008,September,Shelby                                               ,Not Adjusted,12214,12853,639,5.0
3919,2008,December,Shelby                                               ,Not Adjusted,11971,12604,633,5.0
3920,2008,March,Sherman                                              ,Not Adjusted,1363,1417,54,3.8
3921,2008,June,Sherman                                              ,Not Adjusted,1419,1479,60,4.1
3922,2008,September,Sherman                                              ,Not Adjusted,1510,1565,55,3.5
3923,2008,December,Sherman                                              ,Not Adjusted,1464,1521,57,3.7
3924,2008,March,Smith                                                ,Not Adjusted,92802,97135,4333,4.5
3925,2008,June,Smith                                                ,Not Adjusted,94261,99096,4835,4.9
3926,2008,September,Smith                                                ,Not Adjusted,94594,99477,4883,4.9
3927,2008,December,Smith                                                ,Not Adjusted,94717,100061,5344,5.3
3928,2008,March,Somervell                                            ,Not Adjusted,3873,4038,165,4.1
3929,2008,June,Somervell                                            ,Not Adjusted,3942,4147,205,4.9
3930,2008,September,Somervell                                            ,Not Adjusted,4040,4219,179,4.2
3931,2008,December,Somervell                                            ,Not Adjusted,3958,4163,205,4.9
3932,2008,March,Starr                                                ,Not Adjusted,19384,22035,2651,12.0
3933,2008,June,Starr                                                ,Not Adjusted,19494,21992,2498,11.4
3934,2008,September,Starr                                                ,Not Adjusted,20062,22376,2314,10.3
3935,2008,December,Starr                                                ,Not Adjusted,20457,23765,3308,13.9
3936,2008,March,Stephens                                             ,Not Adjusted,4477,4619,142,3.1
3937,2008,June,Stephens                                             ,Not Adjusted,4516,4699,183,3.9
3938,2008,September,Stephens                                             ,Not Adjusted,4608,4800,192,4.0
3939,2008,December,Stephens                                             ,Not Adjusted,4530,4729,199,4.2
3940,2008,March,Sterling                                             ,Not Adjusted,769,790,21,2.7
3941,2008,June,Sterling                                             ,Not Adjusted,839,868,29,3.3
3942,2008,September,Sterling                                             ,Not Adjusted,864,892,28,3.1
3943,2008,December,Sterling                                             ,Not Adjusted,864,887,23,2.6
3944,2008,March,Stonewall                                            ,Not Adjusted,816,845,29,3.4
3945,2008,June,Stonewall                                            ,Not Adjusted,863,890,27,3.0
3946,2008,September,Stonewall                                            ,Not Adjusted,902,932,30,3.2
3947,2008,December,Stonewall                                            ,Not Adjusted,806,836,30,3.6
3948,2008,March,Sutton                                               ,Not Adjusted,3292,3351,59,1.8
3949,2008,June,Sutton                                               ,Not Adjusted,3408,3477,69,2.0
3950,2008,September,Sutton                                               ,Not Adjusted,3521,3599,78,2.2
3951,2008,December,Sutton                                               ,Not Adjusted,3519,3592,73,2.0
3952,2008,March,Swisher                                              ,Not Adjusted,3321,3465,144,4.2
3953,2008,June,Swisher                                              ,Not Adjusted,3427,3599,172,4.8
3954,2008,September,Swisher                                              ,Not Adjusted,3579,3755,176,4.7
3955,2008,December,Swisher                                              ,Not Adjusted,3468,3621,153,4.2
3956,2008,March,Tarrant                                              ,Not Adjusted,835578,873066,37488,4.3
3957,2008,June,Tarrant                                              ,Not Adjusted,841869,884950,43081,4.9
3958,2008,September,Tarrant                                              ,Not Adjusted,840808,886053,45245,5.1
3959,2008,December,Tarrant                                              ,Not Adjusted,836978,886430,49452,5.6
3960,2008,March,Taylor                                               ,Not Adjusted,64199,66468,2269,3.4
3961,2008,June,Taylor                                               ,Not Adjusted,64937,67606,2669,3.9
3962,2008,September,Taylor                                               ,Not Adjusted,65102,67771,2669,3.9
3963,2008,December,Taylor                                               ,Not Adjusted,64715,67374,2659,3.9
3964,2008,March,Terrell                                              ,Not Adjusted,283,303,20,6.6
3965,2008,June,Terrell                                              ,Not Adjusted,314,334,20,6.0
3966,2008,September,Terrell                                              ,Not Adjusted,331,355,24,6.8
3967,2008,December,Terrell                                              ,Not Adjusted,339,367,28,7.6
3968,2008,March,Terry                                                ,Not Adjusted,5435,5670,235,4.1
3969,2008,June,Terry                                                ,Not Adjusted,5643,5905,262,4.4
3970,2008,September,Terry                                                ,Not Adjusted,5855,6117,262,4.3
3971,2008,December,Terry                                                ,Not Adjusted,5763,6012,249,4.1
3972,2008,March,Throckmorton                                         ,Not Adjusted,840,873,33,3.8
3973,2008,June,Throckmorton                                         ,Not Adjusted,904,939,35,3.7
3974,2008,September,Throckmorton                                         ,Not Adjusted,985,1019,34,3.3
3975,2008,December,Throckmorton                                         ,Not Adjusted,974,1004,30,3.0
3976,2008,March,Titus                                                ,Not Adjusted,13463,13996,533,3.8
3977,2008,June,Titus                                                ,Not Adjusted,13605,14248,643,4.5
3978,2008,September,Titus                                                ,Not Adjusted,13754,14409,655,4.5
3979,2008,December,Titus                                                ,Not Adjusted,13235,13930,695,5.0
3980,2008,March,Tom Green                                            ,Not Adjusted,49823,51693,1870,3.6
3981,2008,June,Tom Green                                            ,Not Adjusted,49469,51730,2261,4.4
3982,2008,September,Tom Green                                            ,Not Adjusted,49626,51950,2324,4.5
3983,2008,December,Tom Green                                            ,Not Adjusted,49300,51596,2296,4.4
3984,2008,March,Travis                                               ,Not Adjusted,512730,532721,19991,3.8
3985,2008,June,Travis                                               ,Not Adjusted,514235,537341,23106,4.3
3986,2008,September,Travis                                               ,Not Adjusted,515411,540291,24880,4.6
3987,2008,December,Travis                                               ,Not Adjusted,514534,541285,26751,4.9
3988,2008,March,Trinity                                              ,Not Adjusted,5379,5657,278,4.9
3989,2008,June,Trinity                                              ,Not Adjusted,5522,5851,329,5.6
3990,2008,September,Trinity                                              ,Not Adjusted,5487,5827,340,5.8
3991,2008,December,Trinity                                              ,Not Adjusted,5550,5936,386,6.5
3992,2008,March,Tyler                                                ,Not Adjusted,7734,8164,430,5.3
3993,2008,June,Tyler                                                ,Not Adjusted,7762,8263,501,6.1
3994,2008,September,Tyler                                                ,Not Adjusted,7750,8293,543,6.5
3995,2008,December,Tyler                                                ,Not Adjusted,7917,8485,568,6.7
3996,2008,March,Upshur                                               ,Not Adjusted,18853,19610,757,3.9
3997,2008,June,Upshur                                               ,Not Adjusted,19031,19872,841,4.2
3998,2008,September,Upshur                                               ,Not Adjusted,19008,19903,895,4.5
3999,2008,December,Upshur                                               ,Not Adjusted,19011,19952,941,4.7
4000,2008,March,Upton                                                ,Not Adjusted,1661,1711,50,2.9
4001,2008,June,Upton                                                ,Not Adjusted,1724,1783,59,3.3
4002,2008,September,Upton                                                ,Not Adjusted,1834,1891,57,3.0
4003,2008,December,Upton                                                ,Not Adjusted,1746,1807,61,3.4
4004,2008,March,Uvalde                                               ,Not Adjusted,10432,10990,558,5.1
4005,2008,June,Uvalde                                               ,Not Adjusted,10658,11346,688,6.1
4006,2008,September,Uvalde                                               ,Not Adjusted,10683,11383,700,6.1
4007,2008,December,Uvalde                                               ,Not Adjusted,10511,11202,691,6.2
4008,2008,March,Val Verde                                            ,Not Adjusted,19071,20134,1063,5.3
4009,2008,June,Val Verde                                            ,Not Adjusted,19394,20566,1172,5.7
4010,2008,September,Val Verde                                            ,Not Adjusted,19318,20473,1155,5.6
4011,2008,December,Val Verde                                            ,Not Adjusted,19252,20571,1319,6.4
4012,2008,March,Van Zandt                                            ,Not Adjusted,24324,25323,999,3.9
4013,2008,June,Van Zandt                                            ,Not Adjusted,24697,25845,1148,4.4
4014,2008,September,Van Zandt                                            ,Not Adjusted,24580,25810,1230,4.8
4015,2008,December,Van Zandt                                            ,Not Adjusted,24167,25427,1260,5.0
4016,2008,March,Victoria                                             ,Not Adjusted,43449,44930,1481,3.3
4017,2008,June,Victoria                                             ,Not Adjusted,43827,45643,1816,4.0
4018,2008,September,Victoria                                             ,Not Adjusted,43485,45342,1857,4.1
4019,2008,December,Victoria                                             ,Not Adjusted,43380,45351,1971,4.3
4020,2008,March,Walker                                               ,Not Adjusted,24689,25887,1198,4.6
4021,2008,June,Walker                                               ,Not Adjusted,24644,26190,1546,5.9
4022,2008,September,Walker                                               ,Not Adjusted,25399,26924,1525,5.7
4023,2008,December,Walker                                               ,Not Adjusted,25218,26606,1388,5.2
4024,2008,March,Waller                                               ,Not Adjusted,15241,15937,696,4.4
4025,2008,June,Waller                                               ,Not Adjusted,15389,16285,896,5.5
4026,2008,September,Waller                                               ,Not Adjusted,15331,16207,876,5.4
4027,2008,December,Waller                                               ,Not Adjusted,15478,16349,871,5.3
4028,2008,March,Ward                                                 ,Not Adjusted,4742,4911,169,3.4
4029,2008,June,Ward                                                 ,Not Adjusted,4929,5145,216,4.2
4030,2008,September,Ward                                                 ,Not Adjusted,5029,5245,216,4.1
4031,2008,December,Ward                                                 ,Not Adjusted,4897,5108,211,4.1
4032,2008,March,Washington                                           ,Not Adjusted,15679,16250,571,3.5
4033,2008,June,Washington                                           ,Not Adjusted,15765,16522,757,4.6
4034,2008,September,Washington                                           ,Not Adjusted,15892,16605,713,4.3
4035,2008,December,Washington                                           ,Not Adjusted,16013,16677,664,4.0
4036,2008,March,Webb                                                 ,Not Adjusted,86773,91296,4523,5.0
4037,2008,June,Webb                                                 ,Not Adjusted,87888,93255,5367,5.8
4038,2008,September,Webb                                                 ,Not Adjusted,88192,93296,5104,5.5
4039,2008,December,Webb                                                 ,Not Adjusted,88182,93541,5359,5.7
4040,2008,March,Wharton                                              ,Not Adjusted,19779,20587,808,3.9
4041,2008,June,Wharton                                              ,Not Adjusted,19913,20907,994,4.8
4042,2008,September,Wharton                                              ,Not Adjusted,20298,21276,978,4.6
4043,2008,December,Wharton                                              ,Not Adjusted,20394,21371,977,4.6
4044,2008,March,Wheeler                                              ,Not Adjusted,3131,3205,74,2.3
4045,2008,June,Wheeler                                              ,Not Adjusted,3289,3373,84,2.5
4046,2008,September,Wheeler                                              ,Not Adjusted,3632,3718,86,2.3
4047,2008,December,Wheeler                                              ,Not Adjusted,3278,3371,93,2.8
4048,2008,March,Wichita                                              ,Not Adjusted,58501,61071,2570,4.2
4049,2008,June,Wichita                                              ,Not Adjusted,58320,61396,3076,5.0
4050,2008,September,Wichita                                              ,Not Adjusted,57969,61342,3373,5.5
4051,2008,December,Wichita                                              ,Not Adjusted,57567,61037,3470,5.7
4052,2008,March,Wilbarger                                            ,Not Adjusted,7258,7503,245,3.3
4053,2008,June,Wilbarger                                            ,Not Adjusted,7295,7591,296,3.9
4054,2008,September,Wilbarger                                            ,Not Adjusted,7387,7683,296,3.9
4055,2008,December,Wilbarger                                            ,Not Adjusted,7415,7685,270,3.5
4056,2008,March,Willacy                                              ,Not Adjusted,7064,7709,645,8.4
4057,2008,June,Willacy                                              ,Not Adjusted,7022,7727,705,9.1
4058,2008,September,Willacy                                              ,Not Adjusted,7019,7766,747,9.6
4059,2008,December,Willacy                                              ,Not Adjusted,7183,7938,755,9.5
4060,2008,March,Williamson                                           ,Not Adjusted,192615,200645,8030,4.0
4061,2008,June,Williamson                                           ,Not Adjusted,193182,202250,9068,4.5
4062,2008,September,Williamson                                           ,Not Adjusted,193624,203504,9880,4.9
4063,2008,December,Williamson                                           ,Not Adjusted,193295,204448,11153,5.5
4064,2008,March,Wilson                                               ,Not Adjusted,17758,18537,779,4.2
4065,2008,June,Wilson                                               ,Not Adjusted,17985,18910,925,4.9
4066,2008,September,Wilson                                               ,Not Adjusted,17933,18867,934,5.0
4067,2008,December,Wilson                                               ,Not Adjusted,17882,18790,908,4.8
4068,2008,March,Winkler                                              ,Not Adjusted,3261,3369,108,3.2
4069,2008,June,Winkler                                              ,Not Adjusted,3320,3459,139,4.0
4070,2008,September,Winkler                                              ,Not Adjusted,3400,3539,139,3.9
4071,2008,December,Winkler                                              ,Not Adjusted,3375,3532,157,4.4
4072,2008,March,Wise                                                 ,Not Adjusted,26232,27265,1033,3.8
4073,2008,June,Wise                                                 ,Not Adjusted,26429,27710,1281,4.6
4074,2008,September,Wise                                                 ,Not Adjusted,26395,27629,1234,4.5
4075,2008,December,Wise                                                 ,Not Adjusted,26276,27651,1375,5.0
4076,2008,March,Wood                                                 ,Not Adjusted,17037,17845,808,4.5
4077,2008,June,Wood                                                 ,Not Adjusted,17309,18223,914,5.0
4078,2008,September,Wood                                                 ,Not Adjusted,17456,18414,958,5.2
4079,2008,December,Wood                                                 ,Not Adjusted,17033,18114,1081,6.0
4080,2008,March,Yoakum                                               ,Not Adjusted,3839,3950,111,2.8
4081,2008,June,Yoakum                                               ,Not Adjusted,4046,4183,137,3.3
4082,2008,September,Yoakum                                               ,Not Adjusted,4088,4219,131,3.1
4083,2008,December,Yoakum                                               ,Not Adjusted,4057,4198,141,3.4
4084,2008,March,Young                                                ,Not Adjusted,9421,9710,289,3.0
4085,2008,June,Young                                                ,Not Adjusted,9582,9946,364,3.7
4086,2008,September,Young                                                ,Not Adjusted,9634,9990,356,3.6
4087,2008,December,Young                                                ,Not Adjusted,9424,9799,375,3.8
4088,2008,March,Zapata                                               ,Not Adjusted,4797,5067,270,5.3
4089,2008,June,Zapata                                               ,Not Adjusted,4824,5135,311,6.1
4090,2008,September,Zapata                                               ,Not Adjusted,4904,5196,292,5.6
4091,2008,December,Zapata                                               ,Not Adjusted,5044,5346,302,5.6
4092,2008,March,Zavala                                               ,Not Adjusted,3289,3636,347,9.5
4093,2008,June,Zavala                                               ,Not Adjusted,3264,3654,390,10.7
4094,2008,September,Zavala                                               ,Not Adjusted,3168,3622,454,12.5
4095,2008,December,Zavala                                               ,Not Adjusted,3370,3830,460,12.0
4096,2009,March,Texas,Not Adjusted,10990873,11755589,764716,6.5
4097,2009,March,Texas,Adjusted,11040416,11799261,758845,6.4
4098,2009,June,Texas,Not Adjusted,11048285,12062534,1014249,8.4
4099,2009,June,Texas,Adjusted,11041350,11998393,957043,8.0
4100,2009,September,Texas,Not Adjusted,11027843,12030653,1002810,8.3
4101,2009,September,Texas,Adjusted,11038831,12036191,997360,8.3
4102,2009,December,Texas,Not Adjusted,11063681,12022010,958329,8.0
4103,2009,December,Texas,Adjusted,11072620,12070223,997603,8.3
4104,2009,March,Anderson                                             ,Not Adjusted,18971,20417,1446,7.1
4105,2009,June,Anderson                                             ,Not Adjusted,19277,21344,2067,9.7
4106,2009,September,Anderson                                             ,Not Adjusted,19160,21213,2053,9.7
4107,2009,December,Anderson                                             ,Not Adjusted,19118,21137,2019,9.6
4108,2009,March,Andrews                                              ,Not Adjusted,6503,6920,417,6.0
4109,2009,June,Andrews                                              ,Not Adjusted,6532,7138,606,8.5
4110,2009,September,Andrews                                              ,Not Adjusted,6475,7039,564,8.0
4111,2009,December,Andrews                                              ,Not Adjusted,6581,7027,446,6.3
4112,2009,March,Angelina                                             ,Not Adjusted,36850,39695,2845,7.2
4113,2009,June,Angelina                                             ,Not Adjusted,36656,40535,3879,9.6
4114,2009,September,Angelina                                             ,Not Adjusted,36748,40397,3649,9.0
4115,2009,December,Angelina                                             ,Not Adjusted,36606,40020,3414,8.5
4116,2009,March,Aransas                                              ,Not Adjusted,10867,11525,658,5.7
4117,2009,June,Aransas                                              ,Not Adjusted,10745,11620,875,7.5
4118,2009,September,Aransas                                              ,Not Adjusted,10767,11620,853,7.3
4119,2009,December,Aransas                                              ,Not Adjusted,10781,11681,900,7.7
4120,2009,March,Archer                                               ,Not Adjusted,4756,5014,258,5.1
4121,2009,June,Archer                                               ,Not Adjusted,4738,5073,335,6.6
4122,2009,September,Archer                                               ,Not Adjusted,4675,5005,330,6.6
4123,2009,December,Archer                                               ,Not Adjusted,4670,4968,298,6.0
4124,2009,March,Armstrong                                            ,Not Adjusted,1000,1043,43,4.1
4125,2009,June,Armstrong                                            ,Not Adjusted,1016,1075,59,5.5
4126,2009,September,Armstrong                                            ,Not Adjusted,1016,1070,54,5.0
4127,2009,December,Armstrong                                            ,Not Adjusted,1018,1065,47,4.4
4128,2009,March,Atascosa                                             ,Not Adjusted,17863,19051,1188,6.2
4129,2009,June,Atascosa                                             ,Not Adjusted,18096,19745,1649,8.4
4130,2009,September,Atascosa                                             ,Not Adjusted,18035,19650,1615,8.2
4131,2009,December,Atascosa                                             ,Not Adjusted,18172,19734,1562,7.9
4132,2009,March,Austin                                               ,Not Adjusted,12277,13064,787,6.0
4133,2009,June,Austin                                               ,Not Adjusted,12275,13342,1067,8.0
4134,2009,September,Austin                                               ,Not Adjusted,12245,13361,1116,8.4
4135,2009,December,Austin                                               ,Not Adjusted,12272,13336,1064,8.0
4136,2009,March,Bailey                                               ,Not Adjusted,3135,3302,167,5.1
4137,2009,June,Bailey                                               ,Not Adjusted,3290,3513,223,6.3
4138,2009,September,Bailey                                               ,Not Adjusted,3136,3321,185,5.6
4139,2009,December,Bailey                                               ,Not Adjusted,3129,3336,207,6.2
4140,2009,March,Bandera                                              ,Not Adjusted,9118,9655,537,5.6
4141,2009,June,Bandera                                              ,Not Adjusted,9237,9931,694,7.0
4142,2009,September,Bandera                                              ,Not Adjusted,9206,9916,710,7.2
4143,2009,December,Bandera                                              ,Not Adjusted,9275,9966,691,6.9
4144,2009,March,Bastrop                                              ,Not Adjusted,31312,33639,2327,6.9
4145,2009,June,Bastrop                                              ,Not Adjusted,31628,34689,3061,8.8
4146,2009,September,Bastrop                                              ,Not Adjusted,31725,34658,2933,8.5
4147,2009,December,Bastrop                                              ,Not Adjusted,31830,34659,2829,8.2
4148,2009,March,Baylor                                               ,Not Adjusted,1810,1914,104,5.4
4149,2009,June,Baylor                                               ,Not Adjusted,1973,2103,130,6.2
4150,2009,September,Baylor                                               ,Not Adjusted,1805,1918,113,5.9
4151,2009,December,Baylor                                               ,Not Adjusted,1835,1951,116,5.9
4152,2009,March,Bee                                                  ,Not Adjusted,10777,11674,897,7.7
4153,2009,June,Bee                                                  ,Not Adjusted,10893,12140,1247,10.3
4154,2009,September,Bee                                                  ,Not Adjusted,10847,12057,1210,10.0
4155,2009,December,Bee                                                  ,Not Adjusted,10911,11994,1083,9.0
4156,2009,March,Bell                                                 ,Not Adjusted,117121,124311,7190,5.8
4157,2009,June,Bell                                                 ,Not Adjusted,119002,128500,9498,7.4
4158,2009,September,Bell                                                 ,Not Adjusted,119803,129085,9282,7.2
4159,2009,December,Bell                                                 ,Not Adjusted,120068,129025,8957,6.9
4160,2009,March,Bexar                                                ,Not Adjusted,707887,752112,44225,5.9
4161,2009,June,Bexar                                                ,Not Adjusted,717141,774748,57607,7.4
4162,2009,September,Bexar                                                ,Not Adjusted,714665,771959,57294,7.4
4163,2009,December,Bexar                                                ,Not Adjusted,720081,774075,53994,7.0
4164,2009,March,Blanco                                               ,Not Adjusted,4749,4975,226,4.5
4165,2009,June,Blanco                                               ,Not Adjusted,5002,5304,302,5.7
4166,2009,September,Blanco                                               ,Not Adjusted,4837,5133,296,5.8
4167,2009,December,Blanco                                               ,Not Adjusted,4773,5043,270,5.4
4168,2009,March,Borden                                               ,Not Adjusted,375,401,26,6.5
4169,2009,June,Borden                                               ,Not Adjusted,425,456,31,6.8
4170,2009,September,Borden                                               ,Not Adjusted,404,428,24,5.6
4171,2009,December,Borden                                               ,Not Adjusted,435,456,21,4.6
4172,2009,March,Bosque                                               ,Not Adjusted,7849,8384,535,6.4
4173,2009,June,Bosque                                               ,Not Adjusted,8099,8874,775,8.7
4174,2009,September,Bosque                                               ,Not Adjusted,7886,8634,748,8.7
4175,2009,December,Bosque                                               ,Not Adjusted,7819,8548,729,8.5
4176,2009,March,Bowie                                                ,Not Adjusted,41338,43705,2367,5.4
4177,2009,June,Bowie                                                ,Not Adjusted,41331,44507,3176,7.1
4178,2009,September,Bowie                                                ,Not Adjusted,41226,44496,3270,7.3
4179,2009,December,Bowie                                                ,Not Adjusted,41444,44641,3197,7.2
4180,2009,March,Brazoria                                             ,Not Adjusted,134655,144699,10044,6.9
4181,2009,June,Brazoria                                             ,Not Adjusted,134626,147805,13179,8.9
4182,2009,September,Brazoria                                             ,Not Adjusted,134291,147270,12979,8.8
4183,2009,December,Brazoria                                             ,Not Adjusted,134606,147531,12925,8.8
4184,2009,March,Brazos                                               ,Not Adjusted,91930,96173,4243,4.4
4185,2009,June,Brazos                                               ,Not Adjusted,88395,94727,6332,6.7
4186,2009,September,Brazos                                               ,Not Adjusted,92973,99215,6242,6.3
4187,2009,December,Brazos                                               ,Not Adjusted,93855,99387,5532,5.6
4188,2009,March,Brewster                                             ,Not Adjusted,4895,5120,225,4.4
4189,2009,June,Brewster                                             ,Not Adjusted,4764,5072,308,6.1
4190,2009,September,Brewster                                             ,Not Adjusted,4914,5201,287,5.5
4191,2009,December,Brewster                                             ,Not Adjusted,4976,5238,262,5.0
4192,2009,March,Briscoe                                              ,Not Adjusted,667,693,26,3.8
4193,2009,June,Briscoe                                              ,Not Adjusted,732,767,35,4.6
4194,2009,September,Briscoe                                              ,Not Adjusted,662,703,41,5.8
4195,2009,December,Briscoe                                              ,Not Adjusted,667,707,40,5.7
4196,2009,March,Brooks                                               ,Not Adjusted,3086,3325,239,7.2
4197,2009,June,Brooks                                               ,Not Adjusted,3038,3410,372,10.9
4198,2009,September,Brooks                                               ,Not Adjusted,2967,3313,346,10.4
4199,2009,December,Brooks                                               ,Not Adjusted,2955,3272,317,9.7
4200,2009,March,Brown                                                ,Not Adjusted,17481,18752,1271,6.8
4201,2009,June,Brown                                                ,Not Adjusted,18152,19637,1485,7.6
4202,2009,September,Brown                                                ,Not Adjusted,17884,19281,1397,7.2
4203,2009,December,Brown                                                ,Not Adjusted,17481,18746,1265,6.7
4204,2009,March,Burleson                                             ,Not Adjusted,7631,8119,488,6.0
4205,2009,June,Burleson                                             ,Not Adjusted,7338,7968,630,7.9
4206,2009,September,Burleson                                             ,Not Adjusted,7717,8325,608,7.3
4207,2009,December,Burleson                                             ,Not Adjusted,7791,8384,593,7.1
4208,2009,March,Burnet                                               ,Not Adjusted,20754,21921,1167,5.3
4209,2009,June,Burnet                                               ,Not Adjusted,21626,23166,1540,6.6
4210,2009,September,Burnet                                               ,Not Adjusted,20850,22355,1505,6.7
4211,2009,December,Burnet                                               ,Not Adjusted,20522,21900,1378,6.3
4212,2009,March,Caldwell                                             ,Not Adjusted,14325,15479,1154,7.5
4213,2009,June,Caldwell                                             ,Not Adjusted,14471,15952,1481,9.3
4214,2009,September,Caldwell                                             ,Not Adjusted,14515,15907,1392,8.8
4215,2009,December,Caldwell                                             ,Not Adjusted,14562,15914,1352,8.5
4216,2009,March,Calhoun                                              ,Not Adjusted,8685,9372,687,7.3
4217,2009,June,Calhoun                                              ,Not Adjusted,8689,9621,932,9.7
4218,2009,September,Calhoun                                              ,Not Adjusted,8594,9507,913,9.6
4219,2009,December,Calhoun                                              ,Not Adjusted,8625,9464,839,8.9
4220,2009,March,Callahan                                             ,Not Adjusted,6641,6984,343,4.9
4221,2009,June,Callahan                                             ,Not Adjusted,6702,7210,508,7.0
4222,2009,September,Callahan                                             ,Not Adjusted,6731,7185,454,6.3
4223,2009,December,Callahan                                             ,Not Adjusted,6688,7098,410,5.8
4224,2009,March,Cameron                                              ,Not Adjusted,134731,147431,12700,8.6
4225,2009,June,Cameron                                              ,Not Adjusted,137128,153353,16225,10.6
4226,2009,September,Cameron                                              ,Not Adjusted,137780,153873,16093,10.5
4227,2009,December,Cameron                                              ,Not Adjusted,139301,155748,16447,10.6
4228,2009,March,Camp                                                 ,Not Adjusted,5165,5602,437,7.8
4229,2009,June,Camp                                                 ,Not Adjusted,5347,5937,590,9.9
4230,2009,September,Camp                                                 ,Not Adjusted,5245,5815,570,9.8
4231,2009,December,Camp                                                 ,Not Adjusted,5252,5742,490,8.5
4232,2009,March,Carson                                               ,Not Adjusted,3033,3200,167,5.2
4233,2009,June,Carson                                               ,Not Adjusted,3077,3309,232,7.0
4234,2009,September,Carson                                               ,Not Adjusted,3083,3310,227,6.9
4235,2009,December,Carson                                               ,Not Adjusted,3085,3283,198,6.0
4236,2009,March,Cass                                                 ,Not Adjusted,11858,13266,1408,10.6
4237,2009,June,Cass                                                 ,Not Adjusted,11880,13604,1724,12.7
4238,2009,September,Cass                                                 ,Not Adjusted,11900,13567,1667,12.3
4239,2009,December,Cass                                                 ,Not Adjusted,11857,13364,1507,11.3
4240,2009,March,Castro                                               ,Not Adjusted,3485,3641,156,4.3
4241,2009,June,Castro                                               ,Not Adjusted,3726,3934,208,5.3
4242,2009,September,Castro                                               ,Not Adjusted,3501,3696,195,5.3
4243,2009,December,Castro                                               ,Not Adjusted,3451,3642,191,5.2
4244,2009,March,Chambers                                             ,Not Adjusted,13988,15144,1156,7.6
4245,2009,June,Chambers                                             ,Not Adjusted,13985,15562,1577,10.1
4246,2009,September,Chambers                                             ,Not Adjusted,13950,15537,1587,10.2
4247,2009,December,Chambers                                             ,Not Adjusted,13983,15494,1511,9.8
4248,2009,March,Cherokee                                             ,Not Adjusted,18859,20447,1588,7.8
4249,2009,June,Cherokee                                             ,Not Adjusted,19552,21577,2025,9.4
4250,2009,September,Cherokee                                             ,Not Adjusted,19211,21243,2032,9.6
4251,2009,December,Cherokee                                             ,Not Adjusted,18989,20989,2000,9.5
4252,2009,March,Childress                                            ,Not Adjusted,3021,3200,179,5.6
4253,2009,June,Childress                                            ,Not Adjusted,3239,3474,235,6.8
4254,2009,September,Childress                                            ,Not Adjusted,3141,3359,218,6.5
4255,2009,December,Childress                                            ,Not Adjusted,3024,3236,212,6.6
4256,2009,March,Clay                                                 ,Not Adjusted,5720,6055,335,5.5
4257,2009,June,Clay                                                 ,Not Adjusted,5695,6176,481,7.8
4258,2009,September,Clay                                                 ,Not Adjusted,5622,6078,456,7.5
4259,2009,December,Clay                                                 ,Not Adjusted,5615,6096,481,7.9
4260,2009,March,Cochran                                              ,Not Adjusted,1413,1496,83,5.5
4261,2009,June,Cochran                                              ,Not Adjusted,1493,1605,112,7.0
4262,2009,September,Cochran                                              ,Not Adjusted,1371,1481,110,7.4
4263,2009,December,Cochran                                              ,Not Adjusted,1366,1465,99,6.8
4264,2009,March,Coke                                                 ,Not Adjusted,1241,1334,93,7.0
4265,2009,June,Coke                                                 ,Not Adjusted,1223,1341,118,8.8
4266,2009,September,Coke                                                 ,Not Adjusted,1173,1290,117,9.1
4267,2009,December,Coke                                                 ,Not Adjusted,1224,1326,102,7.7
4268,2009,March,Coleman                                              ,Not Adjusted,4032,4302,270,6.3
4269,2009,June,Coleman                                              ,Not Adjusted,4206,4548,342,7.5
4270,2009,September,Coleman                                              ,Not Adjusted,4130,4457,327,7.3
4271,2009,December,Coleman                                              ,Not Adjusted,4104,4407,303,6.9
4272,2009,March,Collin                                               ,Not Adjusted,383082,409726,26644,6.5
4273,2009,June,Collin                                               ,Not Adjusted,385349,419362,34013,8.1
4274,2009,September,Collin                                               ,Not Adjusted,386552,419574,33022,7.9
4275,2009,December,Collin                                               ,Not Adjusted,387331,417474,30143,7.2
4276,2009,March,Collingsworth                                        ,Not Adjusted,1400,1470,70,4.8
4277,2009,June,Collingsworth                                        ,Not Adjusted,1500,1603,103,6.4
4278,2009,September,Collingsworth                                        ,Not Adjusted,1427,1520,93,6.1
4279,2009,December,Collingsworth                                        ,Not Adjusted,1373,1443,70,4.9
4280,2009,March,Colorado                                             ,Not Adjusted,10041,10594,553,5.2
4281,2009,June,Colorado                                             ,Not Adjusted,10404,11207,803,7.2
4282,2009,September,Colorado                                             ,Not Adjusted,10114,10874,760,7.0
4283,2009,December,Colorado                                             ,Not Adjusted,9831,10554,723,6.9
4284,2009,March,Comal                                                ,Not Adjusted,53416,56455,3039,5.4
4285,2009,June,Comal                                                ,Not Adjusted,54114,58107,3993,6.9
4286,2009,September,Comal                                                ,Not Adjusted,53927,57783,3856,6.7
4287,2009,December,Comal                                                ,Not Adjusted,54336,57985,3649,6.3
4288,2009,March,Comanche                                             ,Not Adjusted,6371,6721,350,5.2
4289,2009,June,Comanche                                             ,Not Adjusted,6709,7199,490,6.8
4290,2009,September,Comanche                                             ,Not Adjusted,6460,6900,440,6.4
4291,2009,December,Comanche                                             ,Not Adjusted,6247,6667,420,6.3
4292,2009,March,Concho                                               ,Not Adjusted,1234,1321,87,6.6
4293,2009,June,Concho                                               ,Not Adjusted,1328,1439,111,7.7
4294,2009,September,Concho                                               ,Not Adjusted,1237,1345,108,8.0
4295,2009,December,Concho                                               ,Not Adjusted,1212,1307,95,7.3
4296,2009,March,Cooke                                                ,Not Adjusted,20535,21792,1257,5.8
4297,2009,June,Cooke                                                ,Not Adjusted,20498,22162,1664,7.5
4298,2009,September,Cooke                                                ,Not Adjusted,20142,21716,1574,7.2
4299,2009,December,Cooke                                                ,Not Adjusted,20456,21929,1473,6.7
4300,2009,March,Coryell                                              ,Not Adjusted,22039,23689,1650,7.0
4301,2009,June,Coryell                                              ,Not Adjusted,22393,24691,2298,9.3
4302,2009,September,Coryell                                              ,Not Adjusted,22544,24771,2227,9.0
4303,2009,December,Coryell                                              ,Not Adjusted,22593,24693,2100,8.5
4304,2009,March,Cottle                                               ,Not Adjusted,768,808,40,5.0
4305,2009,June,Cottle                                               ,Not Adjusted,819,867,48,5.5
4306,2009,September,Cottle                                               ,Not Adjusted,736,783,47,6.0
4307,2009,December,Cottle                                               ,Not Adjusted,724,770,46,6.0
4308,2009,March,Crane                                                ,Not Adjusted,1628,1752,124,7.1
4309,2009,June,Crane                                                ,Not Adjusted,1654,1841,187,10.2
4310,2009,September,Crane                                                ,Not Adjusted,1632,1811,179,9.9
4311,2009,December,Crane                                                ,Not Adjusted,1566,1719,153,8.9
4312,2009,March,Crockett                                             ,Not Adjusted,2091,2247,156,6.9
4313,2009,June,Crockett                                             ,Not Adjusted,2162,2418,256,10.6
4314,2009,September,Crockett                                             ,Not Adjusted,2106,2337,231,9.9
4315,2009,December,Crockett                                             ,Not Adjusted,2023,2210,187,8.5
4316,2009,March,Crosby                                               ,Not Adjusted,2395,2559,164,6.4
4317,2009,June,Crosby                                               ,Not Adjusted,2382,2586,204,7.9
4318,2009,September,Crosby                                               ,Not Adjusted,2430,2621,191,7.3
4319,2009,December,Crosby                                               ,Not Adjusted,2430,2612,182,7.0
4320,2009,March,Culberson                                            ,Not Adjusted,1731,1798,67,3.7
4321,2009,June,Culberson                                            ,Not Adjusted,1817,1904,87,4.6
4322,2009,September,Culberson                                            ,Not Adjusted,1709,1783,74,4.2
4323,2009,December,Culberson                                            ,Not Adjusted,1674,1741,67,3.8
4324,2009,March,Dallam                                               ,Not Adjusted,3519,3640,121,3.3
4325,2009,June,Dallam                                               ,Not Adjusted,3824,3996,172,4.3
4326,2009,September,Dallam                                               ,Not Adjusted,3565,3739,174,4.7
4327,2009,December,Dallam                                               ,Not Adjusted,3545,3748,203,5.4
4328,2009,March,Dallas                                               ,Not Adjusted,1044157,1125602,81445,7.2
4329,2009,June,Dallas                                               ,Not Adjusted,1050333,1153766,103433,9.0
4330,2009,September,Dallas                                               ,Not Adjusted,1053617,1157451,103834,9.0
4331,2009,December,Dallas                                               ,Not Adjusted,1055739,1154363,98624,8.5
4332,2009,March,Dawson                                               ,Not Adjusted,4870,5261,391,7.4
4333,2009,June,Dawson                                               ,Not Adjusted,5112,5629,517,9.2
4334,2009,September,Dawson                                               ,Not Adjusted,4903,5373,470,8.7
4335,2009,December,Dawson                                               ,Not Adjusted,4995,5396,401,7.4
4336,2009,March,Deaf Smith                                           ,Not Adjusted,8588,8997,409,4.5
4337,2009,June,Deaf Smith                                           ,Not Adjusted,8966,9515,549,5.8
4338,2009,September,Deaf Smith                                           ,Not Adjusted,8640,9184,544,5.9
4339,2009,December,Deaf Smith                                           ,Not Adjusted,8591,9086,495,5.4
4340,2009,March,Delta                                                ,Not Adjusted,2050,2203,153,6.9
4341,2009,June,Delta                                                ,Not Adjusted,2061,2288,227,9.9
4342,2009,September,Delta                                                ,Not Adjusted,2068,2277,209,9.2
4343,2009,December,Delta                                                ,Not Adjusted,2072,2288,216,9.4
4344,2009,March,Denton                                               ,Not Adjusted,324177,345886,21709,6.3
4345,2009,June,Denton                                               ,Not Adjusted,326094,354452,28358,8.0
4346,2009,September,Denton                                               ,Not Adjusted,327115,354542,27427,7.7
4347,2009,December,Denton                                               ,Not Adjusted,327773,353571,25798,7.3
4348,2009,March,DeWitt                                               ,Not Adjusted,8516,9103,587,6.4
4349,2009,June,DeWitt                                               ,Not Adjusted,8636,9403,767,8.2
4350,2009,September,DeWitt                                               ,Not Adjusted,8477,9256,779,8.4
4351,2009,December,DeWitt                                               ,Not Adjusted,8438,9191,753,8.2
4352,2009,March,Dickens                                              ,Not Adjusted,943,1009,66,6.5
4353,2009,June,Dickens                                              ,Not Adjusted,1026,1109,83,7.5
4354,2009,September,Dickens                                              ,Not Adjusted,946,1019,73,7.2
4355,2009,December,Dickens                                              ,Not Adjusted,925,998,73,7.3
4356,2009,March,Dimmit                                               ,Not Adjusted,3729,4079,350,8.6
4357,2009,June,Dimmit                                               ,Not Adjusted,3794,4275,481,11.3
4358,2009,September,Dimmit                                               ,Not Adjusted,3831,4296,465,10.8
4359,2009,December,Dimmit                                               ,Not Adjusted,3790,4213,423,10.0
4360,2009,March,Donley                                               ,Not Adjusted,1783,1876,93,5.0
4361,2009,June,Donley                                               ,Not Adjusted,1925,2065,140,6.8
4362,2009,September,Donley                                               ,Not Adjusted,1805,1938,133,6.9
4363,2009,December,Donley                                               ,Not Adjusted,1762,1874,112,6.0
4364,2009,March,Duval                                                ,Not Adjusted,4757,5194,437,8.4
4365,2009,June,Duval                                                ,Not Adjusted,4728,5381,653,12.1
4366,2009,September,Duval                                                ,Not Adjusted,4626,5316,690,13.0
4367,2009,December,Duval                                                ,Not Adjusted,4606,5238,632,12.1
4368,2009,March,Eastland                                             ,Not Adjusted,8173,8702,529,6.1
4369,2009,June,Eastland                                             ,Not Adjusted,8005,8769,764,8.7
4370,2009,September,Eastland                                             ,Not Adjusted,7839,8567,728,8.5
4371,2009,December,Eastland                                             ,Not Adjusted,7774,8467,693,8.2
4372,2009,March,Ector                                                ,Not Adjusted,67579,71962,4383,6.1
4373,2009,June,Ector                                                ,Not Adjusted,64649,71761,7112,9.9
4374,2009,September,Ector                                                ,Not Adjusted,64644,71499,6855,9.6
4375,2009,December,Ector                                                ,Not Adjusted,65441,71564,6123,8.6
4376,2009,March,Edwards                                              ,Not Adjusted,983,1058,75,7.1
4377,2009,June,Edwards                                              ,Not Adjusted,1054,1139,85,7.5
4378,2009,September,Edwards                                              ,Not Adjusted,983,1057,74,7.0
4379,2009,December,Edwards                                              ,Not Adjusted,973,1054,81,7.7
4380,2009,March,Ellis                                                ,Not Adjusted,64994,69754,4760,6.8
4381,2009,June,Ellis                                                ,Not Adjusted,65378,71776,6398,8.9
4382,2009,September,Ellis                                                ,Not Adjusted,65584,71873,6289,8.8
4383,2009,December,Ellis                                                ,Not Adjusted,65715,71604,5889,8.2
4384,2009,March,El Paso                                              ,Not Adjusted,278258,301917,23659,7.8
4385,2009,June,El Paso                                              ,Not Adjusted,279764,310152,30388,9.8
4386,2009,September,El Paso                                              ,Not Adjusted,282276,312447,30171,9.7
4387,2009,December,El Paso                                              ,Not Adjusted,285885,314161,28276,9.0
4388,2009,March,Erath                                                ,Not Adjusted,18264,19270,1006,5.2
4389,2009,June,Erath                                                ,Not Adjusted,18017,19497,1480,7.6
4390,2009,September,Erath                                                ,Not Adjusted,17744,19142,1398,7.3
4391,2009,December,Erath                                                ,Not Adjusted,17960,19197,1237,6.4
4392,2009,March,Falls                                                ,Not Adjusted,6032,6525,493,7.6
4393,2009,June,Falls                                                ,Not Adjusted,6225,6866,641,9.3
4394,2009,September,Falls                                                ,Not Adjusted,6103,6757,654,9.7
4395,2009,December,Falls                                                ,Not Adjusted,6068,6710,642,9.6
4396,2009,March,Fannin                                               ,Not Adjusted,12311,13317,1006,7.6
4397,2009,June,Fannin                                               ,Not Adjusted,12590,13875,1285,9.3
4398,2009,September,Fannin                                               ,Not Adjusted,12487,13765,1278,9.3
4399,2009,December,Fannin                                               ,Not Adjusted,12533,13764,1231,8.9
4400,2009,March,Fayette                                              ,Not Adjusted,11539,12106,567,4.7
4401,2009,June,Fayette                                              ,Not Adjusted,12043,12803,760,5.9
4402,2009,September,Fayette                                              ,Not Adjusted,11389,12133,744,6.1
4403,2009,December,Fayette                                              ,Not Adjusted,11428,12135,707,5.8
4404,2009,March,Fisher                                               ,Not Adjusted,1888,1993,105,5.3
4405,2009,June,Fisher                                               ,Not Adjusted,1999,2140,141,6.6
4406,2009,September,Fisher                                               ,Not Adjusted,1905,2040,135,6.6
4407,2009,December,Fisher                                               ,Not Adjusted,1876,2001,125,6.2
4408,2009,March,Floyd                                                ,Not Adjusted,2981,3166,185,5.8
4409,2009,June,Floyd                                                ,Not Adjusted,3160,3398,238,7.0
4410,2009,September,Floyd                                                ,Not Adjusted,3002,3236,234,7.2
4411,2009,December,Floyd                                                ,Not Adjusted,2938,3150,212,6.7
4412,2009,March,Foard                                                ,Not Adjusted,685,717,32,4.5
4413,2009,June,Foard                                                ,Not Adjusted,729,777,48,6.2
4414,2009,September,Foard                                                ,Not Adjusted,663,708,45,6.4
4415,2009,December,Foard                                                ,Not Adjusted,652,689,37,5.4
4416,2009,March,Fort Bend                                            ,Not Adjusted,257701,273722,16021,5.9
4417,2009,June,Fort Bend                                            ,Not Adjusted,257644,279544,21900,7.8
4418,2009,September,Fort Bend                                            ,Not Adjusted,257004,279716,22712,8.1
4419,2009,December,Fort Bend                                            ,Not Adjusted,257605,279322,21717,7.8
4420,2009,March,Franklin                                             ,Not Adjusted,5150,5441,291,5.3
4421,2009,June,Franklin                                             ,Not Adjusted,5212,5637,425,7.5
4422,2009,September,Franklin                                             ,Not Adjusted,5098,5521,423,7.7
4423,2009,December,Franklin                                             ,Not Adjusted,4882,5288,406,7.7
4424,2009,March,Freestone                                            ,Not Adjusted,9565,10062,497,4.9
4425,2009,June,Freestone                                            ,Not Adjusted,9652,10372,720,6.9
4426,2009,September,Freestone                                            ,Not Adjusted,9502,10246,744,7.3
4427,2009,December,Freestone                                            ,Not Adjusted,9405,10093,688,6.8
4428,2009,March,Frio                                                 ,Not Adjusted,7014,7515,501,6.7
4429,2009,June,Frio                                                 ,Not Adjusted,7100,7735,635,8.2
4430,2009,September,Frio                                                 ,Not Adjusted,6776,7383,607,8.2
4431,2009,December,Frio                                                 ,Not Adjusted,6785,7338,553,7.5
4432,2009,March,Gaines                                               ,Not Adjusted,6485,6842,357,5.2
4433,2009,June,Gaines                                               ,Not Adjusted,6878,7438,560,7.5
4434,2009,September,Gaines                                               ,Not Adjusted,6707,7215,508,7.0
4435,2009,December,Gaines                                               ,Not Adjusted,6498,6938,440,6.3
4436,2009,March,Galveston                                            ,Not Adjusted,129269,139580,10311,7.4
4437,2009,June,Galveston                                            ,Not Adjusted,129239,141511,12272,8.7
4438,2009,September,Galveston                                            ,Not Adjusted,128918,141078,12160,8.6
4439,2009,December,Galveston                                            ,Not Adjusted,129222,141815,12593,8.9
4440,2009,March,Garza                                                ,Not Adjusted,2284,2394,110,4.6
4441,2009,June,Garza                                                ,Not Adjusted,2359,2506,147,5.9
4442,2009,September,Garza                                                ,Not Adjusted,2351,2500,149,6.0
4443,2009,December,Garza                                                ,Not Adjusted,2339,2461,122,5.0
4444,2009,March,Gillespie                                            ,Not Adjusted,12804,13324,520,3.9
4445,2009,June,Gillespie                                            ,Not Adjusted,13450,14128,678,4.8
4446,2009,September,Gillespie                                            ,Not Adjusted,13026,13723,697,5.1
4447,2009,December,Gillespie                                            ,Not Adjusted,13285,13931,646,4.6
4448,2009,March,Glasscock                                            ,Not Adjusted,607,630,23,3.7
4449,2009,June,Glasscock                                            ,Not Adjusted,679,716,37,5.2
4450,2009,September,Glasscock                                            ,Not Adjusted,615,649,34,5.2
4451,2009,December,Glasscock                                            ,Not Adjusted,608,642,34,5.3
4452,2009,March,Goliad                                               ,Not Adjusted,3163,3340,177,5.3
4453,2009,June,Goliad                                               ,Not Adjusted,3166,3414,248,7.3
4454,2009,September,Goliad                                               ,Not Adjusted,3134,3411,277,8.1
4455,2009,December,Goliad                                               ,Not Adjusted,3143,3411,268,7.9
4456,2009,March,Gonzales                                             ,Not Adjusted,9462,9933,471,4.7
4457,2009,June,Gonzales                                             ,Not Adjusted,10005,10644,639,6.0
4458,2009,September,Gonzales                                             ,Not Adjusted,9460,10075,615,6.1
4459,2009,December,Gonzales                                             ,Not Adjusted,9426,10030,604,6.0
4460,2009,March,Gray                                                 ,Not Adjusted,10549,11302,753,6.7
4461,2009,June,Gray                                                 ,Not Adjusted,10607,11706,1099,9.4
4462,2009,September,Gray                                                 ,Not Adjusted,10203,11284,1081,9.6
4463,2009,December,Gray                                                 ,Not Adjusted,10002,10931,929,8.5
4464,2009,March,Grayson                                              ,Not Adjusted,52095,56220,4125,7.3
4465,2009,June,Grayson                                              ,Not Adjusted,52628,57625,4997,8.7
4466,2009,September,Grayson                                              ,Not Adjusted,52190,57162,4972,8.7
4467,2009,December,Grayson                                              ,Not Adjusted,52227,56907,4680,8.2
4468,2009,March,Gregg                                                ,Not Adjusted,60900,64600,3700,5.7
4469,2009,June,Gregg                                                ,Not Adjusted,60661,66078,5417,8.2
4470,2009,September,Gregg                                                ,Not Adjusted,59850,65059,5209,8.0
4471,2009,December,Gregg                                                ,Not Adjusted,60131,65048,4917,7.6
4472,2009,March,Grimes                                               ,Not Adjusted,10374,11131,757,6.8
4473,2009,June,Grimes                                               ,Not Adjusted,10629,11786,1157,9.8
4474,2009,September,Grimes                                               ,Not Adjusted,10705,11870,1165,9.8
4475,2009,December,Grimes                                               ,Not Adjusted,10738,11832,1094,9.2
4476,2009,March,Guadalupe                                            ,Not Adjusted,55825,59211,3386,5.7
4477,2009,June,Guadalupe                                            ,Not Adjusted,56554,61006,4452,7.3
4478,2009,September,Guadalupe                                            ,Not Adjusted,56358,60512,4154,6.9
4479,2009,December,Guadalupe                                            ,Not Adjusted,56786,60729,3943,6.5
4480,2009,March,Hale                                                 ,Not Adjusted,15982,16873,891,5.3
4481,2009,June,Hale                                                 ,Not Adjusted,16458,17738,1280,7.2
4482,2009,September,Hale                                                 ,Not Adjusted,16640,17777,1137,6.4
4483,2009,December,Hale                                                 ,Not Adjusted,16308,17374,1066,6.1
4484,2009,March,Hall                                                 ,Not Adjusted,1344,1454,110,7.6
4485,2009,June,Hall                                                 ,Not Adjusted,1412,1548,136,8.8
4486,2009,September,Hall                                                 ,Not Adjusted,1337,1465,128,8.7
4487,2009,December,Hall                                                 ,Not Adjusted,1293,1411,118,8.4
4488,2009,March,Hamilton                                             ,Not Adjusted,4079,4268,189,4.4
4489,2009,June,Hamilton                                             ,Not Adjusted,4249,4530,281,6.2
4490,2009,September,Hamilton                                             ,Not Adjusted,4027,4304,277,6.4
4491,2009,December,Hamilton                                             ,Not Adjusted,4098,4360,262,6.0
4492,2009,March,Hansford                                             ,Not Adjusted,2595,2710,115,4.2
4493,2009,June,Hansford                                             ,Not Adjusted,2803,2993,190,6.3
4494,2009,September,Hansford                                             ,Not Adjusted,2618,2785,167,6.0
4495,2009,December,Hansford                                             ,Not Adjusted,2569,2703,134,5.0
4496,2009,March,Hardeman                                             ,Not Adjusted,2078,2223,145,6.5
4497,2009,June,Hardeman                                             ,Not Adjusted,2243,2441,198,8.1
4498,2009,September,Hardeman                                             ,Not Adjusted,2053,2225,172,7.7
4499,2009,December,Hardeman                                             ,Not Adjusted,2040,2202,162,7.4
4500,2009,March,Hardin                                               ,Not Adjusted,25270,27078,1808,6.7
4501,2009,June,Hardin                                               ,Not Adjusted,24818,27532,2714,9.9
4502,2009,September,Hardin                                               ,Not Adjusted,24654,27268,2614,9.6
4503,2009,December,Hardin                                               ,Not Adjusted,24836,27384,2548,9.3
4504,2009,March,Harris                                               ,Not Adjusted,1826837,1949314,122477,6.3
4505,2009,June,Harris                                               ,Not Adjusted,1826427,1992587,166160,8.3
4506,2009,September,Harris                                               ,Not Adjusted,1821897,1990836,168939,8.5
4507,2009,December,Harris                                               ,Not Adjusted,1826162,1989205,163043,8.2
4508,2009,March,Harrison                                             ,Not Adjusted,30566,32631,2065,6.3
4509,2009,June,Harrison                                             ,Not Adjusted,30140,33186,3046,9.2
4510,2009,September,Harrison                                             ,Not Adjusted,29943,32940,2997,9.1
4511,2009,December,Harrison                                             ,Not Adjusted,29856,32983,3127,9.5
4512,2009,March,Hartley                                              ,Not Adjusted,2314,2396,82,3.4
4513,2009,June,Hartley                                              ,Not Adjusted,2513,2625,112,4.3
4514,2009,September,Hartley                                              ,Not Adjusted,2344,2455,111,4.5
4515,2009,December,Hartley                                              ,Not Adjusted,2329,2431,102,4.2
4516,2009,March,Haskell                                              ,Not Adjusted,3070,3229,159,4.9
4517,2009,June,Haskell                                              ,Not Adjusted,3171,3359,188,5.6
4518,2009,September,Haskell                                              ,Not Adjusted,3036,3202,166,5.2
4519,2009,December,Haskell                                              ,Not Adjusted,3000,3153,153,4.9
4520,2009,March,Hays                                                 ,Not Adjusted,73230,77721,4491,5.8
4521,2009,June,Hays                                                 ,Not Adjusted,73966,79882,5916,7.4
4522,2009,September,Hays                                                 ,Not Adjusted,74194,79898,5704,7.1
4523,2009,December,Hays                                                 ,Not Adjusted,74441,79855,5414,6.8
4524,2009,March,Hemphill                                             ,Not Adjusted,2666,2744,78,2.8
4525,2009,June,Hemphill                                             ,Not Adjusted,2507,2615,108,4.1
4526,2009,September,Hemphill                                             ,Not Adjusted,2444,2546,102,4.0
4527,2009,December,Hemphill                                             ,Not Adjusted,2407,2497,90,3.6
4528,2009,March,Henderson                                            ,Not Adjusted,32191,34654,2463,7.1
4529,2009,June,Henderson                                            ,Not Adjusted,32791,35925,3134,8.7
4530,2009,September,Henderson                                            ,Not Adjusted,32512,35615,3103,8.7
4531,2009,December,Henderson                                            ,Not Adjusted,32254,35318,3064,8.7
4532,2009,March,Hidalgo                                              ,Not Adjusted,263456,289805,26349,9.1
4533,2009,June,Hidalgo                                              ,Not Adjusted,265305,299424,34119,11.4
4534,2009,September,Hidalgo                                              ,Not Adjusted,265033,299298,34265,11.4
4535,2009,December,Hidalgo                                              ,Not Adjusted,270429,305492,35063,11.5
4536,2009,March,Hill                                                 ,Not Adjusted,15142,16227,1085,6.7
4537,2009,June,Hill                                                 ,Not Adjusted,15298,16747,1449,8.7
4538,2009,September,Hill                                                 ,Not Adjusted,15022,16456,1434,8.7
4539,2009,December,Hill                                                 ,Not Adjusted,15209,16540,1331,8.0
4540,2009,March,Hockley                                              ,Not Adjusted,11534,12278,744,6.1
4541,2009,June,Hockley                                              ,Not Adjusted,11353,12370,1017,8.2
4542,2009,September,Hockley                                              ,Not Adjusted,11364,12238,874,7.1
4543,2009,December,Hockley                                              ,Not Adjusted,11391,12149,758,6.2
4544,2009,March,Hood                                                 ,Not Adjusted,24536,26067,1531,5.9
4545,2009,June,Hood                                                 ,Not Adjusted,24731,26883,2152,8.0
4546,2009,September,Hood                                                 ,Not Adjusted,24278,26398,2120,8.0
4547,2009,December,Hood                                                 ,Not Adjusted,23984,26076,2092,8.0
4548,2009,March,Hopkins                                              ,Not Adjusted,16554,17422,868,5.0
4549,2009,June,Hopkins                                              ,Not Adjusted,17024,18247,1223,6.7
4550,2009,September,Hopkins                                              ,Not Adjusted,17030,18240,1210,6.6
4551,2009,December,Hopkins                                              ,Not Adjusted,16828,18034,1206,6.7
4552,2009,March,Houston                                              ,Not Adjusted,7410,8008,598,7.5
4553,2009,June,Houston                                              ,Not Adjusted,7650,8496,846,10.0
4554,2009,September,Houston                                              ,Not Adjusted,7435,8274,839,10.1
4555,2009,December,Houston                                              ,Not Adjusted,7575,8439,864,10.2
4556,2009,March,Howard                                               ,Not Adjusted,13215,14140,925,6.5
4557,2009,June,Howard                                               ,Not Adjusted,13404,14652,1248,8.5
4558,2009,September,Howard                                               ,Not Adjusted,13279,14415,1136,7.9
4559,2009,December,Howard                                               ,Not Adjusted,13227,14225,998,7.0
4560,2009,March,Hudspeth                                             ,Not Adjusted,1527,1600,73,4.6
4561,2009,June,Hudspeth                                             ,Not Adjusted,1683,1788,105,5.9
4562,2009,September,Hudspeth                                             ,Not Adjusted,1654,1758,104,5.9
4563,2009,December,Hudspeth                                             ,Not Adjusted,1683,1791,108,6.0
4564,2009,March,Hunt                                                 ,Not Adjusted,33285,35776,2491,7.0
4565,2009,June,Hunt                                                 ,Not Adjusted,33481,36734,3253,8.9
4566,2009,September,Hunt                                                 ,Not Adjusted,33586,36877,3291,8.9
4567,2009,December,Hunt                                                 ,Not Adjusted,33655,36889,3234,8.8
4568,2009,March,Hutchinson                                           ,Not Adjusted,10679,11278,599,5.3
4569,2009,June,Hutchinson                                           ,Not Adjusted,10724,11605,881,7.6
4570,2009,September,Hutchinson                                           ,Not Adjusted,10443,11376,933,8.2
4571,2009,December,Hutchinson                                           ,Not Adjusted,10239,11054,815,7.4
4572,2009,March,Irion                                                ,Not Adjusted,877,924,47,5.1
4573,2009,June,Irion                                                ,Not Adjusted,870,932,62,6.7
4574,2009,September,Irion                                                ,Not Adjusted,872,923,51,5.5
4575,2009,December,Irion                                                ,Not Adjusted,885,926,41,4.4
4576,2009,March,Jack                                                 ,Not Adjusted,5060,5344,284,5.3
4577,2009,June,Jack                                                 ,Not Adjusted,4927,5323,396,7.4
4578,2009,September,Jack                                                 ,Not Adjusted,4859,5230,371,7.1
4579,2009,December,Jack                                                 ,Not Adjusted,4882,5217,335,6.4
4580,2009,March,Jackson                                              ,Not Adjusted,6407,6858,451,6.6
4581,2009,June,Jackson                                              ,Not Adjusted,6584,7199,615,8.5
4582,2009,September,Jackson                                              ,Not Adjusted,6353,6899,546,7.9
4583,2009,December,Jackson                                              ,Not Adjusted,6348,6840,492,7.2
4584,2009,March,Jasper                                               ,Not Adjusted,14486,15786,1300,8.2
4585,2009,June,Jasper                                               ,Not Adjusted,14521,16262,1741,10.7
4586,2009,September,Jasper                                               ,Not Adjusted,14258,16140,1882,11.7
4587,2009,December,Jasper                                               ,Not Adjusted,14120,15964,1844,11.6
4588,2009,March,Jeff Davis                                           ,Not Adjusted,1116,1165,49,4.2
4589,2009,June,Jeff Davis                                           ,Not Adjusted,1204,1270,66,5.2
4590,2009,September,Jeff Davis                                           ,Not Adjusted,1183,1252,69,5.5
4591,2009,December,Jeff Davis                                           ,Not Adjusted,1119,1174,55,4.7
4592,2009,March,Jefferson                                            ,Not Adjusted,105987,115513,9526,8.2
4593,2009,June,Jefferson                                            ,Not Adjusted,104093,115957,11864,10.2
4594,2009,September,Jefferson                                            ,Not Adjusted,103396,115471,12075,10.5
4595,2009,December,Jefferson                                            ,Not Adjusted,104163,116249,12086,10.4
4596,2009,March,Jim Hogg                                             ,Not Adjusted,2730,2900,170,5.9
4597,2009,June,Jim Hogg                                             ,Not Adjusted,2788,3060,272,8.9
4598,2009,September,Jim Hogg                                             ,Not Adjusted,2834,3114,280,9.0
4599,2009,December,Jim Hogg                                             ,Not Adjusted,2794,3039,245,8.1
4600,2009,March,Jim Wells                                            ,Not Adjusted,20121,21619,1498,6.9
4601,2009,June,Jim Wells                                            ,Not Adjusted,19752,22153,2401,10.8
4602,2009,September,Jim Wells                                            ,Not Adjusted,19284,21567,2283,10.6
4603,2009,December,Jim Wells                                            ,Not Adjusted,19436,21469,2033,9.5
4604,2009,March,Johnson                                              ,Not Adjusted,68768,73793,5025,6.8
4605,2009,June,Johnson                                              ,Not Adjusted,68969,76092,7123,9.4
4606,2009,September,Johnson                                              ,Not Adjusted,68785,75762,6977,9.2
4607,2009,December,Johnson                                              ,Not Adjusted,69058,75510,6452,8.5
4608,2009,March,Jones                                                ,Not Adjusted,7131,7679,548,7.1
4609,2009,June,Jones                                                ,Not Adjusted,7196,7902,706,8.9
4610,2009,September,Jones                                                ,Not Adjusted,7227,7899,672,8.5
4611,2009,December,Jones                                                ,Not Adjusted,7180,7762,582,7.5
4612,2009,March,Karnes                                               ,Not Adjusted,4968,5371,403,7.5
4613,2009,June,Karnes                                               ,Not Adjusted,5081,5636,555,9.8
4614,2009,September,Karnes                                               ,Not Adjusted,4920,5486,566,10.3
4615,2009,December,Karnes                                               ,Not Adjusted,4993,5526,533,9.6
4616,2009,March,Kaufman                                              ,Not Adjusted,42801,46082,3281,7.1
4617,2009,June,Kaufman                                              ,Not Adjusted,43054,47355,4301,9.1
4618,2009,September,Kaufman                                              ,Not Adjusted,43190,47428,4238,8.9
4619,2009,December,Kaufman                                              ,Not Adjusted,43277,47501,4224,8.9
4620,2009,March,Kendall                                              ,Not Adjusted,15667,16504,837,5.1
4621,2009,June,Kendall                                              ,Not Adjusted,15871,16983,1112,6.5
4622,2009,September,Kendall                                              ,Not Adjusted,15817,16870,1053,6.2
4623,2009,December,Kendall                                              ,Not Adjusted,15937,16859,922,5.5
4624,2009,March,Kenedy                                               ,Not Adjusted,221,230,9,3.9
4625,2009,June,Kenedy                                               ,Not Adjusted,222,237,15,6.3
4626,2009,September,Kenedy                                               ,Not Adjusted,218,232,14,6.0
4627,2009,December,Kenedy                                               ,Not Adjusted,223,240,17,7.1
4628,2009,March,Kent                                                 ,Not Adjusted,422,442,20,4.5
4629,2009,June,Kent                                                 ,Not Adjusted,477,507,30,5.9
4630,2009,September,Kent                                                 ,Not Adjusted,428,452,24,5.3
4631,2009,December,Kent                                                 ,Not Adjusted,446,468,22,4.7
4632,2009,March,Kerr                                                 ,Not Adjusted,21966,23144,1178,5.1
4633,2009,June,Kerr                                                 ,Not Adjusted,22599,24110,1511,6.3
4634,2009,September,Kerr                                                 ,Not Adjusted,21585,23069,1484,6.4
4635,2009,December,Kerr                                                 ,Not Adjusted,21677,23054,1377,6.0
4636,2009,March,Kimble                                               ,Not Adjusted,2018,2120,102,4.8
4637,2009,June,Kimble                                               ,Not Adjusted,2146,2270,124,5.5
4638,2009,September,Kimble                                               ,Not Adjusted,2016,2143,127,5.9
4639,2009,December,Kimble                                               ,Not Adjusted,1983,2096,113,5.4
4640,2009,March,King                                                 ,Not Adjusted,168,177,9,5.1
4641,2009,June,King                                                 ,Not Adjusted,213,225,12,5.3
4642,2009,September,King                                                 ,Not Adjusted,192,203,11,5.4
4643,2009,December,King                                                 ,Not Adjusted,183,192,9,4.7
4644,2009,March,Kinney                                               ,Not Adjusted,1285,1389,104,7.5
4645,2009,June,Kinney                                               ,Not Adjusted,1380,1493,113,7.6
4646,2009,September,Kinney                                               ,Not Adjusted,1329,1456,127,8.7
4647,2009,December,Kinney                                               ,Not Adjusted,1332,1457,125,8.6
4648,2009,March,Kleberg                                              ,Not Adjusted,15915,16869,954,5.7
4649,2009,June,Kleberg                                              ,Not Adjusted,15902,17280,1378,8.0
4650,2009,September,Kleberg                                              ,Not Adjusted,15688,16986,1298,7.6
4651,2009,December,Kleberg                                              ,Not Adjusted,16078,17244,1166,6.8
4652,2009,March,Knox                                                 ,Not Adjusted,1699,1800,101,5.6
4653,2009,June,Knox                                                 ,Not Adjusted,1807,1935,128,6.6
4654,2009,September,Knox                                                 ,Not Adjusted,1721,1834,113,6.2
4655,2009,December,Knox                                                 ,Not Adjusted,1687,1789,102,5.7
4656,2009,March,Lamar                                                ,Not Adjusted,21429,23022,1593,6.9
4657,2009,June,Lamar                                                ,Not Adjusted,21985,24013,2028,8.4
4658,2009,September,Lamar                                                ,Not Adjusted,22031,23996,1965,8.2
4659,2009,December,Lamar                                                ,Not Adjusted,21866,23807,1941,8.2
4660,2009,March,Lamb                                                 ,Not Adjusted,6540,6954,414,6.0
4661,2009,June,Lamb                                                 ,Not Adjusted,6918,7462,544,7.3
4662,2009,September,Lamb                                                 ,Not Adjusted,6490,6968,478,6.9
4663,2009,December,Lamb                                                 ,Not Adjusted,6419,6877,458,6.7
4664,2009,March,Lampasas                                             ,Not Adjusted,9773,10291,518,5.0
4665,2009,June,Lampasas                                             ,Not Adjusted,9930,10667,737,6.9
4666,2009,September,Lampasas                                             ,Not Adjusted,9998,10669,671,6.3
4667,2009,December,Lampasas                                             ,Not Adjusted,10020,10635,615,5.8
4668,2009,March,La Salle                                             ,Not Adjusted,2615,2865,250,8.7
4669,2009,June,La Salle                                             ,Not Adjusted,2631,2933,302,10.3
4670,2009,September,La Salle                                             ,Not Adjusted,2642,2932,290,9.9
4671,2009,December,La Salle                                             ,Not Adjusted,2749,3014,265,8.8
4672,2009,March,Lavaca                                               ,Not Adjusted,9435,9915,480,4.8
4673,2009,June,Lavaca                                               ,Not Adjusted,9606,10249,643,6.3
4674,2009,September,Lavaca                                               ,Not Adjusted,9413,10051,638,6.3
4675,2009,December,Lavaca                                               ,Not Adjusted,9382,9999,617,6.2
4676,2009,March,Lee                                                  ,Not Adjusted,8621,9155,534,5.8
4677,2009,June,Lee                                                  ,Not Adjusted,8700,9425,725,7.7
4678,2009,September,Lee                                                  ,Not Adjusted,8390,9039,649,7.2
4679,2009,December,Lee                                                  ,Not Adjusted,8261,8860,599,6.8
4680,2009,March,Leon                                                 ,Not Adjusted,7941,8403,462,5.5
4681,2009,June,Leon                                                 ,Not Adjusted,8032,8667,635,7.3
4682,2009,September,Leon                                                 ,Not Adjusted,7546,8209,663,8.1
4683,2009,December,Leon                                                 ,Not Adjusted,7209,7848,639,8.1
4684,2009,March,Liberty                                              ,Not Adjusted,28335,30884,2549,8.3
4685,2009,June,Liberty                                              ,Not Adjusted,28329,31880,3551,11.1
4686,2009,September,Liberty                                              ,Not Adjusted,28259,31838,3579,11.2
4687,2009,December,Liberty                                              ,Not Adjusted,28324,31869,3545,11.1
4688,2009,March,Limestone                                            ,Not Adjusted,10520,11100,580,5.2
4689,2009,June,Limestone                                            ,Not Adjusted,10708,11482,774,6.7
4690,2009,September,Limestone                                            ,Not Adjusted,10401,11210,809,7.2
4691,2009,December,Limestone                                            ,Not Adjusted,10551,11312,761,6.7
4692,2009,March,Lipscomb                                             ,Not Adjusted,1628,1729,101,5.8
4693,2009,June,Lipscomb                                             ,Not Adjusted,1700,1846,146,7.9
4694,2009,September,Lipscomb                                             ,Not Adjusted,1615,1740,125,7.2
4695,2009,December,Lipscomb                                             ,Not Adjusted,1636,1747,111,6.4
4696,2009,March,Live Oak                                             ,Not Adjusted,4783,5106,323,6.3
4697,2009,June,Live Oak                                             ,Not Adjusted,4903,5329,426,8.0
4698,2009,September,Live Oak                                             ,Not Adjusted,4911,5302,391,7.4
4699,2009,December,Live Oak                                             ,Not Adjusted,4830,5190,360,6.9
4700,2009,March,Llano                                                ,Not Adjusted,7898,8421,523,6.2
4701,2009,June,Llano                                                ,Not Adjusted,8253,8901,648,7.3
4702,2009,September,Llano                                                ,Not Adjusted,7891,8530,639,7.5
4703,2009,December,Llano                                                ,Not Adjusted,7791,8433,642,7.6
4704,2009,March,Loving                                               ,Not Adjusted,37,40,3,7.5
4705,2009,June,Loving                                               ,Not Adjusted,37,41,4,9.8
4706,2009,September,Loving                                               ,Not Adjusted,38,43,5,11.6
4707,2009,December,Loving                                               ,Not Adjusted,46,49,3,6.1
4708,2009,March,Lubbock                                              ,Not Adjusted,133812,140007,6195,4.4
4709,2009,June,Lubbock                                              ,Not Adjusted,133246,142514,9268,6.5
4710,2009,September,Lubbock                                              ,Not Adjusted,135933,144520,8587,5.9
4711,2009,December,Lubbock                                              ,Not Adjusted,135896,143827,7931,5.5
4712,2009,March,Lynn                                                 ,Not Adjusted,2660,2820,160,5.7
4713,2009,June,Lynn                                                 ,Not Adjusted,2867,3055,188,6.2
4714,2009,September,Lynn                                                 ,Not Adjusted,2649,2840,191,6.7
4715,2009,December,Lynn                                                 ,Not Adjusted,2675,2850,175,6.1
4716,2009,March,McCulloch                                            ,Not Adjusted,3728,3982,254,6.4
4717,2009,June,McCulloch                                            ,Not Adjusted,3637,4034,397,9.8
4718,2009,September,McCulloch                                            ,Not Adjusted,3546,3929,383,9.7
4719,2009,December,McCulloch                                            ,Not Adjusted,3624,3901,277,7.1
4720,2009,March,McLennan                                             ,Not Adjusted,104746,111310,6564,5.9
4721,2009,June,McLennan                                             ,Not Adjusted,106838,115646,8808,7.6
4722,2009,September,McLennan                                             ,Not Adjusted,107274,115767,8493,7.3
4723,2009,December,McLennan                                             ,Not Adjusted,106768,114791,8023,7.0
4724,2009,March,McMullen                                             ,Not Adjusted,332,355,23,6.5
4725,2009,June,McMullen                                             ,Not Adjusted,357,387,30,7.8
4726,2009,September,McMullen                                             ,Not Adjusted,337,363,26,7.2
4727,2009,December,McMullen                                             ,Not Adjusted,340,362,22,6.1
4728,2009,March,Madison                                              ,Not Adjusted,4824,5141,317,6.2
4729,2009,June,Madison                                              ,Not Adjusted,5144,5603,459,8.2
4730,2009,September,Madison                                              ,Not Adjusted,5001,5446,445,8.2
4731,2009,December,Madison                                              ,Not Adjusted,4920,5345,425,8.0
4732,2009,March,Marion                                               ,Not Adjusted,4681,5083,402,7.9
4733,2009,June,Marion                                               ,Not Adjusted,4607,5226,619,11.8
4734,2009,September,Marion                                               ,Not Adjusted,4645,5255,610,11.6
4735,2009,December,Marion                                               ,Not Adjusted,4551,5153,602,11.7
4736,2009,March,Martin                                               ,Not Adjusted,2139,2234,95,4.3
4737,2009,June,Martin                                               ,Not Adjusted,2256,2381,125,5.2
4738,2009,September,Martin                                               ,Not Adjusted,2096,2218,122,5.5
4739,2009,December,Martin                                               ,Not Adjusted,2061,2166,105,4.8
4740,2009,March,Mason                                                ,Not Adjusted,2276,2369,93,3.9
4741,2009,June,Mason                                                ,Not Adjusted,2425,2576,151,5.9
4742,2009,September,Mason                                                ,Not Adjusted,2193,2328,135,5.8
4743,2009,December,Mason                                                ,Not Adjusted,2251,2373,122,5.1
4744,2009,March,Matagorda                                            ,Not Adjusted,15941,17354,1413,8.1
4745,2009,June,Matagorda                                            ,Not Adjusted,16297,18319,2022,11.0
4746,2009,September,Matagorda                                            ,Not Adjusted,16471,18408,1937,10.5
4747,2009,December,Matagorda                                            ,Not Adjusted,15932,17977,2045,11.4
4748,2009,March,Maverick                                             ,Not Adjusted,19157,22415,3258,14.5
4749,2009,June,Maverick                                             ,Not Adjusted,19780,23285,3505,15.1
4750,2009,September,Maverick                                             ,Not Adjusted,19609,22592,2983,13.2
4751,2009,December,Maverick                                             ,Not Adjusted,19984,23447,3463,14.8
4752,2009,March,Medina                                               ,Not Adjusted,18436,19557,1121,5.7
4753,2009,June,Medina                                               ,Not Adjusted,18676,20148,1472,7.3
4754,2009,September,Medina                                               ,Not Adjusted,18610,20095,1485,7.4
4755,2009,December,Medina                                               ,Not Adjusted,18754,20195,1441,7.1
4756,2009,March,Menard                                               ,Not Adjusted,1053,1108,55,5.0
4757,2009,June,Menard                                               ,Not Adjusted,1072,1165,93,8.0
4758,2009,September,Menard                                               ,Not Adjusted,1006,1097,91,8.3
4759,2009,December,Menard                                               ,Not Adjusted,987,1057,70,6.6
4760,2009,March,Midland                                              ,Not Adjusted,71567,74851,3284,4.4
4761,2009,June,Midland                                              ,Not Adjusted,70194,75292,5098,6.8
4762,2009,September,Midland                                              ,Not Adjusted,70446,75332,4886,6.5
4763,2009,December,Midland                                              ,Not Adjusted,70914,75141,4227,5.6
4764,2009,March,Milam                                                ,Not Adjusted,10209,11387,1178,10.3
4765,2009,June,Milam                                                ,Not Adjusted,10324,11717,1393,11.9
4766,2009,September,Milam                                                ,Not Adjusted,10175,11426,1251,10.9
4767,2009,December,Milam                                                ,Not Adjusted,10166,11418,1252,11.0
4768,2009,March,Mills                                                ,Not Adjusted,2301,2420,119,4.9
4769,2009,June,Mills                                                ,Not Adjusted,2412,2566,154,6.0
4770,2009,September,Mills                                                ,Not Adjusted,2328,2470,142,5.7
4771,2009,December,Mills                                                ,Not Adjusted,2271,2399,128,5.3
4772,2009,March,Mitchell                                             ,Not Adjusted,3123,3390,267,7.9
4773,2009,June,Mitchell                                             ,Not Adjusted,3266,3613,347,9.6
4774,2009,September,Mitchell                                             ,Not Adjusted,3222,3534,312,8.8
4775,2009,December,Mitchell                                             ,Not Adjusted,3245,3522,277,7.9
4776,2009,March,Montague                                             ,Not Adjusted,10113,10696,583,5.5
4777,2009,June,Montague                                             ,Not Adjusted,10064,10970,906,8.3
4778,2009,September,Montague                                             ,Not Adjusted,9854,10728,874,8.1
4779,2009,December,Montague                                             ,Not Adjusted,9685,10484,799,7.6
4780,2009,March,Montgomery                                           ,Not Adjusted,205527,218153,12626,5.8
4781,2009,June,Montgomery                                           ,Not Adjusted,205481,222445,16964,7.6
4782,2009,September,Montgomery                                           ,Not Adjusted,204972,222340,17368,7.8
4783,2009,December,Montgomery                                           ,Not Adjusted,205451,221925,16474,7.4
4784,2009,March,Moore                                                ,Not Adjusted,10670,11110,440,4.0
4785,2009,June,Moore                                                ,Not Adjusted,11184,11776,592,5.0
4786,2009,September,Moore                                                ,Not Adjusted,11158,11790,632,5.4
4787,2009,December,Moore                                                ,Not Adjusted,10950,11532,582,5.0
4788,2009,March,Morris                                               ,Not Adjusted,5186,5990,804,13.4
4789,2009,June,Morris                                               ,Not Adjusted,5198,6260,1062,17.0
4790,2009,September,Morris                                               ,Not Adjusted,5088,6092,1004,16.5
4791,2009,December,Morris                                               ,Not Adjusted,5147,6042,895,14.8
4792,2009,March,Motley                                               ,Not Adjusted,618,647,29,4.5
4793,2009,June,Motley                                               ,Not Adjusted,695,737,42,5.7
4794,2009,September,Motley                                               ,Not Adjusted,631,676,45,6.7
4795,2009,December,Motley                                               ,Not Adjusted,646,683,37,5.4
4796,2009,March,Nacogdoches                                          ,Not Adjusted,30360,32067,1707,5.3
4797,2009,June,Nacogdoches                                          ,Not Adjusted,29807,32289,2482,7.7
4798,2009,September,Nacogdoches                                          ,Not Adjusted,30204,32575,2371,7.3
4799,2009,December,Nacogdoches                                          ,Not Adjusted,29714,31806,2092,6.6
4800,2009,March,Navarro                                              ,Not Adjusted,19288,20763,1475,7.1
4801,2009,June,Navarro                                              ,Not Adjusted,19557,21414,1857,8.7
4802,2009,September,Navarro                                              ,Not Adjusted,19969,21810,1841,8.4
4803,2009,December,Navarro                                              ,Not Adjusted,19951,21742,1791,8.2
4804,2009,March,Newton                                               ,Not Adjusted,5285,5864,579,9.9
4805,2009,June,Newton                                               ,Not Adjusted,5322,6068,746,12.3
4806,2009,September,Newton                                               ,Not Adjusted,5109,5872,763,13.0
4807,2009,December,Newton                                               ,Not Adjusted,5053,5803,750,12.9
4808,2009,March,Nolan                                                ,Not Adjusted,7345,7778,433,5.6
4809,2009,June,Nolan                                                ,Not Adjusted,7461,8040,579,7.2
4810,2009,September,Nolan                                                ,Not Adjusted,7398,7918,520,6.6
4811,2009,December,Nolan                                                ,Not Adjusted,7321,7868,547,7.0
4812,2009,March,Nueces                                               ,Not Adjusted,155753,165121,9368,5.7
4813,2009,June,Nueces                                               ,Not Adjusted,154007,166876,12869,7.7
4814,2009,September,Nueces                                               ,Not Adjusted,154312,166817,12505,7.5
4815,2009,December,Nueces                                               ,Not Adjusted,154524,166413,11889,7.1
4816,2009,March,Ochiltree                                            ,Not Adjusted,5257,5524,267,4.8
4817,2009,June,Ochiltree                                            ,Not Adjusted,5316,5729,413,7.2
4818,2009,September,Ochiltree                                            ,Not Adjusted,5039,5429,390,7.2
4819,2009,December,Ochiltree                                            ,Not Adjusted,5007,5326,319,6.0
4820,2009,March,Oldham                                               ,Not Adjusted,856,902,46,5.1
4821,2009,June,Oldham                                               ,Not Adjusted,925,988,63,6.4
4822,2009,September,Oldham                                               ,Not Adjusted,858,916,58,6.3
4823,2009,December,Oldham                                               ,Not Adjusted,844,894,50,5.6
4824,2009,March,Orange                                               ,Not Adjusted,37884,41439,3555,8.6
4825,2009,June,Orange                                               ,Not Adjusted,37207,41660,4453,10.7
4826,2009,September,Orange                                               ,Not Adjusted,36958,41463,4505,10.9
4827,2009,December,Orange                                               ,Not Adjusted,37233,41560,4327,10.4
4828,2009,March,Palo Pinto                                           ,Not Adjusted,13258,14129,871,6.2
4829,2009,June,Palo Pinto                                           ,Not Adjusted,13289,14516,1227,8.5
4830,2009,September,Palo Pinto                                           ,Not Adjusted,13025,14347,1322,9.2
4831,2009,December,Palo Pinto                                           ,Not Adjusted,12879,14075,1196,8.5
4832,2009,March,Panola                                               ,Not Adjusted,12389,13203,814,6.2
4833,2009,June,Panola                                               ,Not Adjusted,12291,13328,1037,7.8
4834,2009,September,Panola                                               ,Not Adjusted,12012,13101,1089,8.3
4835,2009,December,Panola                                               ,Not Adjusted,12165,13234,1069,8.1
4836,2009,March,Parker                                               ,Not Adjusted,50448,53935,3487,6.5
4837,2009,June,Parker                                               ,Not Adjusted,50594,55332,4738,8.6
4838,2009,September,Parker                                               ,Not Adjusted,50459,55159,4700,8.5
4839,2009,December,Parker                                               ,Not Adjusted,50659,54925,4266,7.8
4840,2009,March,Parmer                                               ,Not Adjusted,4347,4514,167,3.7
4841,2009,June,Parmer                                               ,Not Adjusted,4630,4878,248,5.1
4842,2009,September,Parmer                                               ,Not Adjusted,4425,4655,230,4.9
4843,2009,December,Parmer                                               ,Not Adjusted,4386,4595,209,4.5
4844,2009,March,Pecos                                                ,Not Adjusted,7624,8282,658,7.9
4845,2009,June,Pecos                                                ,Not Adjusted,7566,8449,883,10.5
4846,2009,September,Pecos                                                ,Not Adjusted,7602,8399,797,9.5
4847,2009,December,Pecos                                                ,Not Adjusted,7911,8592,681,7.9
4848,2009,March,Polk                                                 ,Not Adjusted,16249,17602,1353,7.7
4849,2009,June,Polk                                                 ,Not Adjusted,16537,18329,1792,9.8
4850,2009,September,Polk                                                 ,Not Adjusted,16488,18322,1834,10.0
4851,2009,December,Polk                                                 ,Not Adjusted,16362,18153,1791,9.9
4852,2009,March,Potter                                               ,Not Adjusted,53505,56345,2840,5.0
4853,2009,June,Potter                                               ,Not Adjusted,54295,58354,4059,7.0
4854,2009,September,Potter                                               ,Not Adjusted,54339,58247,3908,6.7
4855,2009,December,Potter                                               ,Not Adjusted,54415,58037,3622,6.2
4856,2009,March,Presidio                                             ,Not Adjusted,2954,3468,514,14.8
4857,2009,June,Presidio                                             ,Not Adjusted,3219,3898,679,17.4
4858,2009,September,Presidio                                             ,Not Adjusted,3303,3941,638,16.2
4859,2009,December,Presidio                                             ,Not Adjusted,3217,3899,682,17.5
4860,2009,March,Rains                                                ,Not Adjusted,4820,5160,340,6.6
4861,2009,June,Rains                                                ,Not Adjusted,4701,5160,459,8.9
4862,2009,September,Rains                                                ,Not Adjusted,4682,5129,447,8.7
4863,2009,December,Rains                                                ,Not Adjusted,4610,5063,453,8.9
4864,2009,March,Randall                                              ,Not Adjusted,65178,67798,2620,3.9
4865,2009,June,Randall                                              ,Not Adjusted,66139,69863,3724,5.3
4866,2009,September,Randall                                              ,Not Adjusted,66196,69888,3692,5.3
4867,2009,December,Randall                                              ,Not Adjusted,66286,69501,3215,4.6
4868,2009,March,Reagan                                               ,Not Adjusted,2088,2196,108,4.9
4869,2009,June,Reagan                                               ,Not Adjusted,1936,2119,183,8.6
4870,2009,September,Reagan                                               ,Not Adjusted,1987,2147,160,7.5
4871,2009,December,Reagan                                               ,Not Adjusted,2225,2352,127,5.4
4872,2009,March,Real                                                 ,Not Adjusted,1386,1450,64,4.4
4873,2009,June,Real                                                 ,Not Adjusted,1567,1680,113,6.7
4874,2009,September,Real                                                 ,Not Adjusted,1468,1565,97,6.2
4875,2009,December,Real                                                 ,Not Adjusted,1411,1494,83,5.6
4876,2009,March,Red River                                            ,Not Adjusted,5459,5928,469,7.9
4877,2009,June,Red River                                            ,Not Adjusted,5656,6224,568,9.1
4878,2009,September,Red River                                            ,Not Adjusted,5477,6107,630,10.3
4879,2009,December,Red River                                            ,Not Adjusted,5372,5976,604,10.1
4880,2009,March,Reeves                                               ,Not Adjusted,4156,4597,441,9.6
4881,2009,June,Reeves                                               ,Not Adjusted,4273,4914,641,13.0
4882,2009,September,Reeves                                               ,Not Adjusted,4163,4776,613,12.8
4883,2009,December,Reeves                                               ,Not Adjusted,4137,4732,595,12.6
4884,2009,March,Refugio                                              ,Not Adjusted,3884,4093,209,5.1
4885,2009,June,Refugio                                              ,Not Adjusted,3974,4284,310,7.2
4886,2009,September,Refugio                                              ,Not Adjusted,3863,4163,300,7.2
4887,2009,December,Refugio                                              ,Not Adjusted,3838,4141,303,7.3
4888,2009,March,Roberts                                              ,Not Adjusted,566,589,23,3.9
4889,2009,June,Roberts                                              ,Not Adjusted,568,599,31,5.2
4890,2009,September,Roberts                                              ,Not Adjusted,548,584,36,6.2
4891,2009,December,Roberts                                              ,Not Adjusted,535,561,26,4.6
4892,2009,March,Robertson                                            ,Not Adjusted,6697,7191,494,6.9
4893,2009,June,Robertson                                            ,Not Adjusted,6439,7056,617,8.7
4894,2009,September,Robertson                                            ,Not Adjusted,6772,7408,636,8.6
4895,2009,December,Robertson                                            ,Not Adjusted,6836,7444,608,8.2
4896,2009,March,Rockwall                                             ,Not Adjusted,36341,38775,2434,6.3
4897,2009,June,Rockwall                                             ,Not Adjusted,36557,39675,3118,7.9
4898,2009,September,Rockwall                                             ,Not Adjusted,36669,39789,3120,7.8
4899,2009,December,Rockwall                                             ,Not Adjusted,36744,39751,3007,7.6
4900,2009,March,Runnels                                              ,Not Adjusted,4240,4485,245,5.5
4901,2009,June,Runnels                                              ,Not Adjusted,4369,4737,368,7.8
4902,2009,September,Runnels                                              ,Not Adjusted,4124,4589,465,10.1
4903,2009,December,Runnels                                              ,Not Adjusted,4198,4580,382,8.3
4904,2009,March,Rusk                                                 ,Not Adjusted,22572,24078,1506,6.3
4905,2009,June,Rusk                                                 ,Not Adjusted,22482,24604,2122,8.6
4906,2009,September,Rusk                                                 ,Not Adjusted,22183,24411,2228,9.1
4907,2009,December,Rusk                                                 ,Not Adjusted,22286,24387,2101,8.6
4908,2009,March,Sabine                                               ,Not Adjusted,3021,3458,437,12.6
4909,2009,June,Sabine                                               ,Not Adjusted,3109,3690,581,15.7
4910,2009,September,Sabine                                               ,Not Adjusted,2975,3549,574,16.2
4911,2009,December,Sabine                                               ,Not Adjusted,2919,3543,624,17.6
4912,2009,March,San Augustine                                        ,Not Adjusted,3216,3519,303,8.6
4913,2009,June,San Augustine                                        ,Not Adjusted,3332,3739,407,10.9
4914,2009,September,San Augustine                                        ,Not Adjusted,3251,3634,383,10.5
4915,2009,December,San Augustine                                        ,Not Adjusted,3230,3636,406,11.2
4916,2009,March,San Jacinto                                          ,Not Adjusted,9221,9955,734,7.4
4917,2009,June,San Jacinto                                          ,Not Adjusted,9218,10259,1041,10.1
4918,2009,September,San Jacinto                                          ,Not Adjusted,9195,10235,1040,10.2
4919,2009,December,San Jacinto                                          ,Not Adjusted,9217,10345,1128,10.9
4920,2009,March,San Patricio                                         ,Not Adjusted,28245,30328,2083,6.9
4921,2009,June,San Patricio                                         ,Not Adjusted,27930,30894,2964,9.6
4922,2009,September,San Patricio                                         ,Not Adjusted,27985,30945,2960,9.6
4923,2009,December,San Patricio                                         ,Not Adjusted,28023,31154,3131,10.1
4924,2009,March,San Saba                                             ,Not Adjusted,2264,2414,150,6.2
4925,2009,June,San Saba                                             ,Not Adjusted,2368,2578,210,8.1
4926,2009,September,San Saba                                             ,Not Adjusted,2264,2463,199,8.1
4927,2009,December,San Saba                                             ,Not Adjusted,2300,2483,183,7.4
4928,2009,March,Schleicher                                           ,Not Adjusted,1410,1529,119,7.8
4929,2009,June,Schleicher                                           ,Not Adjusted,1394,1579,185,11.7
4930,2009,September,Schleicher                                           ,Not Adjusted,1279,1441,162,11.2
4931,2009,December,Schleicher                                           ,Not Adjusted,1328,1468,140,9.5
4932,2009,March,Scurry                                               ,Not Adjusted,7342,7753,411,5.3
4933,2009,June,Scurry                                               ,Not Adjusted,7288,7963,675,8.5
4934,2009,September,Scurry                                               ,Not Adjusted,7127,7727,600,7.8
4935,2009,December,Scurry                                               ,Not Adjusted,7186,7702,516,6.7
4936,2009,March,Shackelford                                          ,Not Adjusted,2007,2080,73,3.5
4937,2009,June,Shackelford                                          ,Not Adjusted,2098,2192,94,4.3
4938,2009,September,Shackelford                                          ,Not Adjusted,2017,2115,98,4.6
4939,2009,December,Shackelford                                          ,Not Adjusted,2050,2148,98,4.6
4940,2009,March,Shelby                                               ,Not Adjusted,11606,12339,733,5.9
4941,2009,June,Shelby                                               ,Not Adjusted,11857,12898,1041,8.1
4942,2009,September,Shelby                                               ,Not Adjusted,11739,12788,1049,8.2
4943,2009,December,Shelby                                               ,Not Adjusted,11652,12662,1010,8.0
4944,2009,March,Sherman                                              ,Not Adjusted,1357,1410,53,3.8
4945,2009,June,Sherman                                              ,Not Adjusted,1490,1564,74,4.7
4946,2009,September,Sherman                                              ,Not Adjusted,1360,1431,71,5.0
4947,2009,December,Sherman                                              ,Not Adjusted,1329,1396,67,4.8
4948,2009,March,Smith                                                ,Not Adjusted,92424,98865,6441,6.5
4949,2009,June,Smith                                                ,Not Adjusted,93204,101709,8505,8.4
4950,2009,September,Smith                                                ,Not Adjusted,93223,101714,8491,8.3
4951,2009,December,Smith                                                ,Not Adjusted,93862,101971,8109,8.0
4952,2009,March,Somervell                                            ,Not Adjusted,3956,4203,247,5.9
4953,2009,June,Somervell                                            ,Not Adjusted,3987,4366,379,8.7
4954,2009,September,Somervell                                            ,Not Adjusted,3913,4244,331,7.8
4955,2009,December,Somervell                                            ,Not Adjusted,3867,4148,281,6.8
4956,2009,March,Starr                                                ,Not Adjusted,20229,23815,3586,15.1
4957,2009,June,Starr                                                ,Not Adjusted,20639,24816,4177,16.8
4958,2009,September,Starr                                                ,Not Adjusted,20162,24270,4108,16.9
4959,2009,December,Starr                                                ,Not Adjusted,20622,25523,4901,19.2
4960,2009,March,Stephens                                             ,Not Adjusted,4398,4651,253,5.4
4961,2009,June,Stephens                                             ,Not Adjusted,4392,4748,356,7.5
4962,2009,September,Stephens                                             ,Not Adjusted,4295,4648,353,7.6
4963,2009,December,Stephens                                             ,Not Adjusted,4209,4543,334,7.4
4964,2009,March,Sterling                                             ,Not Adjusted,814,843,29,3.4
4965,2009,June,Sterling                                             ,Not Adjusted,875,915,40,4.4
4966,2009,September,Sterling                                             ,Not Adjusted,811,850,39,4.6
4967,2009,December,Sterling                                             ,Not Adjusted,784,825,41,5.0
4968,2009,March,Stonewall                                            ,Not Adjusted,794,823,29,3.5
4969,2009,June,Stonewall                                            ,Not Adjusted,883,926,43,4.6
4970,2009,September,Stonewall                                            ,Not Adjusted,839,875,36,4.1
4971,2009,December,Stonewall                                            ,Not Adjusted,756,790,34,4.3
4972,2009,March,Sutton                                               ,Not Adjusted,3407,3567,160,4.5
4973,2009,June,Sutton                                               ,Not Adjusted,3333,3637,304,8.4
4974,2009,September,Sutton                                               ,Not Adjusted,3059,3371,312,9.3
4975,2009,December,Sutton                                               ,Not Adjusted,2824,3097,273,8.8
4976,2009,March,Swisher                                              ,Not Adjusted,3434,3601,167,4.6
4977,2009,June,Swisher                                              ,Not Adjusted,3593,3840,247,6.4
4978,2009,September,Swisher                                              ,Not Adjusted,3437,3680,243,6.6
4979,2009,December,Swisher                                              ,Not Adjusted,3372,3584,212,5.9
4980,2009,March,Tarrant                                              ,Not Adjusted,827064,885751,58687,6.6
4981,2009,June,Tarrant                                              ,Not Adjusted,829469,908079,78610,8.7
4982,2009,September,Tarrant                                              ,Not Adjusted,827261,902915,75654,8.4
4983,2009,December,Tarrant                                              ,Not Adjusted,830533,902910,72377,8.0
4984,2009,March,Taylor                                               ,Not Adjusted,63658,66903,3245,4.9
4985,2009,June,Taylor                                               ,Not Adjusted,64248,68655,4407,6.4
4986,2009,September,Taylor                                               ,Not Adjusted,64523,68774,4251,6.2
4987,2009,December,Taylor                                               ,Not Adjusted,64102,68120,4018,5.9
4988,2009,March,Terrell                                              ,Not Adjusted,320,357,37,10.4
4989,2009,June,Terrell                                              ,Not Adjusted,381,419,38,9.1
4990,2009,September,Terrell                                              ,Not Adjusted,357,387,30,7.8
4991,2009,December,Terrell                                              ,Not Adjusted,334,363,29,8.0
4992,2009,March,Terry                                                ,Not Adjusted,5639,6017,378,6.3
4993,2009,June,Terry                                                ,Not Adjusted,5862,6357,495,7.8
4994,2009,September,Terry                                                ,Not Adjusted,5435,5881,446,7.6
4995,2009,December,Terry                                                ,Not Adjusted,5438,5850,412,7.0
4996,2009,March,Throckmorton                                         ,Not Adjusted,972,1019,47,4.6
4997,2009,June,Throckmorton                                         ,Not Adjusted,1011,1066,55,5.2
4998,2009,September,Throckmorton                                         ,Not Adjusted,978,1031,53,5.1
4999,2009,December,Throckmorton                                         ,Not Adjusted,996,1048,52,5.0
5000,2009,March,Titus                                                ,Not Adjusted,13199,14102,903,6.4
5001,2009,June,Titus                                                ,Not Adjusted,13428,14600,1172,8.0
5002,2009,September,Titus                                                ,Not Adjusted,13375,14516,1141,7.9
5003,2009,December,Titus                                                ,Not Adjusted,13379,14448,1069,7.4
5004,2009,March,Tom Green                                            ,Not Adjusted,49677,52535,2858,5.4
5005,2009,June,Tom Green                                            ,Not Adjusted,49350,53184,3834,7.2
5006,2009,September,Tom Green                                            ,Not Adjusted,49433,53196,3763,7.1
5007,2009,December,Tom Green                                            ,Not Adjusted,50116,53464,3348,6.3
5008,2009,March,Travis                                               ,Not Adjusted,507209,539119,31910,5.9
5009,2009,June,Travis                                               ,Not Adjusted,512312,552798,40486,7.3
5010,2009,September,Travis                                               ,Not Adjusted,513892,553827,39935,7.2
5011,2009,December,Travis                                               ,Not Adjusted,515593,553259,37666,6.8
5012,2009,March,Trinity                                              ,Not Adjusted,5354,5799,445,7.7
5013,2009,June,Trinity                                              ,Not Adjusted,5558,6126,568,9.3
5014,2009,September,Trinity                                              ,Not Adjusted,5431,5975,544,9.1
5015,2009,December,Trinity                                              ,Not Adjusted,5365,5903,538,9.1
5016,2009,March,Tyler                                                ,Not Adjusted,7627,8319,692,8.3
5017,2009,June,Tyler                                                ,Not Adjusted,7842,8774,932,10.6
5018,2009,September,Tyler                                                ,Not Adjusted,7594,8503,909,10.7
5019,2009,December,Tyler                                                ,Not Adjusted,7511,8386,875,10.4
5020,2009,March,Upshur                                               ,Not Adjusted,18320,19590,1270,6.5
5021,2009,June,Upshur                                               ,Not Adjusted,18249,19968,1719,8.6
5022,2009,September,Upshur                                               ,Not Adjusted,18004,19622,1618,8.2
5023,2009,December,Upshur                                               ,Not Adjusted,18090,19589,1499,7.7
5024,2009,March,Upton                                                ,Not Adjusted,1741,1827,86,4.7
5025,2009,June,Upton                                                ,Not Adjusted,1716,1831,115,6.3
5026,2009,September,Upton                                                ,Not Adjusted,1695,1801,106,5.9
5027,2009,December,Upton                                                ,Not Adjusted,1738,1840,102,5.5
5028,2009,March,Uvalde                                               ,Not Adjusted,10343,11116,773,7.0
5029,2009,June,Uvalde                                               ,Not Adjusted,11129,12138,1009,8.3
5030,2009,September,Uvalde                                               ,Not Adjusted,10643,11675,1032,8.8
5031,2009,December,Uvalde                                               ,Not Adjusted,10729,11719,990,8.4
5032,2009,March,Val Verde                                            ,Not Adjusted,18765,20519,1754,8.5
5033,2009,June,Val Verde                                            ,Not Adjusted,19391,21632,2241,10.4
5034,2009,September,Val Verde                                            ,Not Adjusted,19264,21296,2032,9.5
5035,2009,December,Val Verde                                            ,Not Adjusted,19275,21291,2016,9.5
5036,2009,March,Van Zandt                                            ,Not Adjusted,23852,25352,1500,5.9
5037,2009,June,Van Zandt                                            ,Not Adjusted,24628,26678,2050,7.7
5038,2009,September,Van Zandt                                            ,Not Adjusted,24280,26296,2016,7.7
5039,2009,December,Van Zandt                                            ,Not Adjusted,24143,26062,1919,7.4
5040,2009,March,Victoria                                             ,Not Adjusted,42441,45048,2607,5.8
5041,2009,June,Victoria                                             ,Not Adjusted,42471,46023,3552,7.7
5042,2009,September,Victoria                                             ,Not Adjusted,42009,45588,3579,7.9
5043,2009,December,Victoria                                             ,Not Adjusted,42154,45517,3363,7.4
5044,2009,March,Walker                                               ,Not Adjusted,25430,27030,1600,5.9
5045,2009,June,Walker                                               ,Not Adjusted,26082,28379,2297,8.1
5046,2009,September,Walker                                               ,Not Adjusted,26157,28392,2235,7.9
5047,2009,December,Walker                                               ,Not Adjusted,25805,27770,1965,7.1
5048,2009,March,Waller                                               ,Not Adjusted,15123,16218,1095,6.8
5049,2009,June,Waller                                               ,Not Adjusted,15120,16668,1548,9.3
5050,2009,September,Waller                                               ,Not Adjusted,15084,16612,1528,9.2
5051,2009,December,Waller                                               ,Not Adjusted,15118,16602,1484,8.9
5052,2009,March,Ward                                                 ,Not Adjusted,4672,5023,351,7.0
5053,2009,June,Ward                                                 ,Not Adjusted,4631,5188,557,10.7
5054,2009,September,Ward                                                 ,Not Adjusted,4516,5008,492,9.8
5055,2009,December,Ward                                                 ,Not Adjusted,4494,4931,437,8.9
5056,2009,March,Washington                                           ,Not Adjusted,15959,16771,812,4.8
5057,2009,June,Washington                                           ,Not Adjusted,16181,17380,1199,6.9
5058,2009,September,Washington                                           ,Not Adjusted,15948,17122,1174,6.9
5059,2009,December,Washington                                           ,Not Adjusted,15894,17000,1106,6.5
5060,2009,March,Webb                                                 ,Not Adjusted,86646,93493,6847,7.3
5061,2009,June,Webb                                                 ,Not Adjusted,85476,94924,9448,10.0
5062,2009,September,Webb                                                 ,Not Adjusted,85612,94526,8914,9.4
5063,2009,December,Webb                                                 ,Not Adjusted,87179,95453,8274,8.7
5064,2009,March,Wharton                                              ,Not Adjusted,19707,20863,1156,5.5
5065,2009,June,Wharton                                              ,Not Adjusted,20320,21930,1610,7.3
5066,2009,September,Wharton                                              ,Not Adjusted,19642,21313,1671,7.8
5067,2009,December,Wharton                                              ,Not Adjusted,19486,21201,1715,8.1
5068,2009,March,Wheeler                                              ,Not Adjusted,3083,3223,140,4.3
5069,2009,June,Wheeler                                              ,Not Adjusted,3025,3248,223,6.9
5070,2009,September,Wheeler                                              ,Not Adjusted,2988,3203,215,6.7
5071,2009,December,Wheeler                                              ,Not Adjusted,2987,3172,185,5.8
5072,2009,March,Wichita                                              ,Not Adjusted,57400,61393,3993,6.5
5073,2009,June,Wichita                                              ,Not Adjusted,57157,62550,5393,8.6
5074,2009,September,Wichita                                              ,Not Adjusted,56427,61516,5089,8.3
5075,2009,December,Wichita                                              ,Not Adjusted,56359,61056,4697,7.7
5076,2009,March,Wilbarger                                            ,Not Adjusted,7526,7829,303,3.9
5077,2009,June,Wilbarger                                            ,Not Adjusted,7539,7957,418,5.3
5078,2009,September,Wilbarger                                            ,Not Adjusted,7546,7968,422,5.3
5079,2009,December,Wilbarger                                            ,Not Adjusted,7522,7917,395,5.0
5080,2009,March,Willacy                                              ,Not Adjusted,7211,8058,847,10.5
5081,2009,June,Willacy                                              ,Not Adjusted,7479,8599,1120,13.0
5082,2009,September,Willacy                                              ,Not Adjusted,7361,8478,1117,13.2
5083,2009,December,Willacy                                              ,Not Adjusted,7656,8752,1096,12.5
5084,2009,March,Williamson                                           ,Not Adjusted,193170,206664,13494,6.5
5085,2009,June,Williamson                                           ,Not Adjusted,195116,212279,17163,8.1
5086,2009,September,Williamson                                           ,Not Adjusted,195717,212410,16693,7.9
5087,2009,December,Williamson                                           ,Not Adjusted,196365,212314,15949,7.5
5088,2009,March,Wilson                                               ,Not Adjusted,17561,18640,1079,5.8
5089,2009,June,Wilson                                               ,Not Adjusted,17790,19226,1436,7.5
5090,2009,September,Wilson                                               ,Not Adjusted,17730,19088,1358,7.1
5091,2009,December,Wilson                                               ,Not Adjusted,17864,19129,1265,6.6
5092,2009,March,Winkler                                              ,Not Adjusted,3211,3500,289,8.3
5093,2009,June,Winkler                                              ,Not Adjusted,3086,3497,411,11.8
5094,2009,September,Winkler                                              ,Not Adjusted,3048,3383,335,9.9
5095,2009,December,Winkler                                              ,Not Adjusted,2999,3304,305,9.2
5096,2009,March,Wise                                                 ,Not Adjusted,25780,27783,2003,7.2
5097,2009,June,Wise                                                 ,Not Adjusted,25855,28781,2926,10.2
5098,2009,September,Wise                                                 ,Not Adjusted,25786,28582,2796,9.8
5099,2009,December,Wise                                                 ,Not Adjusted,25889,28391,2502,8.8
5100,2009,March,Wood                                                 ,Not Adjusted,17037,18317,1280,7.0
5101,2009,June,Wood                                                 ,Not Adjusted,17604,19268,1664,8.6
5102,2009,September,Wood                                                 ,Not Adjusted,17083,18714,1631,8.7
5103,2009,December,Wood                                                 ,Not Adjusted,16996,18567,1571,8.5
5104,2009,March,Yoakum                                               ,Not Adjusted,3837,4139,302,7.3
5105,2009,June,Yoakum                                               ,Not Adjusted,3892,4305,413,9.6
5106,2009,September,Yoakum                                               ,Not Adjusted,3756,4073,317,7.8
5107,2009,December,Yoakum                                               ,Not Adjusted,3715,3983,268,6.7
5108,2009,March,Young                                                ,Not Adjusted,9052,9595,543,5.7
5109,2009,June,Young                                                ,Not Adjusted,9252,9985,733,7.3
5110,2009,September,Young                                                ,Not Adjusted,8967,9648,681,7.1
5111,2009,December,Young                                                ,Not Adjusted,9032,9656,624,6.5
5112,2009,March,Zapata                                               ,Not Adjusted,4947,5402,455,8.4
5113,2009,June,Zapata                                               ,Not Adjusted,4729,5394,665,12.3
5114,2009,September,Zapata                                               ,Not Adjusted,4610,5310,700,13.2
5115,2009,December,Zapata                                               ,Not Adjusted,4694,5345,651,12.2
5116,2009,March,Zavala                                               ,Not Adjusted,3365,3858,493,12.8
5117,2009,June,Zavala                                               ,Not Adjusted,3496,4085,589,14.4
5118,2009,September,Zavala                                               ,Not Adjusted,3281,3881,600,15.5
5119,2009,December,Zavala                                               ,Not Adjusted,3440,4051,611,15.1
5120,2010,March,Texas,Not Adjusted,11142577,12151184,1008607,8.3
5121,2010,March,Texas,Adjusted,11184615,12191275,1006660,8.3
5122,2010,June,Texas,Not Adjusted,11242679,12274200,1031521,8.4
5123,2010,June,Texas,Adjusted,11267141,12259778,992637,8.1
5124,2010,September,Texas,Not Adjusted,11325377,12317178,991801,8.1
5125,2010,September,Texas,Adjusted,11306167,12306687,1000520,8.1
5126,2010,December,Texas,Not Adjusted,11372898,12355432,982534,8.0
5127,2010,December,Texas,Adjusted,11356570,12372836,1016266,8.2
5128,2010,March,Anderson                                             ,Not Adjusted,19675,21456,1781,8.3
5129,2010,June,Anderson                                             ,Not Adjusted,20027,21835,1808,8.3
5130,2010,September,Anderson                                             ,Not Adjusted,20157,21911,1754,8.0
5131,2010,December,Anderson                                             ,Not Adjusted,20224,21884,1660,7.6
5132,2010,March,Andrews                                              ,Not Adjusted,6459,6929,470,6.8
5133,2010,June,Andrews                                              ,Not Adjusted,6693,7152,459,6.4
5134,2010,September,Andrews                                              ,Not Adjusted,6959,7376,417,5.7
5135,2010,December,Andrews                                              ,Not Adjusted,6877,7272,395,5.4
5136,2010,March,Angelina                                             ,Not Adjusted,34337,37736,3399,9.0
5137,2010,June,Angelina                                             ,Not Adjusted,35110,38405,3295,8.6
5138,2010,September,Angelina                                             ,Not Adjusted,35217,38381,3164,8.2
5139,2010,December,Angelina                                             ,Not Adjusted,35032,38105,3073,8.1
5140,2010,March,Aransas                                              ,Not Adjusted,8873,9780,907,9.3
5141,2010,June,Aransas                                              ,Not Adjusted,8824,9729,905,9.3
5142,2010,September,Aransas                                              ,Not Adjusted,8789,9690,901,9.3
5143,2010,December,Aransas                                              ,Not Adjusted,8763,9671,908,9.4
5144,2010,March,Archer                                               ,Not Adjusted,4231,4538,307,6.8
5145,2010,June,Archer                                               ,Not Adjusted,4358,4691,333,7.1
5146,2010,September,Archer                                               ,Not Adjusted,4340,4635,295,6.4
5147,2010,December,Archer                                               ,Not Adjusted,4334,4604,270,5.9
5148,2010,March,Armstrong                                            ,Not Adjusted,946,999,53,5.3
5149,2010,June,Armstrong                                            ,Not Adjusted,971,1022,51,5.0
5150,2010,September,Armstrong                                            ,Not Adjusted,972,1022,50,4.9
5151,2010,December,Armstrong                                            ,Not Adjusted,972,1018,46,4.5
5152,2010,March,Atascosa                                             ,Not Adjusted,17898,19507,1609,8.2
5153,2010,June,Atascosa                                             ,Not Adjusted,18142,19824,1682,8.5
5154,2010,September,Atascosa                                             ,Not Adjusted,18116,19701,1585,8.0
5155,2010,December,Atascosa                                             ,Not Adjusted,18159,19733,1574,8.0
5156,2010,March,Austin                                               ,Not Adjusted,12655,13791,1136,8.2
5157,2010,June,Austin                                               ,Not Adjusted,12834,13995,1161,8.3
5158,2010,September,Austin                                               ,Not Adjusted,12920,13992,1072,7.7
5159,2010,December,Austin                                               ,Not Adjusted,12945,14049,1104,7.9
5160,2010,March,Bailey                                               ,Not Adjusted,2917,3194,277,8.7
5161,2010,June,Bailey                                               ,Not Adjusted,3142,3429,287,8.4
5162,2010,September,Bailey                                               ,Not Adjusted,3060,3299,239,7.2
5163,2010,December,Bailey                                               ,Not Adjusted,2978,3202,224,7.0
5164,2010,March,Bandera                                              ,Not Adjusted,8400,9122,722,7.9
5165,2010,June,Bandera                                              ,Not Adjusted,8513,9248,735,7.9
5166,2010,September,Bandera                                              ,Not Adjusted,8498,9204,706,7.7
5167,2010,December,Bandera                                              ,Not Adjusted,8527,9234,707,7.7
5168,2010,March,Bastrop                                              ,Not Adjusted,32049,34969,2920,8.4
5169,2010,June,Bastrop                                              ,Not Adjusted,32393,35459,3066,8.6
5170,2010,September,Bastrop                                              ,Not Adjusted,32591,35466,2875,8.1
5171,2010,December,Bastrop                                              ,Not Adjusted,32860,35785,2925,8.2
5172,2010,March,Baylor                                               ,Not Adjusted,1588,1716,128,7.5
5173,2010,June,Baylor                                               ,Not Adjusted,1651,1780,129,7.2
5174,2010,September,Baylor                                               ,Not Adjusted,1603,1716,113,6.6
5175,2010,December,Baylor                                               ,Not Adjusted,1631,1738,107,6.2
5176,2010,March,Bee                                                  ,Not Adjusted,9656,10580,924,8.7
5177,2010,June,Bee                                                  ,Not Adjusted,9657,10637,980,9.2
5178,2010,September,Bee                                                  ,Not Adjusted,9688,10644,956,9.0
5179,2010,December,Bee                                                  ,Not Adjusted,9573,10524,951,9.0
5180,2010,March,Bell                                                 ,Not Adjusted,120681,130480,9799,7.5
5181,2010,June,Bell                                                 ,Not Adjusted,121670,132220,10550,8.0
5182,2010,September,Bell                                                 ,Not Adjusted,122545,133017,10472,7.9
5183,2010,December,Bell                                                 ,Not Adjusted,122259,132549,10290,7.8
5184,2010,March,Bexar                                                ,Not Adjusted,748817,807076,58259,7.2
5185,2010,June,Bexar                                                ,Not Adjusted,754794,815680,60886,7.5
5186,2010,September,Bexar                                                ,Not Adjusted,756051,816005,59954,7.3
5187,2010,December,Bexar                                                ,Not Adjusted,758462,817408,58946,7.2
5188,2010,March,Blanco                                               ,Not Adjusted,5067,5395,328,6.1
5189,2010,June,Blanco                                               ,Not Adjusted,5163,5498,335,6.1
5190,2010,September,Blanco                                               ,Not Adjusted,5117,5432,315,5.8
5191,2010,December,Blanco                                               ,Not Adjusted,5101,5413,312,5.8
5192,2010,March,Borden                                               ,Not Adjusted,330,354,24,6.8
5193,2010,June,Borden                                               ,Not Adjusted,335,360,25,6.9
5194,2010,September,Borden                                               ,Not Adjusted,330,354,24,6.8
5195,2010,December,Borden                                               ,Not Adjusted,363,387,24,6.2
5196,2010,March,Bosque                                               ,Not Adjusted,7592,8332,740,8.9
5197,2010,June,Bosque                                               ,Not Adjusted,7793,8569,776,9.1
5198,2010,September,Bosque                                               ,Not Adjusted,7838,8563,725,8.5
5199,2010,December,Bosque                                               ,Not Adjusted,7745,8490,745,8.8
5200,2010,March,Bowie                                                ,Not Adjusted,38345,41917,3572,8.5
5201,2010,June,Bowie                                                ,Not Adjusted,38790,42485,3695,8.7
5202,2010,September,Bowie                                                ,Not Adjusted,38932,42433,3501,8.3
5203,2010,December,Bowie                                                ,Not Adjusted,39062,42491,3429,8.1
5204,2010,March,Brazoria                                             ,Not Adjusted,140551,153939,13388,8.7
5205,2010,June,Brazoria                                             ,Not Adjusted,141747,155424,13677,8.8
5206,2010,September,Brazoria                                             ,Not Adjusted,143261,156354,13093,8.4
5207,2010,December,Brazoria                                             ,Not Adjusted,143628,156636,13008,8.3
5208,2010,March,Brazos                                               ,Not Adjusted,94116,100149,6033,6.0
5209,2010,June,Brazos                                               ,Not Adjusted,90662,97542,6880,7.1
5210,2010,September,Brazos                                               ,Not Adjusted,95413,101691,6278,6.2
5211,2010,December,Brazos                                               ,Not Adjusted,95397,101527,6130,6.0
5212,2010,March,Brewster                                             ,Not Adjusted,4707,4971,264,5.3
5213,2010,June,Brewster                                             ,Not Adjusted,4655,4925,270,5.5
5214,2010,September,Brewster                                             ,Not Adjusted,4708,4975,267,5.4
5215,2010,December,Brewster                                             ,Not Adjusted,4588,4856,268,5.5
5216,2010,March,Briscoe                                              ,Not Adjusted,681,732,51,7.0
5217,2010,June,Briscoe                                              ,Not Adjusted,725,769,44,5.7
5218,2010,September,Briscoe                                              ,Not Adjusted,682,723,41,5.7
5219,2010,December,Briscoe                                              ,Not Adjusted,676,719,43,6.0
5220,2010,March,Brooks                                               ,Not Adjusted,2262,2553,291,11.4
5221,2010,June,Brooks                                               ,Not Adjusted,2279,2607,328,12.6
5222,2010,September,Brooks                                               ,Not Adjusted,2316,2628,312,11.9
5223,2010,December,Brooks                                               ,Not Adjusted,2326,2623,297,11.3
5224,2010,March,Brown                                                ,Not Adjusted,15167,16577,1410,8.5
5225,2010,June,Brown                                                ,Not Adjusted,15158,16552,1394,8.4
5226,2010,September,Brown                                                ,Not Adjusted,15167,16500,1333,8.1
5227,2010,December,Brown                                                ,Not Adjusted,14986,16283,1297,8.0
5228,2010,March,Burleson                                             ,Not Adjusted,7269,7897,628,8.0
5229,2010,June,Burleson                                             ,Not Adjusted,7061,7708,647,8.4
5230,2010,September,Burleson                                             ,Not Adjusted,7381,7992,611,7.6
5231,2010,December,Burleson                                             ,Not Adjusted,7378,7958,580,7.3
5232,2010,March,Burnet                                               ,Not Adjusted,18639,20016,1377,6.9
5233,2010,June,Burnet                                               ,Not Adjusted,19228,20668,1440,7.0
5234,2010,September,Burnet                                               ,Not Adjusted,19073,20428,1355,6.6
5235,2010,December,Burnet                                               ,Not Adjusted,18901,20247,1346,6.6
5236,2010,March,Caldwell                                             ,Not Adjusted,15070,16516,1446,8.8
5237,2010,June,Caldwell                                             ,Not Adjusted,15223,16768,1545,9.2
5238,2010,September,Caldwell                                             ,Not Adjusted,15320,16737,1417,8.5
5239,2010,December,Caldwell                                             ,Not Adjusted,15449,16831,1382,8.2
5240,2010,March,Calhoun                                              ,Not Adjusted,9172,10071,899,8.9
5241,2010,June,Calhoun                                              ,Not Adjusted,9127,10044,917,9.1
5242,2010,September,Calhoun                                              ,Not Adjusted,9354,10254,900,8.8
5243,2010,December,Calhoun                                              ,Not Adjusted,9584,10465,881,8.4
5244,2010,March,Callahan                                             ,Not Adjusted,5557,6000,443,7.4
5245,2010,June,Callahan                                             ,Not Adjusted,5569,6031,462,7.7
5246,2010,September,Callahan                                             ,Not Adjusted,5578,6004,426,7.1
5247,2010,December,Callahan                                             ,Not Adjusted,5594,6004,410,6.8
5248,2010,March,Cameron                                              ,Not Adjusted,143128,160872,17744,11.0
5249,2010,June,Cameron                                              ,Not Adjusted,144232,162873,18641,11.4
5250,2010,September,Cameron                                              ,Not Adjusted,144145,162197,18052,11.1
5251,2010,December,Cameron                                              ,Not Adjusted,145938,165149,19211,11.6
5252,2010,March,Camp                                                 ,Not Adjusted,5206,5748,542,9.4
5253,2010,June,Camp                                                 ,Not Adjusted,5238,5785,547,9.5
5254,2010,September,Camp                                                 ,Not Adjusted,5215,5732,517,9.0
5255,2010,December,Camp                                                 ,Not Adjusted,5136,5638,502,8.9
5256,2010,March,Carson                                               ,Not Adjusted,3121,3311,190,5.7
5257,2010,June,Carson                                               ,Not Adjusted,3197,3389,192,5.7
5258,2010,September,Carson                                               ,Not Adjusted,3201,3372,171,5.1
5259,2010,December,Carson                                               ,Not Adjusted,3209,3372,163,4.8
5260,2010,March,Cass                                                 ,Not Adjusted,11788,13393,1605,12.0
5261,2010,June,Cass                                                 ,Not Adjusted,11815,13345,1530,11.5
5262,2010,September,Cass                                                 ,Not Adjusted,11932,13342,1410,10.6
5263,2010,December,Cass                                                 ,Not Adjusted,11949,13380,1431,10.7
5264,2010,March,Castro                                               ,Not Adjusted,3835,4063,228,5.6
5265,2010,June,Castro                                               ,Not Adjusted,4096,4337,241,5.6
5266,2010,September,Castro                                               ,Not Adjusted,3993,4212,219,5.2
5267,2010,December,Castro                                               ,Not Adjusted,3903,4111,208,5.1
5268,2010,March,Chambers                                             ,Not Adjusted,14845,16510,1665,10.1
5269,2010,June,Chambers                                             ,Not Adjusted,14960,16674,1714,10.3
5270,2010,September,Chambers                                             ,Not Adjusted,15124,16691,1567,9.4
5271,2010,December,Chambers                                             ,Not Adjusted,15169,16741,1572,9.4
5272,2010,March,Cherokee                                             ,Not Adjusted,19609,21586,1977,9.2
5273,2010,June,Cherokee                                             ,Not Adjusted,20085,22062,1977,9.0
5274,2010,September,Cherokee                                             ,Not Adjusted,20150,22028,1878,8.5
5275,2010,December,Cherokee                                             ,Not Adjusted,20387,22271,1884,8.5
5276,2010,March,Childress                                            ,Not Adjusted,2925,3101,176,5.7
5277,2010,June,Childress                                            ,Not Adjusted,3073,3266,193,5.9
5278,2010,September,Childress                                            ,Not Adjusted,2993,3177,184,5.8
5279,2010,December,Childress                                            ,Not Adjusted,2959,3125,166,5.3
5280,2010,March,Clay                                                 ,Not Adjusted,5043,5489,446,8.1
5281,2010,June,Clay                                                 ,Not Adjusted,5209,5630,421,7.5
5282,2010,September,Clay                                                 ,Not Adjusted,5180,5573,393,7.1
5283,2010,December,Clay                                                 ,Not Adjusted,5171,5547,376,6.8
5284,2010,March,Cochran                                              ,Not Adjusted,1402,1520,118,7.8
5285,2010,June,Cochran                                              ,Not Adjusted,1451,1596,145,9.1
5286,2010,September,Cochran                                              ,Not Adjusted,1406,1544,138,8.9
5287,2010,December,Cochran                                              ,Not Adjusted,1365,1481,116,7.8
5288,2010,March,Coke                                                 ,Not Adjusted,1521,1614,93,5.8
5289,2010,June,Coke                                                 ,Not Adjusted,1477,1577,100,6.3
5290,2010,September,Coke                                                 ,Not Adjusted,1454,1551,97,6.3
5291,2010,December,Coke                                                 ,Not Adjusted,1445,1530,85,5.6
5292,2010,March,Coleman                                              ,Not Adjusted,3186,3534,348,9.8
5293,2010,June,Coleman                                              ,Not Adjusted,3244,3574,330,9.2
5294,2010,September,Coleman                                              ,Not Adjusted,3167,3462,295,8.5
5295,2010,December,Coleman                                              ,Not Adjusted,3127,3409,282,8.3
5296,2010,March,Collin                                               ,Not Adjusted,389432,420764,31332,7.4
5297,2010,June,Collin                                               ,Not Adjusted,393999,426124,32125,7.5
5298,2010,September,Collin                                               ,Not Adjusted,397961,428446,30485,7.1
5299,2010,December,Collin                                               ,Not Adjusted,399916,429316,29400,6.8
5300,2010,March,Collingsworth                                        ,Not Adjusted,1244,1309,65,5.0
5301,2010,June,Collingsworth                                        ,Not Adjusted,1292,1373,81,5.9
5302,2010,September,Collingsworth                                        ,Not Adjusted,1299,1379,80,5.8
5303,2010,December,Collingsworth                                        ,Not Adjusted,1288,1358,70,5.2
5304,2010,March,Colorado                                             ,Not Adjusted,8585,9373,788,8.4
5305,2010,June,Colorado                                             ,Not Adjusted,9009,9826,817,8.3
5306,2010,September,Colorado                                             ,Not Adjusted,8914,9659,745,7.7
5307,2010,December,Colorado                                             ,Not Adjusted,8991,9786,795,8.1
5308,2010,March,Comal                                                ,Not Adjusted,49435,53217,3782,7.1
5309,2010,June,Comal                                                ,Not Adjusted,49845,53721,3876,7.2
5310,2010,September,Comal                                                ,Not Adjusted,49896,53651,3755,7.0
5311,2010,December,Comal                                                ,Not Adjusted,50098,53827,3729,6.9
5312,2010,March,Comanche                                             ,Not Adjusted,5558,6027,469,7.8
5313,2010,June,Comanche                                             ,Not Adjusted,5728,6216,488,7.9
5314,2010,September,Comanche                                             ,Not Adjusted,5599,6048,449,7.4
5315,2010,December,Comanche                                             ,Not Adjusted,5469,5894,425,7.2
5316,2010,March,Concho                                               ,Not Adjusted,1440,1532,92,6.0
5317,2010,June,Concho                                               ,Not Adjusted,1537,1637,100,6.1
5318,2010,September,Concho                                               ,Not Adjusted,1501,1591,90,5.7
5319,2010,December,Concho                                               ,Not Adjusted,1489,1569,80,5.1
5320,2010,March,Cooke                                                ,Not Adjusted,17832,19358,1526,7.9
5321,2010,June,Cooke                                                ,Not Adjusted,18148,19637,1489,7.6
5322,2010,September,Cooke                                                ,Not Adjusted,18422,19805,1383,7.0
5323,2010,December,Cooke                                                ,Not Adjusted,18470,19770,1300,6.6
5324,2010,March,Coryell                                              ,Not Adjusted,23248,25082,1834,7.3
5325,2010,June,Coryell                                              ,Not Adjusted,23452,25430,1978,7.8
5326,2010,September,Coryell                                              ,Not Adjusted,23611,25510,1899,7.4
5327,2010,December,Coryell                                              ,Not Adjusted,23555,25472,1917,7.5
5328,2010,March,Cottle                                               ,Not Adjusted,614,662,48,7.3
5329,2010,June,Cottle                                               ,Not Adjusted,646,697,51,7.3
5330,2010,September,Cottle                                               ,Not Adjusted,626,675,49,7.3
5331,2010,December,Cottle                                               ,Not Adjusted,618,655,37,5.6
5332,2010,March,Crane                                                ,Not Adjusted,1654,1793,139,7.8
5333,2010,June,Crane                                                ,Not Adjusted,1685,1828,143,7.8
5334,2010,September,Crane                                                ,Not Adjusted,1703,1833,130,7.1
5335,2010,December,Crane                                                ,Not Adjusted,1718,1858,140,7.5
5336,2010,March,Crockett                                             ,Not Adjusted,1557,1724,167,9.7
5337,2010,June,Crockett                                             ,Not Adjusted,1609,1760,151,8.6
5338,2010,September,Crockett                                             ,Not Adjusted,1579,1715,136,7.9
5339,2010,December,Crockett                                             ,Not Adjusted,1600,1722,122,7.1
5340,2010,March,Crosby                                               ,Not Adjusted,2663,2909,246,8.5
5341,2010,June,Crosby                                               ,Not Adjusted,2779,3030,251,8.3
5342,2010,September,Crosby                                               ,Not Adjusted,2751,2990,239,8.0
5343,2010,December,Crosby                                               ,Not Adjusted,2753,2964,211,7.1
5344,2010,March,Culberson                                            ,Not Adjusted,955,1026,71,6.9
5345,2010,June,Culberson                                            ,Not Adjusted,960,1031,71,6.9
5346,2010,September,Culberson                                            ,Not Adjusted,979,1050,71,6.8
5347,2010,December,Culberson                                            ,Not Adjusted,951,1025,74,7.2
5348,2010,March,Dallam                                               ,Not Adjusted,3535,3749,214,5.7
5349,2010,June,Dallam                                               ,Not Adjusted,3758,3973,215,5.4
5350,2010,September,Dallam                                               ,Not Adjusted,3782,3984,202,5.1
5351,2010,December,Dallam                                               ,Not Adjusted,3741,3922,181,4.6
5352,2010,March,Dallas                                               ,Not Adjusted,1077430,1181837,104407,8.8
5353,2010,June,Dallas                                               ,Not Adjusted,1089721,1194632,104911,8.8
5354,2010,September,Dallas                                               ,Not Adjusted,1100620,1202815,102195,8.5
5355,2010,December,Dallas                                               ,Not Adjusted,1106359,1206846,100487,8.3
5356,2010,March,Dawson                                               ,Not Adjusted,4655,5065,410,8.1
5357,2010,June,Dawson                                               ,Not Adjusted,4784,5216,432,8.3
5358,2010,September,Dawson                                               ,Not Adjusted,4760,5144,384,7.5
5359,2010,December,Dawson                                               ,Not Adjusted,4881,5235,354,6.8
5360,2010,March,Deaf Smith                                           ,Not Adjusted,8859,9398,539,5.7
5361,2010,June,Deaf Smith                                           ,Not Adjusted,9242,9827,585,6.0
5362,2010,September,Deaf Smith                                           ,Not Adjusted,9087,9623,536,5.6
5363,2010,December,Deaf Smith                                           ,Not Adjusted,8984,9506,522,5.5
5364,2010,March,Delta                                                ,Not Adjusted,2383,2589,206,8.0
5365,2010,June,Delta                                                ,Not Adjusted,2404,2604,200,7.7
5366,2010,September,Delta                                                ,Not Adjusted,2410,2622,212,8.1
5367,2010,December,Delta                                                ,Not Adjusted,2416,2621,205,7.8
5368,2010,March,Denton                                               ,Not Adjusted,338434,365121,26687,7.3
5369,2010,June,Denton                                               ,Not Adjusted,342443,369260,26817,7.3
5370,2010,September,Denton                                               ,Not Adjusted,345933,371890,25957,7.0
5371,2010,December,Denton                                               ,Not Adjusted,347557,372836,25279,6.8
5372,2010,March,DeWitt                                               ,Not Adjusted,8303,9004,701,7.8
5373,2010,June,DeWitt                                               ,Not Adjusted,8375,9119,744,8.2
5374,2010,September,DeWitt                                               ,Not Adjusted,8440,9151,711,7.8
5375,2010,December,DeWitt                                               ,Not Adjusted,8526,9174,648,7.1
5376,2010,March,Dickens                                              ,Not Adjusted,763,846,83,9.8
5377,2010,June,Dickens                                              ,Not Adjusted,802,884,82,9.3
5378,2010,September,Dickens                                              ,Not Adjusted,779,900,121,13.4
5379,2010,December,Dickens                                              ,Not Adjusted,780,911,131,14.4
5380,2010,March,Dimmit                                               ,Not Adjusted,3303,3713,410,11.0
5381,2010,June,Dimmit                                               ,Not Adjusted,3374,3798,424,11.2
5382,2010,September,Dimmit                                               ,Not Adjusted,3677,4072,395,9.7
5383,2010,December,Dimmit                                               ,Not Adjusted,3655,4061,406,10.0
5384,2010,March,Donley                                               ,Not Adjusted,1642,1764,122,6.9
5385,2010,June,Donley                                               ,Not Adjusted,1733,1867,134,7.2
5386,2010,September,Donley                                               ,Not Adjusted,1667,1791,124,6.9
5387,2010,December,Donley                                               ,Not Adjusted,1716,1835,119,6.5
5388,2010,March,Duval                                                ,Not Adjusted,4340,4967,627,12.6
5389,2010,June,Duval                                                ,Not Adjusted,4479,5092,613,12.0
5390,2010,September,Duval                                                ,Not Adjusted,4548,5111,563,11.0
5391,2010,December,Duval                                                ,Not Adjusted,4602,5158,556,10.8
5392,2010,March,Eastland                                             ,Not Adjusted,7277,7993,716,9.0
5393,2010,June,Eastland                                             ,Not Adjusted,7418,8180,762,9.3
5394,2010,September,Eastland                                             ,Not Adjusted,7503,8179,676,8.3
5395,2010,December,Eastland                                             ,Not Adjusted,7712,8382,670,8.0
5396,2010,March,Ector                                                ,Not Adjusted,61248,67279,6031,9.0
5397,2010,June,Ector                                                ,Not Adjusted,61894,67866,5972,8.8
5398,2010,September,Ector                                                ,Not Adjusted,63667,69067,5400,7.8
5399,2010,December,Ector                                                ,Not Adjusted,64720,69734,5014,7.2
5400,2010,March,Edwards                                              ,Not Adjusted,976,1051,75,7.1
5401,2010,June,Edwards                                              ,Not Adjusted,1005,1089,84,7.7
5402,2010,September,Edwards                                              ,Not Adjusted,954,1026,72,7.0
5403,2010,December,Edwards                                              ,Not Adjusted,942,1003,61,6.1
5404,2010,March,Ellis                                                ,Not Adjusted,68699,74759,6060,8.1
5405,2010,June,Ellis                                                ,Not Adjusted,69555,75777,6222,8.2
5406,2010,September,Ellis                                                ,Not Adjusted,70206,76291,6085,8.0
5407,2010,December,Ellis                                                ,Not Adjusted,70554,76635,6081,7.9
5408,2010,March,El Paso                                              ,Not Adjusted,308924,339566,30642,9.0
5409,2010,June,El Paso                                              ,Not Adjusted,309495,341377,31882,9.3
5410,2010,September,El Paso                                              ,Not Adjusted,312328,344455,32127,9.3
5411,2010,December,El Paso                                              ,Not Adjusted,312921,345218,32297,9.4
5412,2010,March,Erath                                                ,Not Adjusted,18900,20218,1318,6.5
5413,2010,June,Erath                                                ,Not Adjusted,19417,20825,1408,6.8
5414,2010,September,Erath                                                ,Not Adjusted,19177,20470,1293,6.3
5415,2010,December,Erath                                                ,Not Adjusted,19535,20792,1257,6.0
5416,2010,March,Falls                                                ,Not Adjusted,6542,7163,621,8.7
5417,2010,June,Falls                                                ,Not Adjusted,6725,7369,644,8.7
5418,2010,September,Falls                                                ,Not Adjusted,6695,7321,626,8.6
5419,2010,December,Falls                                                ,Not Adjusted,6622,7213,591,8.2
5420,2010,March,Fannin                                               ,Not Adjusted,13976,15234,1258,8.3
5421,2010,June,Fannin                                               ,Not Adjusted,14244,15511,1267,8.2
5422,2010,September,Fannin                                               ,Not Adjusted,14088,15372,1284,8.4
5423,2010,December,Fannin                                               ,Not Adjusted,14061,15348,1287,8.4
5424,2010,March,Fayette                                              ,Not Adjusted,11133,11880,747,6.3
5425,2010,June,Fayette                                              ,Not Adjusted,11492,12250,758,6.2
5426,2010,September,Fayette                                              ,Not Adjusted,11337,12054,717,5.9
5427,2010,December,Fayette                                              ,Not Adjusted,11377,12104,727,6.0
5428,2010,March,Fisher                                               ,Not Adjusted,1789,1929,140,7.3
5429,2010,June,Fisher                                               ,Not Adjusted,1831,1979,148,7.5
5430,2010,September,Fisher                                               ,Not Adjusted,1790,1928,138,7.2
5431,2010,December,Fisher                                               ,Not Adjusted,1817,1937,120,6.2
5432,2010,March,Floyd                                                ,Not Adjusted,3036,3307,271,8.2
5433,2010,June,Floyd                                                ,Not Adjusted,3188,3476,288,8.3
5434,2010,September,Floyd                                                ,Not Adjusted,3130,3392,262,7.7
5435,2010,December,Floyd                                                ,Not Adjusted,3077,3319,242,7.3
5436,2010,March,Foard                                                ,Not Adjusted,622,661,39,5.9
5437,2010,June,Foard                                                ,Not Adjusted,636,680,44,6.5
5438,2010,September,Foard                                                ,Not Adjusted,607,656,49,7.5
5439,2010,December,Foard                                                ,Not Adjusted,613,656,43,6.6
5440,2010,March,Fort Bend                                            ,Not Adjusted,272650,295700,23050,7.8
5441,2010,June,Fort Bend                                            ,Not Adjusted,274799,298506,23707,7.9
5442,2010,September,Fort Bend                                            ,Not Adjusted,277737,300339,22602,7.5
5443,2010,December,Fort Bend                                            ,Not Adjusted,278596,300716,22120,7.4
5444,2010,March,Franklin                                             ,Not Adjusted,4416,4845,429,8.9
5445,2010,June,Franklin                                             ,Not Adjusted,4478,4903,425,8.7
5446,2010,September,Franklin                                             ,Not Adjusted,4390,4802,412,8.6
5447,2010,December,Franklin                                             ,Not Adjusted,4348,4737,389,8.2
5448,2010,March,Freestone                                            ,Not Adjusted,7524,8194,670,8.2
5449,2010,June,Freestone                                            ,Not Adjusted,7592,8276,684,8.3
5450,2010,September,Freestone                                            ,Not Adjusted,7513,8192,679,8.3
5451,2010,December,Freestone                                            ,Not Adjusted,7411,8066,655,8.1
5452,2010,March,Frio                                                 ,Not Adjusted,6918,7497,579,7.7
5453,2010,June,Frio                                                 ,Not Adjusted,7131,7726,595,7.7
5454,2010,September,Frio                                                 ,Not Adjusted,7117,7652,535,7.0
5455,2010,December,Frio                                                 ,Not Adjusted,7116,7629,513,6.7
5456,2010,March,Gaines                                               ,Not Adjusted,7210,7713,503,6.5
5457,2010,June,Gaines                                               ,Not Adjusted,7605,8105,500,6.2
5458,2010,September,Gaines                                               ,Not Adjusted,7662,8113,451,5.6
5459,2010,December,Gaines                                               ,Not Adjusted,7611,8024,413,5.1
5460,2010,March,Galveston                                            ,Not Adjusted,132480,146062,13582,9.3
5461,2010,June,Galveston                                            ,Not Adjusted,133624,147393,13769,9.3
5462,2010,September,Galveston                                            ,Not Adjusted,134997,148376,13379,9.0
5463,2010,December,Galveston                                            ,Not Adjusted,135387,148893,13506,9.1
5464,2010,March,Garza                                                ,Not Adjusted,1977,2110,133,6.3
5465,2010,June,Garza                                                ,Not Adjusted,2024,2158,134,6.2
5466,2010,September,Garza                                                ,Not Adjusted,2014,2142,128,6.0
5467,2010,December,Garza                                                ,Not Adjusted,2103,2225,122,5.5
5468,2010,March,Gillespie                                            ,Not Adjusted,11288,11964,676,5.7
5469,2010,June,Gillespie                                            ,Not Adjusted,11575,12273,698,5.7
5470,2010,September,Gillespie                                            ,Not Adjusted,11734,12397,663,5.3
5471,2010,December,Gillespie                                            ,Not Adjusted,11834,12463,629,5.0
5472,2010,March,Glasscock                                            ,Not Adjusted,652,687,35,5.1
5473,2010,June,Glasscock                                            ,Not Adjusted,695,731,36,4.9
5474,2010,September,Glasscock                                            ,Not Adjusted,674,709,35,4.9
5475,2010,December,Glasscock                                            ,Not Adjusted,692,725,33,4.6
5476,2010,March,Goliad                                               ,Not Adjusted,3084,3328,244,7.3
5477,2010,June,Goliad                                               ,Not Adjusted,3154,3420,266,7.8
5478,2010,September,Goliad                                               ,Not Adjusted,3120,3359,239,7.1
5479,2010,December,Goliad                                               ,Not Adjusted,3114,3352,238,7.1
5480,2010,March,Gonzales                                             ,Not Adjusted,8606,9248,642,6.9
5481,2010,June,Gonzales                                             ,Not Adjusted,8856,9517,661,6.9
5482,2010,September,Gonzales                                             ,Not Adjusted,8719,9338,619,6.6
5483,2010,December,Gonzales                                             ,Not Adjusted,8708,9340,632,6.8
5484,2010,March,Gray                                                 ,Not Adjusted,8203,9116,913,10.0
5485,2010,June,Gray                                                 ,Not Adjusted,8451,9261,810,8.7
5486,2010,September,Gray                                                 ,Not Adjusted,8678,9403,725,7.7
5487,2010,December,Gray                                                 ,Not Adjusted,8770,9471,701,7.4
5488,2010,March,Grayson                                              ,Not Adjusted,54308,59262,4954,8.4
5489,2010,June,Grayson                                              ,Not Adjusted,54792,59826,5034,8.4
5490,2010,September,Grayson                                              ,Not Adjusted,54882,59713,4831,8.1
5491,2010,December,Grayson                                              ,Not Adjusted,55041,59743,4702,7.9
5492,2010,March,Gregg                                                ,Not Adjusted,55027,59886,4859,8.1
5493,2010,June,Gregg                                                ,Not Adjusted,55293,60323,5030,8.3
5494,2010,September,Gregg                                                ,Not Adjusted,56324,61070,4746,7.8
5495,2010,December,Gregg                                                ,Not Adjusted,55979,60485,4506,7.4
5496,2010,March,Grimes                                               ,Not Adjusted,10170,11207,1037,9.3
5497,2010,June,Grimes                                               ,Not Adjusted,10335,11410,1075,9.4
5498,2010,September,Grimes                                               ,Not Adjusted,10428,11437,1009,8.8
5499,2010,December,Grimes                                               ,Not Adjusted,10403,11365,962,8.5
5500,2010,March,Guadalupe                                            ,Not Adjusted,60175,64579,4404,6.8
5501,2010,June,Guadalupe                                            ,Not Adjusted,60720,65275,4555,7.0
5502,2010,September,Guadalupe                                            ,Not Adjusted,60800,65107,4307,6.6
5503,2010,December,Guadalupe                                            ,Not Adjusted,60958,65256,4298,6.6
5504,2010,March,Hale                                                 ,Not Adjusted,14820,15970,1150,7.2
5505,2010,June,Hale                                                 ,Not Adjusted,15051,16356,1305,8.0
5506,2010,September,Hale                                                 ,Not Adjusted,15257,16450,1193,7.3
5507,2010,December,Hale                                                 ,Not Adjusted,14999,16167,1168,7.2
5508,2010,March,Hall                                                 ,Not Adjusted,1273,1401,128,9.1
5509,2010,June,Hall                                                 ,Not Adjusted,1326,1463,137,9.4
5510,2010,September,Hall                                                 ,Not Adjusted,1318,1455,137,9.4
5511,2010,December,Hall                                                 ,Not Adjusted,1287,1395,108,7.7
5512,2010,March,Hamilton                                             ,Not Adjusted,3677,3945,268,6.8
5513,2010,June,Hamilton                                             ,Not Adjusted,3703,3979,276,6.9
5514,2010,September,Hamilton                                             ,Not Adjusted,3683,3939,256,6.5
5515,2010,December,Hamilton                                             ,Not Adjusted,3668,3927,259,6.6
5516,2010,March,Hansford                                             ,Not Adjusted,2824,2960,136,4.6
5517,2010,June,Hansford                                             ,Not Adjusted,2984,3121,137,4.4
5518,2010,September,Hansford                                             ,Not Adjusted,2962,3089,127,4.1
5519,2010,December,Hansford                                             ,Not Adjusted,2941,3060,119,3.9
5520,2010,March,Hardeman                                             ,Not Adjusted,1766,1917,151,7.9
5521,2010,June,Hardeman                                             ,Not Adjusted,1857,2028,171,8.4
5522,2010,September,Hardeman                                             ,Not Adjusted,1774,1939,165,8.5
5523,2010,December,Hardeman                                             ,Not Adjusted,1786,1935,149,7.7
5524,2010,March,Hardin                                               ,Not Adjusted,23185,25846,2661,10.3
5525,2010,June,Hardin                                               ,Not Adjusted,23233,25931,2698,10.4
5526,2010,September,Hardin                                               ,Not Adjusted,23333,25830,2497,9.7
5527,2010,December,Hardin                                               ,Not Adjusted,23403,25978,2575,9.9
5528,2010,March,Harris                                               ,Not Adjusted,1873901,2047155,173254,8.5
5529,2010,June,Harris                                               ,Not Adjusted,1888454,2064874,176420,8.5
5530,2010,September,Harris                                               ,Not Adjusted,1908254,2079025,170771,8.2
5531,2010,December,Harris                                               ,Not Adjusted,1914784,2084409,169625,8.1
5532,2010,March,Harrison                                             ,Not Adjusted,27533,30500,2967,9.7
5533,2010,June,Harrison                                             ,Not Adjusted,28022,30960,2938,9.5
5534,2010,September,Harrison                                             ,Not Adjusted,28319,31177,2858,9.2
5535,2010,December,Harrison                                             ,Not Adjusted,28230,30976,2746,8.9
5536,2010,March,Hartley                                              ,Not Adjusted,2500,2613,113,4.3
5537,2010,June,Hartley                                              ,Not Adjusted,2649,2768,119,4.3
5538,2010,September,Hartley                                              ,Not Adjusted,2643,2751,108,3.9
5539,2010,December,Hartley                                              ,Not Adjusted,2651,2754,103,3.7
5540,2010,March,Haskell                                              ,Not Adjusted,2772,2942,170,5.8
5541,2010,June,Haskell                                              ,Not Adjusted,2900,3070,170,5.5
5542,2010,September,Haskell                                              ,Not Adjusted,2864,3020,156,5.2
5543,2010,December,Haskell                                              ,Not Adjusted,2870,3013,143,4.7
5544,2010,March,Hays                                                 ,Not Adjusted,74007,79669,5662,7.1
5545,2010,June,Hays                                                 ,Not Adjusted,74615,80578,5963,7.4
5546,2010,September,Hays                                                 ,Not Adjusted,75185,80781,5596,6.9
5547,2010,December,Hays                                                 ,Not Adjusted,75850,81335,5485,6.7
5548,2010,March,Hemphill                                             ,Not Adjusted,1989,2073,84,4.1
5549,2010,June,Hemphill                                             ,Not Adjusted,2045,2130,85,4.0
5550,2010,September,Hemphill                                             ,Not Adjusted,2062,2144,82,3.8
5551,2010,December,Hemphill                                             ,Not Adjusted,2128,2205,77,3.5
5552,2010,March,Henderson                                            ,Not Adjusted,31548,34683,3135,9.0
5553,2010,June,Henderson                                            ,Not Adjusted,32050,35190,3140,8.9
5554,2010,September,Henderson                                            ,Not Adjusted,31906,34896,2990,8.6
5555,2010,December,Henderson                                            ,Not Adjusted,31632,34603,2971,8.6
5556,2010,March,Hidalgo                                              ,Not Adjusted,280898,318282,37384,11.7
5557,2010,June,Hidalgo                                              ,Not Adjusted,280724,319214,38490,12.1
5558,2010,September,Hidalgo                                              ,Not Adjusted,280891,317795,36904,11.6
5559,2010,December,Hidalgo                                              ,Not Adjusted,286730,326211,39481,12.1
5560,2010,March,Hill                                                 ,Not Adjusted,14510,15857,1347,8.5
5561,2010,June,Hill                                                 ,Not Adjusted,14678,16057,1379,8.6
5562,2010,September,Hill                                                 ,Not Adjusted,14723,16047,1324,8.3
5563,2010,December,Hill                                                 ,Not Adjusted,14595,15881,1286,8.1
5564,2010,March,Hockley                                              ,Not Adjusted,10127,10935,808,7.4
5565,2010,June,Hockley                                              ,Not Adjusted,10149,11007,858,7.8
5566,2010,September,Hockley                                              ,Not Adjusted,10500,11251,751,6.7
5567,2010,December,Hockley                                              ,Not Adjusted,10589,11287,698,6.2
5568,2010,March,Hood                                                 ,Not Adjusted,21183,23246,2063,8.9
5569,2010,June,Hood                                                 ,Not Adjusted,21411,23400,1989,8.5
5570,2010,September,Hood                                                 ,Not Adjusted,21500,23472,1972,8.4
5571,2010,December,Hood                                                 ,Not Adjusted,21628,23594,1966,8.3
5572,2010,March,Hopkins                                              ,Not Adjusted,15436,16718,1282,7.7
5573,2010,June,Hopkins                                              ,Not Adjusted,15387,16647,1260,7.6
5574,2010,September,Hopkins                                              ,Not Adjusted,15537,16746,1209,7.2
5575,2010,December,Hopkins                                              ,Not Adjusted,15404,16640,1236,7.4
5576,2010,March,Houston                                              ,Not Adjusted,9576,10400,824,7.9
5577,2010,June,Houston                                              ,Not Adjusted,9815,10649,834,7.8
5578,2010,September,Houston                                              ,Not Adjusted,9909,10701,792,7.4
5579,2010,December,Houston                                              ,Not Adjusted,9963,10767,804,7.5
5580,2010,March,Howard                                               ,Not Adjusted,12215,13178,963,7.3
5581,2010,June,Howard                                               ,Not Adjusted,12365,13403,1038,7.7
5582,2010,September,Howard                                               ,Not Adjusted,12307,13217,910,6.9
5583,2010,December,Howard                                               ,Not Adjusted,12228,13102,874,6.7
5584,2010,March,Hudspeth                                             ,Not Adjusted,1286,1388,102,7.3
5585,2010,June,Hudspeth                                             ,Not Adjusted,1328,1447,119,8.2
5586,2010,September,Hudspeth                                             ,Not Adjusted,1319,1438,119,8.3
5587,2010,December,Hudspeth                                             ,Not Adjusted,1312,1418,106,7.5
5588,2010,March,Hunt                                                 ,Not Adjusted,34274,37658,3384,9.0
5589,2010,June,Hunt                                                 ,Not Adjusted,34728,38254,3526,9.2
5590,2010,September,Hunt                                                 ,Not Adjusted,35032,38407,3375,8.8
5591,2010,December,Hunt                                                 ,Not Adjusted,35203,38565,3362,8.7
5592,2010,March,Hutchinson                                           ,Not Adjusted,8925,9728,803,8.3
5593,2010,June,Hutchinson                                           ,Not Adjusted,8883,9739,856,8.8
5594,2010,September,Hutchinson                                           ,Not Adjusted,8865,9716,851,8.8
5595,2010,December,Hutchinson                                           ,Not Adjusted,8854,9738,884,9.1
5596,2010,March,Irion                                                ,Not Adjusted,817,864,47,5.4
5597,2010,June,Irion                                                ,Not Adjusted,841,888,47,5.3
5598,2010,September,Irion                                                ,Not Adjusted,835,879,44,5.0
5599,2010,December,Irion                                                ,Not Adjusted,836,879,43,4.9
5600,2010,March,Jack                                                 ,Not Adjusted,3397,3695,298,8.1
5601,2010,June,Jack                                                 ,Not Adjusted,3326,3613,287,7.9
5602,2010,September,Jack                                                 ,Not Adjusted,3404,3674,270,7.3
5603,2010,December,Jack                                                 ,Not Adjusted,3379,3651,272,7.5
5604,2010,March,Jackson                                              ,Not Adjusted,6497,7011,514,7.3
5605,2010,June,Jackson                                              ,Not Adjusted,6753,7307,554,7.6
5606,2010,September,Jackson                                              ,Not Adjusted,6740,7232,492,6.8
5607,2010,December,Jackson                                              ,Not Adjusted,6766,7236,470,6.5
5608,2010,March,Jasper                                               ,Not Adjusted,12928,14802,1874,12.7
5609,2010,June,Jasper                                               ,Not Adjusted,13064,14953,1889,12.6
5610,2010,September,Jasper                                               ,Not Adjusted,13032,14853,1821,12.3
5611,2010,December,Jasper                                               ,Not Adjusted,13042,14958,1916,12.8
5612,2010,March,Jeff Davis                                           ,Not Adjusted,1206,1268,62,4.9
5613,2010,June,Jeff Davis                                           ,Not Adjusted,1291,1362,71,5.2
5614,2010,September,Jeff Davis                                           ,Not Adjusted,1217,1276,59,4.6
5615,2010,December,Jeff Davis                                           ,Not Adjusted,1168,1227,59,4.8
5616,2010,March,Jefferson                                            ,Not Adjusted,99950,112958,13008,11.5
5617,2010,June,Jefferson                                            ,Not Adjusted,100187,113334,13147,11.6
5618,2010,September,Jefferson                                            ,Not Adjusted,100596,113362,12766,11.3
5619,2010,December,Jefferson                                            ,Not Adjusted,100902,114410,13508,11.8
5620,2010,March,Jim Hogg                                             ,Not Adjusted,2040,2298,258,11.2
5621,2010,June,Jim Hogg                                             ,Not Adjusted,2053,2304,251,10.9
5622,2010,September,Jim Hogg                                             ,Not Adjusted,2112,2343,231,9.9
5623,2010,December,Jim Hogg                                             ,Not Adjusted,2179,2405,226,9.4
5624,2010,March,Jim Wells                                            ,Not Adjusted,16015,17916,1901,10.6
5625,2010,June,Jim Wells                                            ,Not Adjusted,16377,18302,1925,10.5
5626,2010,September,Jim Wells                                            ,Not Adjusted,16819,18591,1772,9.5
5627,2010,December,Jim Wells                                            ,Not Adjusted,17058,18703,1645,8.8
5628,2010,March,Johnson                                              ,Not Adjusted,65154,71624,6470,9.0
5629,2010,June,Johnson                                              ,Not Adjusted,65717,72257,6540,9.1
5630,2010,September,Johnson                                              ,Not Adjusted,66123,72199,6076,8.4
5631,2010,December,Johnson                                              ,Not Adjusted,66485,72444,5959,8.2
5632,2010,March,Jones                                                ,Not Adjusted,5594,6164,570,9.2
5633,2010,June,Jones                                                ,Not Adjusted,5661,6234,573,9.2
5634,2010,September,Jones                                                ,Not Adjusted,5647,6174,527,8.5
5635,2010,December,Jones                                                ,Not Adjusted,5639,6134,495,8.1
5636,2010,March,Karnes                                               ,Not Adjusted,4442,4888,446,9.1
5637,2010,June,Karnes                                               ,Not Adjusted,4469,4954,485,9.8
5638,2010,September,Karnes                                               ,Not Adjusted,4376,4811,435,9.0
5639,2010,December,Karnes                                               ,Not Adjusted,4431,4816,385,8.0
5640,2010,March,Kaufman                                              ,Not Adjusted,45874,50236,4362,8.7
5641,2010,June,Kaufman                                              ,Not Adjusted,46437,50948,4511,8.9
5642,2010,September,Kaufman                                              ,Not Adjusted,46903,51126,4223,8.3
5643,2010,December,Kaufman                                              ,Not Adjusted,47114,51296,4182,8.2
5644,2010,March,Kendall                                              ,Not Adjusted,15280,16314,1034,6.3
5645,2010,June,Kendall                                              ,Not Adjusted,15498,16566,1068,6.4
5646,2010,September,Kendall                                              ,Not Adjusted,15464,16470,1006,6.1
5647,2010,December,Kendall                                              ,Not Adjusted,15513,16500,987,6.0
5648,2010,March,Kenedy                                               ,Not Adjusted,184,204,20,9.8
5649,2010,June,Kenedy                                               ,Not Adjusted,211,225,14,6.2
5650,2010,September,Kenedy                                               ,Not Adjusted,224,237,13,5.5
5651,2010,December,Kenedy                                               ,Not Adjusted,208,221,13,5.9
5652,2010,March,Kent                                                 ,Not Adjusted,535,559,24,4.3
5653,2010,June,Kent                                                 ,Not Adjusted,535,567,32,5.6
5654,2010,September,Kent                                                 ,Not Adjusted,520,547,27,4.9
5655,2010,December,Kent                                                 ,Not Adjusted,547,571,24,4.2
5656,2010,March,Kerr                                                 ,Not Adjusted,20251,21709,1458,6.7
5657,2010,June,Kerr                                                 ,Not Adjusted,20788,22298,1510,6.8
5658,2010,September,Kerr                                                 ,Not Adjusted,20419,21888,1469,6.7
5659,2010,December,Kerr                                                 ,Not Adjusted,20398,21804,1406,6.4
5660,2010,March,Kimble                                               ,Not Adjusted,2135,2268,133,5.9
5661,2010,June,Kimble                                               ,Not Adjusted,2189,2325,136,5.8
5662,2010,September,Kimble                                               ,Not Adjusted,2134,2274,140,6.2
5663,2010,December,Kimble                                               ,Not Adjusted,2153,2299,146,6.4
5664,2010,March,King                                                 ,Not Adjusted,259,271,12,4.4
5665,2010,June,King                                                 ,Not Adjusted,291,302,11,3.6
5666,2010,September,King                                                 ,Not Adjusted,276,288,12,4.2
5667,2010,December,King                                                 ,Not Adjusted,261,273,12,4.4
5668,2010,March,Kinney                                               ,Not Adjusted,1132,1286,154,12.0
5669,2010,June,Kinney                                               ,Not Adjusted,1145,1279,134,10.5
5670,2010,September,Kinney                                               ,Not Adjusted,1136,1274,138,10.8
5671,2010,December,Kinney                                               ,Not Adjusted,1120,1267,147,11.6
5672,2010,March,Kleberg                                              ,Not Adjusted,13811,15049,1238,8.2
5673,2010,June,Kleberg                                              ,Not Adjusted,13852,15209,1357,8.9
5674,2010,September,Kleberg                                              ,Not Adjusted,13808,15066,1258,8.3
5675,2010,December,Kleberg                                              ,Not Adjusted,13805,15065,1260,8.4
5676,2010,March,Knox                                                 ,Not Adjusted,1734,1842,108,5.9
5677,2010,June,Knox                                                 ,Not Adjusted,1863,1984,121,6.1
5678,2010,September,Knox                                                 ,Not Adjusted,1824,1934,110,5.7
5679,2010,December,Knox                                                 ,Not Adjusted,1796,1897,101,5.3
5680,2010,March,Lamar                                                ,Not Adjusted,21169,23280,2111,9.1
5681,2010,June,Lamar                                                ,Not Adjusted,21208,23428,2220,9.5
5682,2010,September,Lamar                                                ,Not Adjusted,21085,23381,2296,9.8
5683,2010,December,Lamar                                                ,Not Adjusted,20972,23287,2315,9.9
5684,2010,March,Lamb                                                 ,Not Adjusted,6179,6726,547,8.1
5685,2010,June,Lamb                                                 ,Not Adjusted,6483,7033,550,7.8
5686,2010,September,Lamb                                                 ,Not Adjusted,6367,6853,486,7.1
5687,2010,December,Lamb                                                 ,Not Adjusted,6314,6779,465,6.9
5688,2010,March,Lampasas                                             ,Not Adjusted,8306,8931,625,7.0
5689,2010,June,Lampasas                                             ,Not Adjusted,8406,9079,673,7.4
5690,2010,September,Lampasas                                             ,Not Adjusted,8444,9079,635,7.0
5691,2010,December,Lampasas                                             ,Not Adjusted,8425,9104,679,7.5
5692,2010,March,La Salle                                             ,Not Adjusted,2370,2622,252,9.6
5693,2010,June,La Salle                                             ,Not Adjusted,2474,2730,256,9.4
5694,2010,September,La Salle                                             ,Not Adjusted,2553,2796,243,8.7
5695,2010,December,La Salle                                             ,Not Adjusted,2632,2870,238,8.3
5696,2010,March,Lavaca                                               ,Not Adjusted,8922,9546,624,6.5
5697,2010,June,Lavaca                                               ,Not Adjusted,9057,9775,718,7.3
5698,2010,September,Lavaca                                               ,Not Adjusted,9101,9792,691,7.1
5699,2010,December,Lavaca                                               ,Not Adjusted,9136,9763,627,6.4
5700,2010,March,Lee                                                  ,Not Adjusted,7195,7792,597,7.7
5701,2010,June,Lee                                                  ,Not Adjusted,7833,8484,651,7.7
5702,2010,September,Lee                                                  ,Not Adjusted,7948,8542,594,7.0
5703,2010,December,Lee                                                  ,Not Adjusted,7821,8366,545,6.5
5704,2010,March,Leon                                                 ,Not Adjusted,6603,7261,658,9.1
5705,2010,June,Leon                                                 ,Not Adjusted,6811,7480,669,8.9
5706,2010,September,Leon                                                 ,Not Adjusted,6714,7331,617,8.4
5707,2010,December,Leon                                                 ,Not Adjusted,6598,7231,633,8.8
5708,2010,March,Liberty                                              ,Not Adjusted,26750,30360,3610,11.9
5709,2010,June,Liberty                                              ,Not Adjusted,27030,30691,3661,11.9
5710,2010,September,Liberty                                              ,Not Adjusted,27276,30869,3593,11.6
5711,2010,December,Liberty                                              ,Not Adjusted,27347,30972,3625,11.7
5712,2010,March,Limestone                                            ,Not Adjusted,9152,9926,774,7.8
5713,2010,June,Limestone                                            ,Not Adjusted,9339,10171,832,8.2
5714,2010,September,Limestone                                            ,Not Adjusted,9152,9953,801,8.0
5715,2010,December,Limestone                                            ,Not Adjusted,9037,9802,765,7.8
5716,2010,March,Lipscomb                                             ,Not Adjusted,1565,1670,105,6.3
5717,2010,June,Lipscomb                                             ,Not Adjusted,1617,1724,107,6.2
5718,2010,September,Lipscomb                                             ,Not Adjusted,1599,1690,91,5.4
5719,2010,December,Lipscomb                                             ,Not Adjusted,1624,1704,80,4.7
5720,2010,March,Live Oak                                             ,Not Adjusted,4189,4552,363,8.0
5721,2010,June,Live Oak                                             ,Not Adjusted,4264,4626,362,7.8
5722,2010,September,Live Oak                                             ,Not Adjusted,4429,4744,315,6.6
5723,2010,December,Live Oak                                             ,Not Adjusted,4528,4833,305,6.3
5724,2010,March,Llano                                                ,Not Adjusted,7285,7955,670,8.4
5725,2010,June,Llano                                                ,Not Adjusted,7558,8197,639,7.8
5726,2010,September,Llano                                                ,Not Adjusted,7367,7987,620,7.8
5727,2010,December,Llano                                                ,Not Adjusted,7323,7937,614,7.7
5728,2010,March,Loving                                               ,Not Adjusted,68,73,5,6.8
5729,2010,June,Loving                                               ,Not Adjusted,75,79,4,5.1
5730,2010,September,Loving                                               ,Not Adjusted,63,67,4,6.0
5731,2010,December,Loving                                               ,Not Adjusted,58,62,4,6.5
5732,2010,March,Lubbock                                              ,Not Adjusted,132785,141533,8748,6.2
5733,2010,June,Lubbock                                              ,Not Adjusted,133893,143751,9858,6.9
5734,2010,September,Lubbock                                              ,Not Adjusted,135136,144067,8931,6.2
5735,2010,December,Lubbock                                              ,Not Adjusted,136746,145333,8587,5.9
5736,2010,March,Lynn                                                 ,Not Adjusted,2814,3023,209,6.9
5737,2010,June,Lynn                                                 ,Not Adjusted,2921,3144,223,7.1
5738,2010,September,Lynn                                                 ,Not Adjusted,2902,3099,197,6.4
5739,2010,December,Lynn                                                 ,Not Adjusted,2908,3080,172,5.6
5740,2010,March,McCulloch                                            ,Not Adjusted,3620,3965,345,8.7
5741,2010,June,McCulloch                                            ,Not Adjusted,3850,4153,303,7.3
5742,2010,September,McCulloch                                            ,Not Adjusted,3948,4218,270,6.4
5743,2010,December,McCulloch                                            ,Not Adjusted,4051,4310,259,6.0
5744,2010,March,McLennan                                             ,Not Adjusted,103583,111928,8345,7.5
5745,2010,June,McLennan                                             ,Not Adjusted,105345,114048,8703,7.6
5746,2010,September,McLennan                                             ,Not Adjusted,105417,113713,8296,7.3
5747,2010,December,McLennan                                             ,Not Adjusted,104544,112746,8202,7.3
5748,2010,March,McMullen                                             ,Not Adjusted,444,462,18,3.9
5749,2010,June,McMullen                                             ,Not Adjusted,457,482,25,5.2
5750,2010,September,McMullen                                             ,Not Adjusted,472,491,19,3.9
5751,2010,December,McMullen                                             ,Not Adjusted,530,549,19,3.5
5752,2010,March,Madison                                              ,Not Adjusted,4383,4782,399,8.3
5753,2010,June,Madison                                              ,Not Adjusted,4414,4840,426,8.8
5754,2010,September,Madison                                              ,Not Adjusted,4395,4794,399,8.3
5755,2010,December,Madison                                              ,Not Adjusted,4354,4734,380,8.0
5756,2010,March,Marion                                               ,Not Adjusted,3931,4510,579,12.8
5757,2010,June,Marion                                               ,Not Adjusted,4011,4533,522,11.5
5758,2010,September,Marion                                               ,Not Adjusted,4022,4524,502,11.1
5759,2010,December,Marion                                               ,Not Adjusted,3977,4460,483,10.8
5760,2010,March,Martin                                               ,Not Adjusted,2005,2136,131,6.1
5761,2010,June,Martin                                               ,Not Adjusted,2087,2232,145,6.5
5762,2010,September,Martin                                               ,Not Adjusted,2108,2242,134,6.0
5763,2010,December,Martin                                               ,Not Adjusted,2121,2249,128,5.7
5764,2010,March,Mason                                                ,Not Adjusted,1869,1999,130,6.5
5765,2010,June,Mason                                                ,Not Adjusted,1921,2055,134,6.5
5766,2010,September,Mason                                                ,Not Adjusted,1858,1986,128,6.4
5767,2010,December,Mason                                                ,Not Adjusted,1868,1993,125,6.3
5768,2010,March,Matagorda                                            ,Not Adjusted,16604,18620,2016,10.8
5769,2010,June,Matagorda                                            ,Not Adjusted,16266,18456,2190,11.9
5770,2010,September,Matagorda                                            ,Not Adjusted,15951,18037,2086,11.6
5771,2010,December,Matagorda                                            ,Not Adjusted,15758,17917,2159,12.1
5772,2010,March,Maverick                                             ,Not Adjusted,20002,24070,4068,16.9
5773,2010,June,Maverick                                             ,Not Adjusted,19891,23398,3507,15.0
5774,2010,September,Maverick                                             ,Not Adjusted,20041,23118,3077,13.3
5775,2010,December,Maverick                                             ,Not Adjusted,20432,23968,3536,14.8
5776,2010,March,Medina                                               ,Not Adjusted,18368,19845,1477,7.4
5777,2010,June,Medina                                               ,Not Adjusted,18635,20192,1557,7.7
5778,2010,September,Medina                                               ,Not Adjusted,18602,20138,1536,7.6
5779,2010,December,Medina                                               ,Not Adjusted,18636,20134,1498,7.4
5780,2010,March,Menard                                               ,Not Adjusted,957,1035,78,7.5
5781,2010,June,Menard                                               ,Not Adjusted,951,1025,74,7.2
5782,2010,September,Menard                                               ,Not Adjusted,926,997,71,7.1
5783,2010,December,Menard                                               ,Not Adjusted,884,955,71,7.4
5784,2010,March,Midland                                              ,Not Adjusted,65378,69729,4351,6.2
5785,2010,June,Midland                                              ,Not Adjusted,66863,71296,4433,6.2
5786,2010,September,Midland                                              ,Not Adjusted,68453,72473,4020,5.5
5787,2010,December,Midland                                              ,Not Adjusted,69295,73045,3750,5.1
5788,2010,March,Milam                                                ,Not Adjusted,9311,10519,1208,11.5
5789,2010,June,Milam                                                ,Not Adjusted,9500,10704,1204,11.2
5790,2010,September,Milam                                                ,Not Adjusted,9421,10602,1181,11.1
5791,2010,December,Milam                                                ,Not Adjusted,9350,10472,1122,10.7
5792,2010,March,Mills                                                ,Not Adjusted,2025,2161,136,6.3
5793,2010,June,Mills                                                ,Not Adjusted,2111,2258,147,6.5
5794,2010,September,Mills                                                ,Not Adjusted,2065,2202,137,6.2
5795,2010,December,Mills                                                ,Not Adjusted,2063,2201,138,6.3
5796,2010,March,Mitchell                                             ,Not Adjusted,2701,2963,262,8.8
5797,2010,June,Mitchell                                             ,Not Adjusted,2775,3035,260,8.6
5798,2010,September,Mitchell                                             ,Not Adjusted,2737,2964,227,7.7
5799,2010,December,Mitchell                                             ,Not Adjusted,2733,2957,224,7.6
5800,2010,March,Montague                                             ,Not Adjusted,8547,9359,812,8.7
5801,2010,June,Montague                                             ,Not Adjusted,8743,9534,791,8.3
5802,2010,September,Montague                                             ,Not Adjusted,8782,9514,732,7.7
5803,2010,December,Montague                                             ,Not Adjusted,8866,9539,673,7.1
5804,2010,March,Montgomery                                           ,Not Adjusted,205414,222685,17271,7.8
5805,2010,June,Montgomery                                           ,Not Adjusted,207101,224543,17442,7.8
5806,2010,September,Montgomery                                           ,Not Adjusted,209187,226076,16889,7.5
5807,2010,December,Montgomery                                           ,Not Adjusted,209915,226239,16324,7.2
5808,2010,March,Moore                                                ,Not Adjusted,10687,11327,640,5.7
5809,2010,June,Moore                                                ,Not Adjusted,11076,11718,642,5.5
5810,2010,September,Moore                                                ,Not Adjusted,11177,11784,607,5.2
5811,2010,December,Moore                                                ,Not Adjusted,10989,11585,596,5.1
5812,2010,March,Morris                                               ,Not Adjusted,4910,5745,835,14.5
5813,2010,June,Morris                                               ,Not Adjusted,4951,5738,787,13.7
5814,2010,September,Morris                                               ,Not Adjusted,5086,5858,772,13.2
5815,2010,December,Morris                                               ,Not Adjusted,5052,5804,752,13.0
5816,2010,March,Motley                                               ,Not Adjusted,584,625,41,6.6
5817,2010,June,Motley                                               ,Not Adjusted,614,655,41,6.3
5818,2010,September,Motley                                               ,Not Adjusted,591,628,37,5.9
5819,2010,December,Motley                                               ,Not Adjusted,561,598,37,6.2
5820,2010,March,Nacogdoches                                          ,Not Adjusted,28446,30622,2176,7.1
5821,2010,June,Nacogdoches                                          ,Not Adjusted,28546,30900,2354,7.6
5822,2010,September,Nacogdoches                                          ,Not Adjusted,29011,31160,2149,6.9
5823,2010,December,Nacogdoches                                          ,Not Adjusted,28670,30761,2091,6.8
5824,2010,March,Navarro                                              ,Not Adjusted,20622,22477,1855,8.3
5825,2010,June,Navarro                                              ,Not Adjusted,20823,22784,1961,8.6
5826,2010,September,Navarro                                              ,Not Adjusted,21080,22932,1852,8.1
5827,2010,December,Navarro                                              ,Not Adjusted,21524,23322,1798,7.7
5828,2010,March,Newton                                               ,Not Adjusted,5159,5933,774,13.0
5829,2010,June,Newton                                               ,Not Adjusted,5188,5972,784,13.1
5830,2010,September,Newton                                               ,Not Adjusted,5201,5971,770,12.9
5831,2010,December,Newton                                               ,Not Adjusted,5211,6011,800,13.3
5832,2010,March,Nolan                                                ,Not Adjusted,6728,7320,592,8.1
5833,2010,June,Nolan                                                ,Not Adjusted,6820,7401,581,7.9
5834,2010,September,Nolan                                                ,Not Adjusted,6785,7305,520,7.1
5835,2010,December,Nolan                                                ,Not Adjusted,6869,7367,498,6.8
5836,2010,March,Nueces                                               ,Not Adjusted,150885,163758,12873,7.9
5837,2010,June,Nueces                                               ,Not Adjusted,149348,163168,13820,8.5
5838,2010,September,Nueces                                               ,Not Adjusted,149050,162344,13294,8.2
5839,2010,December,Nueces                                               ,Not Adjusted,148468,162099,13631,8.4
5840,2010,March,Ochiltree                                            ,Not Adjusted,4401,4704,303,6.4
5841,2010,June,Ochiltree                                            ,Not Adjusted,4688,4999,311,6.2
5842,2010,September,Ochiltree                                            ,Not Adjusted,4665,4939,274,5.5
5843,2010,December,Ochiltree                                            ,Not Adjusted,4712,4954,242,4.9
5844,2010,March,Oldham                                               ,Not Adjusted,900,947,47,5.0
5845,2010,June,Oldham                                               ,Not Adjusted,928,971,43,4.4
5846,2010,September,Oldham                                               ,Not Adjusted,927,973,46,4.7
5847,2010,December,Oldham                                               ,Not Adjusted,927,973,46,4.7
5848,2010,March,Orange                                               ,Not Adjusted,33850,38402,4552,11.9
5849,2010,June,Orange                                               ,Not Adjusted,33898,38446,4548,11.8
5850,2010,September,Orange                                               ,Not Adjusted,34051,38555,4504,11.7
5851,2010,December,Orange                                               ,Not Adjusted,34167,38822,4655,12.0
5852,2010,March,Palo Pinto                                           ,Not Adjusted,11998,13157,1159,8.8
5853,2010,June,Palo Pinto                                           ,Not Adjusted,12325,13475,1150,8.5
5854,2010,September,Palo Pinto                                           ,Not Adjusted,12170,13291,1121,8.4
5855,2010,December,Palo Pinto                                           ,Not Adjusted,12151,13292,1141,8.6
5856,2010,March,Panola                                               ,Not Adjusted,10213,11295,1082,9.6
5857,2010,June,Panola                                               ,Not Adjusted,10451,11509,1058,9.2
5858,2010,September,Panola                                               ,Not Adjusted,10728,11710,982,8.4
5859,2010,December,Panola                                               ,Not Adjusted,10402,11389,987,8.7
5860,2010,March,Parker                                               ,Not Adjusted,51671,56105,4434,7.9
5861,2010,June,Parker                                               ,Not Adjusted,52178,56637,4459,7.9
5862,2010,September,Parker                                               ,Not Adjusted,52452,56672,4220,7.4
5863,2010,December,Parker                                               ,Not Adjusted,52741,56831,4090,7.2
5864,2010,March,Parmer                                               ,Not Adjusted,5002,5240,238,4.5
5865,2010,June,Parmer                                               ,Not Adjusted,5266,5524,258,4.7
5866,2010,September,Parmer                                               ,Not Adjusted,5281,5503,222,4.0
5867,2010,December,Parmer                                               ,Not Adjusted,5091,5308,217,4.1
5868,2010,March,Pecos                                                ,Not Adjusted,6685,7218,533,7.4
5869,2010,June,Pecos                                                ,Not Adjusted,6683,7223,540,7.5
5870,2010,September,Pecos                                                ,Not Adjusted,6700,7233,533,7.4
5871,2010,December,Pecos                                                ,Not Adjusted,6566,7050,484,6.9
5872,2010,March,Polk                                                 ,Not Adjusted,15877,17629,1752,9.9
5873,2010,June,Polk                                                 ,Not Adjusted,15973,17669,1696,9.6
5874,2010,September,Polk                                                 ,Not Adjusted,15824,17558,1734,9.9
5875,2010,December,Polk                                                 ,Not Adjusted,15948,17673,1725,9.8
5876,2010,March,Potter                                               ,Not Adjusted,53760,57460,3700,6.4
5877,2010,June,Potter                                               ,Not Adjusted,54142,57964,3822,6.6
5878,2010,September,Potter                                               ,Not Adjusted,54715,58330,3615,6.2
5879,2010,December,Potter                                               ,Not Adjusted,55120,58627,3507,6.0
5880,2010,March,Presidio                                             ,Not Adjusted,3003,3738,735,19.7
5881,2010,June,Presidio                                             ,Not Adjusted,3088,3824,736,19.2
5882,2010,September,Presidio                                             ,Not Adjusted,3073,3799,726,19.1
5883,2010,December,Presidio                                             ,Not Adjusted,3075,3763,688,18.3
5884,2010,March,Rains                                                ,Not Adjusted,4723,5202,479,9.2
5885,2010,June,Rains                                                ,Not Adjusted,4684,5154,470,9.1
5886,2010,September,Rains                                                ,Not Adjusted,4749,5201,452,8.7
5887,2010,December,Rains                                                ,Not Adjusted,4725,5153,428,8.3
5888,2010,March,Randall                                              ,Not Adjusted,62041,65452,3411,5.2
5889,2010,June,Randall                                              ,Not Adjusted,62608,66217,3609,5.5
5890,2010,September,Randall                                              ,Not Adjusted,63248,66643,3395,5.1
5891,2010,December,Randall                                              ,Not Adjusted,63631,66929,3298,4.9
5892,2010,March,Reagan                                               ,Not Adjusted,1715,1830,115,6.3
5893,2010,June,Reagan                                               ,Not Adjusted,1771,1878,107,5.7
5894,2010,September,Reagan                                               ,Not Adjusted,1846,1940,94,4.8
5895,2010,December,Reagan                                               ,Not Adjusted,1964,2062,98,4.8
5896,2010,March,Real                                                 ,Not Adjusted,1035,1134,99,8.7
5897,2010,June,Real                                                 ,Not Adjusted,1118,1228,110,9.0
5898,2010,September,Real                                                 ,Not Adjusted,1031,1133,102,9.0
5899,2010,December,Real                                                 ,Not Adjusted,980,1081,101,9.3
5900,2010,March,Red River                                            ,Not Adjusted,5013,5662,649,11.5
5901,2010,June,Red River                                            ,Not Adjusted,4974,5646,672,11.9
5902,2010,September,Red River                                            ,Not Adjusted,4925,5588,663,11.9
5903,2010,December,Red River                                            ,Not Adjusted,4873,5521,648,11.7
5904,2010,March,Reeves                                               ,Not Adjusted,5172,5695,523,9.2
5905,2010,June,Reeves                                               ,Not Adjusted,5338,5886,548,9.3
5906,2010,September,Reeves                                               ,Not Adjusted,5353,5836,483,8.3
5907,2010,December,Reeves                                               ,Not Adjusted,5186,5650,464,8.2
5908,2010,March,Refugio                                              ,Not Adjusted,3027,3324,297,8.9
5909,2010,June,Refugio                                              ,Not Adjusted,3089,3392,303,8.9
5910,2010,September,Refugio                                              ,Not Adjusted,3057,3341,284,8.5
5911,2010,December,Refugio                                              ,Not Adjusted,3059,3337,278,8.3
5912,2010,March,Roberts                                              ,Not Adjusted,444,474,30,6.3
5913,2010,June,Roberts                                              ,Not Adjusted,470,497,27,5.4
5914,2010,September,Roberts                                              ,Not Adjusted,458,480,22,4.6
5915,2010,December,Roberts                                              ,Not Adjusted,473,498,25,5.0
5916,2010,March,Robertson                                            ,Not Adjusted,6871,7575,704,9.3
5917,2010,June,Robertson                                            ,Not Adjusted,6709,7444,735,9.9
5918,2010,September,Robertson                                            ,Not Adjusted,6993,7660,667,8.7
5919,2010,December,Robertson                                            ,Not Adjusted,6982,7694,712,9.3
5920,2010,March,Rockwall                                             ,Not Adjusted,36053,39003,2950,7.6
5921,2010,June,Rockwall                                             ,Not Adjusted,36474,39488,3014,7.6
5922,2010,September,Rockwall                                             ,Not Adjusted,36830,39717,2887,7.3
5923,2010,December,Rockwall                                             ,Not Adjusted,37022,39883,2861,7.2
5924,2010,March,Runnels                                              ,Not Adjusted,4661,5099,438,8.6
5925,2010,June,Runnels                                              ,Not Adjusted,4811,5254,443,8.4
5926,2010,September,Runnels                                              ,Not Adjusted,4697,5155,458,8.9
5927,2010,December,Runnels                                              ,Not Adjusted,4756,5111,355,6.9
5928,2010,March,Rusk                                                 ,Not Adjusted,21866,23782,1916,8.1
5929,2010,June,Rusk                                                 ,Not Adjusted,22033,23970,1937,8.1
5930,2010,September,Rusk                                                 ,Not Adjusted,22394,24234,1840,7.6
5931,2010,December,Rusk                                                 ,Not Adjusted,22259,24035,1776,7.4
5932,2010,March,Sabine                                               ,Not Adjusted,3063,3699,636,17.2
5933,2010,June,Sabine                                               ,Not Adjusted,3162,3767,605,16.1
5934,2010,September,Sabine                                               ,Not Adjusted,3097,3674,577,15.7
5935,2010,December,Sabine                                               ,Not Adjusted,2919,3521,602,17.1
5936,2010,March,San Augustine                                        ,Not Adjusted,2750,3163,413,13.1
5937,2010,June,San Augustine                                        ,Not Adjusted,2829,3275,446,13.6
5938,2010,September,San Augustine                                        ,Not Adjusted,2804,3213,409,12.7
5939,2010,December,San Augustine                                        ,Not Adjusted,2781,3200,419,13.1
5940,2010,March,San Jacinto                                          ,Not Adjusted,10080,11210,1130,10.1
5941,2010,June,San Jacinto                                          ,Not Adjusted,10224,11332,1108,9.8
5942,2010,September,San Jacinto                                          ,Not Adjusted,10110,11247,1137,10.1
5943,2010,December,San Jacinto                                          ,Not Adjusted,10073,11237,1164,10.4
5944,2010,March,San Patricio                                         ,Not Adjusted,27504,30683,3179,10.4
5945,2010,June,San Patricio                                         ,Not Adjusted,27303,30647,3344,10.9
5946,2010,September,San Patricio                                         ,Not Adjusted,27218,30347,3129,10.3
5947,2010,December,San Patricio                                         ,Not Adjusted,27077,30419,3342,11.0
5948,2010,March,San Saba                                             ,Not Adjusted,2378,2538,160,6.3
5949,2010,June,San Saba                                             ,Not Adjusted,2356,2521,165,6.5
5950,2010,September,San Saba                                             ,Not Adjusted,2423,2578,155,6.0
5951,2010,December,San Saba                                             ,Not Adjusted,2462,2614,152,5.8
5952,2010,March,Schleicher                                           ,Not Adjusted,1454,1581,127,8.0
5953,2010,June,Schleicher                                           ,Not Adjusted,1534,1660,126,7.6
5954,2010,September,Schleicher                                           ,Not Adjusted,1551,1676,125,7.5
5955,2010,December,Schleicher                                           ,Not Adjusted,1568,1679,111,6.6
5956,2010,March,Scurry                                               ,Not Adjusted,6454,6972,518,7.4
5957,2010,June,Scurry                                               ,Not Adjusted,6651,7187,536,7.5
5958,2010,September,Scurry                                               ,Not Adjusted,6721,7188,467,6.5
5959,2010,December,Scurry                                               ,Not Adjusted,6764,7189,425,5.9
5960,2010,March,Shackelford                                          ,Not Adjusted,1708,1809,101,5.6
5961,2010,June,Shackelford                                          ,Not Adjusted,1891,1998,107,5.4
5962,2010,September,Shackelford                                          ,Not Adjusted,1788,1900,112,5.9
5963,2010,December,Shackelford                                          ,Not Adjusted,1842,1948,106,5.4
5964,2010,March,Shelby                                               ,Not Adjusted,10607,11553,946,8.2
5965,2010,June,Shelby                                               ,Not Adjusted,10942,12005,1063,8.9
5966,2010,September,Shelby                                               ,Not Adjusted,11023,12038,1015,8.4
5967,2010,December,Shelby                                               ,Not Adjusted,11058,12048,990,8.2
5968,2010,March,Sherman                                              ,Not Adjusted,1484,1556,72,4.6
5969,2010,June,Sherman                                              ,Not Adjusted,1561,1638,77,4.7
5970,2010,September,Sherman                                              ,Not Adjusted,1496,1568,72,4.6
5971,2010,December,Sherman                                              ,Not Adjusted,1486,1554,68,4.4
5972,2010,March,Smith                                                ,Not Adjusted,91673,99774,8101,8.1
5973,2010,June,Smith                                                ,Not Adjusted,93242,101463,8221,8.1
5974,2010,September,Smith                                                ,Not Adjusted,93779,101642,7863,7.7
5975,2010,December,Smith                                                ,Not Adjusted,94224,102334,8110,7.9
5976,2010,March,Somervell                                            ,Not Adjusted,3691,4007,316,7.9
5977,2010,June,Somervell                                            ,Not Adjusted,3722,4062,340,8.4
5978,2010,September,Somervell                                            ,Not Adjusted,3744,4059,315,7.8
5979,2010,December,Somervell                                            ,Not Adjusted,3767,4103,336,8.2
5980,2010,March,Starr                                                ,Not Adjusted,21363,26332,4969,18.9
5981,2010,June,Starr                                                ,Not Adjusted,21335,25794,4459,17.3
5982,2010,September,Starr                                                ,Not Adjusted,21657,25771,4114,16.0
5983,2010,December,Starr                                                ,Not Adjusted,21905,26635,4730,17.8
5984,2010,March,Stephens                                             ,Not Adjusted,3861,4194,333,7.9
5985,2010,June,Stephens                                             ,Not Adjusted,4024,4337,313,7.2
5986,2010,September,Stephens                                             ,Not Adjusted,3983,4289,306,7.1
5987,2010,December,Stephens                                             ,Not Adjusted,4005,4377,372,8.5
5988,2010,March,Sterling                                             ,Not Adjusted,626,659,33,5.0
5989,2010,June,Sterling                                             ,Not Adjusted,666,700,34,4.9
5990,2010,September,Sterling                                             ,Not Adjusted,650,677,27,4.0
5991,2010,December,Sterling                                             ,Not Adjusted,648,679,31,4.6
5992,2010,March,Stonewall                                            ,Not Adjusted,671,710,39,5.5
5993,2010,June,Stonewall                                            ,Not Adjusted,740,787,47,6.0
5994,2010,September,Stonewall                                            ,Not Adjusted,723,769,46,6.0
5995,2010,December,Stonewall                                            ,Not Adjusted,689,729,40,5.5
5996,2010,March,Sutton                                               ,Not Adjusted,1792,2015,223,11.1
5997,2010,June,Sutton                                               ,Not Adjusted,1816,2013,197,9.8
5998,2010,September,Sutton                                               ,Not Adjusted,1802,1973,171,8.7
5999,2010,December,Sutton                                               ,Not Adjusted,1781,1942,161,8.3
6000,2010,March,Swisher                                              ,Not Adjusted,2933,3148,215,6.8
6001,2010,June,Swisher                                              ,Not Adjusted,3031,3246,215,6.6
6002,2010,September,Swisher                                              ,Not Adjusted,3001,3197,196,6.1
6003,2010,December,Swisher                                              ,Not Adjusted,2993,3186,193,6.1
6004,2010,March,Tarrant                                              ,Not Adjusted,842778,919498,76720,8.3
6005,2010,June,Tarrant                                              ,Not Adjusted,848864,926388,77524,8.4
6006,2010,September,Tarrant                                              ,Not Adjusted,854763,929700,74937,8.1
6007,2010,December,Tarrant                                              ,Not Adjusted,859762,932941,73179,7.8
6008,2010,March,Taylor                                               ,Not Adjusted,59865,64148,4283,6.7
6009,2010,June,Taylor                                               ,Not Adjusted,59823,64401,4578,7.1
6010,2010,September,Taylor                                               ,Not Adjusted,60051,64449,4398,6.8
6011,2010,December,Taylor                                               ,Not Adjusted,60138,64359,4221,6.6
6012,2010,March,Terrell                                              ,Not Adjusted,457,492,35,7.1
6013,2010,June,Terrell                                              ,Not Adjusted,473,507,34,6.7
6014,2010,September,Terrell                                              ,Not Adjusted,484,524,40,7.6
6015,2010,December,Terrell                                              ,Not Adjusted,471,504,33,6.5
6016,2010,March,Terry                                                ,Not Adjusted,5230,5684,454,8.0
6017,2010,June,Terry                                                ,Not Adjusted,5400,5859,459,7.8
6018,2010,September,Terry                                                ,Not Adjusted,5383,5781,398,6.9
6019,2010,December,Terry                                                ,Not Adjusted,5415,5822,407,7.0
6020,2010,March,Throckmorton                                         ,Not Adjusted,813,863,50,5.8
6021,2010,June,Throckmorton                                         ,Not Adjusted,859,912,53,5.8
6022,2010,September,Throckmorton                                         ,Not Adjusted,836,891,55,6.2
6023,2010,December,Throckmorton                                         ,Not Adjusted,816,868,52,6.0
6024,2010,March,Titus                                                ,Not Adjusted,12863,14040,1177,8.4
6025,2010,June,Titus                                                ,Not Adjusted,12908,14160,1252,8.8
6026,2010,September,Titus                                                ,Not Adjusted,12832,14047,1215,8.6
6027,2010,December,Titus                                                ,Not Adjusted,12651,13815,1164,8.4
6028,2010,March,Tom Green                                            ,Not Adjusted,48703,52170,3467,6.6
6029,2010,June,Tom Green                                            ,Not Adjusted,49348,52924,3576,6.8
6030,2010,September,Tom Green                                            ,Not Adjusted,49478,52904,3426,6.5
6031,2010,December,Tom Green                                            ,Not Adjusted,49511,52888,3377,6.4
6032,2010,March,Travis                                               ,Not Adjusted,531592,570860,39268,6.9
6033,2010,June,Travis                                               ,Not Adjusted,535573,575998,40425,7.0
6034,2010,September,Travis                                               ,Not Adjusted,539740,578549,38809,6.7
6035,2010,December,Travis                                               ,Not Adjusted,544766,582304,37538,6.4
6036,2010,March,Trinity                                              ,Not Adjusted,5194,5762,568,9.9
6037,2010,June,Trinity                                              ,Not Adjusted,5301,5874,573,9.8
6038,2010,September,Trinity                                              ,Not Adjusted,5282,5831,549,9.4
6039,2010,December,Trinity                                              ,Not Adjusted,5217,5779,562,9.7
6040,2010,March,Tyler                                                ,Not Adjusted,6919,7876,957,12.2
6041,2010,June,Tyler                                                ,Not Adjusted,7163,8128,965,11.9
6042,2010,September,Tyler                                                ,Not Adjusted,6974,7874,900,11.4
6043,2010,December,Tyler                                                ,Not Adjusted,6933,7893,960,12.2
6044,2010,March,Upshur                                               ,Not Adjusted,16504,18130,1626,9.0
6045,2010,June,Upshur                                               ,Not Adjusted,16632,18262,1630,8.9
6046,2010,September,Upshur                                               ,Not Adjusted,16904,18499,1595,8.6
6047,2010,December,Upshur                                               ,Not Adjusted,16802,18379,1577,8.6
6048,2010,March,Upton                                                ,Not Adjusted,1407,1512,105,6.9
6049,2010,June,Upton                                                ,Not Adjusted,1450,1547,97,6.3
6050,2010,September,Upton                                                ,Not Adjusted,1517,1604,87,5.4
6051,2010,December,Upton                                                ,Not Adjusted,1496,1579,83,5.3
6052,2010,March,Uvalde                                               ,Not Adjusted,10737,11771,1034,8.8
6053,2010,June,Uvalde                                               ,Not Adjusted,10952,12050,1098,9.1
6054,2010,September,Uvalde                                               ,Not Adjusted,10912,11999,1087,9.1
6055,2010,December,Uvalde                                               ,Not Adjusted,10760,11824,1064,9.0
6056,2010,March,Val Verde                                            ,Not Adjusted,18602,20586,1984,9.6
6057,2010,June,Val Verde                                            ,Not Adjusted,18997,20896,1899,9.1
6058,2010,September,Val Verde                                            ,Not Adjusted,18822,20674,1852,9.0
6059,2010,December,Val Verde                                            ,Not Adjusted,18666,20596,1930,9.4
6060,2010,March,Van Zandt                                            ,Not Adjusted,21460,23470,2010,8.6
6061,2010,June,Van Zandt                                            ,Not Adjusted,21944,23983,2039,8.5
6062,2010,September,Van Zandt                                            ,Not Adjusted,21686,23657,1971,8.3
6063,2010,December,Van Zandt                                            ,Not Adjusted,21538,23422,1884,8.0
6064,2010,March,Victoria                                             ,Not Adjusted,39513,43036,3523,8.2
6065,2010,June,Victoria                                             ,Not Adjusted,40264,43664,3400,7.8
6066,2010,September,Victoria                                             ,Not Adjusted,39908,43116,3208,7.4
6067,2010,December,Victoria                                             ,Not Adjusted,39834,42887,3053,7.1
6068,2010,March,Walker                                               ,Not Adjusted,21538,23319,1781,7.6
6069,2010,June,Walker                                               ,Not Adjusted,21280,23193,1913,8.2
6070,2010,September,Walker                                               ,Not Adjusted,21451,23279,1828,7.9
6071,2010,December,Walker                                               ,Not Adjusted,21500,23231,1731,7.5
6072,2010,March,Waller                                               ,Not Adjusted,18029,19727,1698,8.6
6073,2010,June,Waller                                               ,Not Adjusted,18259,20129,1870,9.3
6074,2010,September,Waller                                               ,Not Adjusted,18402,20105,1703,8.5
6075,2010,December,Waller                                               ,Not Adjusted,18437,20100,1663,8.3
6076,2010,March,Ward                                                 ,Not Adjusted,4136,4544,408,9.0
6077,2010,June,Ward                                                 ,Not Adjusted,4270,4692,422,9.0
6078,2010,September,Ward                                                 ,Not Adjusted,4289,4660,371,8.0
6079,2010,December,Ward                                                 ,Not Adjusted,4322,4680,358,7.6
6080,2010,March,Washington                                           ,Not Adjusted,14307,15448,1141,7.4
6081,2010,June,Washington                                           ,Not Adjusted,14524,15739,1215,7.7
6082,2010,September,Washington                                           ,Not Adjusted,14669,15741,1072,6.8
6083,2010,December,Washington                                           ,Not Adjusted,14585,15619,1034,6.6
6084,2010,March,Webb                                                 ,Not Adjusted,95457,104527,9070,8.7
6085,2010,June,Webb                                                 ,Not Adjusted,95596,104722,9126,8.7
6086,2010,September,Webb                                                 ,Not Adjusted,96786,105041,8255,7.9
6087,2010,December,Webb                                                 ,Not Adjusted,98452,106581,8129,7.6
6088,2010,March,Wharton                                              ,Not Adjusted,19277,21175,1898,9.0
6089,2010,June,Wharton                                              ,Not Adjusted,19537,21443,1906,8.9
6090,2010,September,Wharton                                              ,Not Adjusted,19647,21456,1809,8.4
6091,2010,December,Wharton                                              ,Not Adjusted,19623,21423,1800,8.4
6092,2010,March,Wheeler                                              ,Not Adjusted,2432,2616,184,7.0
6093,2010,June,Wheeler                                              ,Not Adjusted,2635,2809,174,6.2
6094,2010,September,Wheeler                                              ,Not Adjusted,2656,2806,150,5.3
6095,2010,December,Wheeler                                              ,Not Adjusted,2680,2824,144,5.1
6096,2010,March,Wichita                                              ,Not Adjusted,53978,58715,4737,8.1
6097,2010,June,Wichita                                              ,Not Adjusted,55138,59986,4848,8.1
6098,2010,September,Wichita                                              ,Not Adjusted,55151,59613,4462,7.5
6099,2010,December,Wichita                                              ,Not Adjusted,55215,59503,4288,7.2
6100,2010,March,Wilbarger                                            ,Not Adjusted,5624,6099,475,7.8
6101,2010,June,Wilbarger                                            ,Not Adjusted,5622,6154,532,8.6
6102,2010,September,Wilbarger                                            ,Not Adjusted,5677,6175,498,8.1
6103,2010,December,Wilbarger                                            ,Not Adjusted,5682,6156,474,7.7
6104,2010,March,Willacy                                              ,Not Adjusted,6767,7903,1136,14.4
6105,2010,June,Willacy                                              ,Not Adjusted,6742,7906,1164,14.7
6106,2010,September,Willacy                                              ,Not Adjusted,6543,7632,1089,14.3
6107,2010,December,Willacy                                              ,Not Adjusted,6560,7721,1161,15.0
6108,2010,March,Williamson                                           ,Not Adjusted,204424,221152,16728,7.6
6109,2010,June,Williamson                                           ,Not Adjusted,206016,222689,16673,7.5
6110,2010,September,Williamson                                           ,Not Adjusted,207709,223664,15955,7.1
6111,2010,December,Williamson                                           ,Not Adjusted,209503,224899,15396,6.8
6112,2010,March,Wilson                                               ,Not Adjusted,19654,21087,1433,6.8
6113,2010,June,Wilson                                               ,Not Adjusted,19867,21407,1540,7.2
6114,2010,September,Wilson                                               ,Not Adjusted,19868,21306,1438,6.7
6115,2010,December,Wilson                                               ,Not Adjusted,19924,21325,1401,6.6
6116,2010,March,Winkler                                              ,Not Adjusted,2534,2810,276,9.8
6117,2010,June,Winkler                                              ,Not Adjusted,2635,2917,282,9.7
6118,2010,September,Winkler                                              ,Not Adjusted,2639,2889,250,8.7
6119,2010,December,Winkler                                              ,Not Adjusted,2744,2980,236,7.9
6120,2010,March,Wise                                                 ,Not Adjusted,25044,27519,2475,9.0
6121,2010,June,Wise                                                 ,Not Adjusted,25332,27894,2562,9.2
6122,2010,September,Wise                                                 ,Not Adjusted,25440,27760,2320,8.4
6123,2010,December,Wise                                                 ,Not Adjusted,25571,27768,2197,7.9
6124,2010,March,Wood                                                 ,Not Adjusted,15351,16936,1585,9.4
6125,2010,June,Wood                                                 ,Not Adjusted,15565,17169,1604,9.3
6126,2010,September,Wood                                                 ,Not Adjusted,15567,17052,1485,8.7
6127,2010,December,Wood                                                 ,Not Adjusted,15416,16862,1446,8.6
6128,2010,March,Yoakum                                               ,Not Adjusted,3342,3612,270,7.5
6129,2010,June,Yoakum                                               ,Not Adjusted,3473,3758,285,7.6
6130,2010,September,Yoakum                                               ,Not Adjusted,3532,3779,247,6.5
6131,2010,December,Yoakum                                               ,Not Adjusted,3550,3765,215,5.7
6132,2010,March,Young                                                ,Not Adjusted,8000,8684,684,7.9
6133,2010,June,Young                                                ,Not Adjusted,8109,8767,658,7.5
6134,2010,September,Young                                                ,Not Adjusted,7983,8655,672,7.8
6135,2010,December,Young                                                ,Not Adjusted,7955,8619,664,7.7
6136,2010,March,Zapata                                               ,Not Adjusted,5057,5688,631,11.1
6137,2010,June,Zapata                                               ,Not Adjusted,5111,5742,631,11.0
6138,2010,September,Zapata                                               ,Not Adjusted,5220,5784,564,9.8
6139,2010,December,Zapata                                               ,Not Adjusted,5470,6039,569,9.4
6140,2010,March,Zavala                                               ,Not Adjusted,3957,4591,634,13.8
6141,2010,June,Zavala                                               ,Not Adjusted,3922,4579,657,14.3
6142,2010,September,Zavala                                               ,Not Adjusted,3824,4443,619,13.9
6143,2010,December,Zavala                                               ,Not Adjusted,4066,4671,605,13.0
6144,2011,March,Texas,Not Adjusted,11415804,12416106,1000302,8.1
6145,2011,March,Texas,Adjusted,11416366,12426745,1010379,8.1
6146,2011,June,Texas,Not Adjusted,11443609,12537024,1093415,8.7
6147,2011,June,Texas,Adjusted,11463413,12497108,1033695,8.3
6148,2011,September,Texas,Not Adjusted,11564022,12588682,1024660,8.1
6149,2011,September,Texas,Adjusted,11556548,12559256,1002708,8.0
6150,2011,December,Texas,Not Adjusted,11686024,12561980,875956,7.0
6151,2011,December,Texas,Adjusted,11659891,12576704,916813,7.3
6152,2011,March,Anderson                                             ,Not Adjusted,20171,21887,1716,7.8
6153,2011,June,Anderson                                             ,Not Adjusted,20429,22274,1845,8.3
6154,2011,September,Anderson                                             ,Not Adjusted,20533,22226,1693,7.6
6155,2011,December,Anderson                                             ,Not Adjusted,21009,22402,1393,6.2
6156,2011,March,Andrews                                              ,Not Adjusted,7127,7535,408,5.4
6157,2011,June,Andrews                                              ,Not Adjusted,7161,7617,456,6.0
6158,2011,September,Andrews                                              ,Not Adjusted,7572,7978,406,5.1
6159,2011,December,Andrews                                              ,Not Adjusted,7868,8194,326,4.0
6160,2011,March,Angelina                                             ,Not Adjusted,35047,38129,3082,8.1
6161,2011,June,Angelina                                             ,Not Adjusted,34862,38306,3444,9.0
6162,2011,September,Angelina                                             ,Not Adjusted,35009,38239,3230,8.4
6163,2011,December,Angelina                                             ,Not Adjusted,35442,38100,2658,7.0
6164,2011,March,Aransas                                              ,Not Adjusted,8846,9736,890,9.1
6165,2011,June,Aransas                                              ,Not Adjusted,8919,9889,970,9.8
6166,2011,September,Aransas                                              ,Not Adjusted,8984,9889,905,9.2
6167,2011,December,Aransas                                              ,Not Adjusted,9067,9860,793,8.0
6168,2011,March,Archer                                               ,Not Adjusted,4197,4458,261,5.9
6169,2011,June,Archer                                               ,Not Adjusted,4223,4532,309,6.8
6170,2011,September,Archer                                               ,Not Adjusted,4196,4491,295,6.6
6171,2011,December,Archer                                               ,Not Adjusted,4240,4502,262,5.8
6172,2011,March,Armstrong                                            ,Not Adjusted,973,1027,54,5.3
6173,2011,June,Armstrong                                            ,Not Adjusted,988,1041,53,5.1
6174,2011,September,Armstrong                                            ,Not Adjusted,996,1053,57,5.4
6175,2011,December,Armstrong                                            ,Not Adjusted,1000,1049,49,4.7
6176,2011,March,Atascosa                                             ,Not Adjusted,18127,19751,1624,8.2
6177,2011,June,Atascosa                                             ,Not Adjusted,18207,20030,1823,9.1
6178,2011,September,Atascosa                                             ,Not Adjusted,18365,20031,1666,8.3
6179,2011,December,Atascosa                                             ,Not Adjusted,18517,19910,1393,7.0
6180,2011,March,Austin                                               ,Not Adjusted,12860,13997,1137,8.1
6181,2011,June,Austin                                               ,Not Adjusted,12951,14193,1242,8.8
6182,2011,September,Austin                                               ,Not Adjusted,13115,14320,1205,8.4
6183,2011,December,Austin                                               ,Not Adjusted,13279,14272,993,7.0
6184,2011,March,Bailey                                               ,Not Adjusted,2971,3225,254,7.9
6185,2011,June,Bailey                                               ,Not Adjusted,3129,3417,288,8.4
6186,2011,September,Bailey                                               ,Not Adjusted,3130,3379,249,7.4
6187,2011,December,Bailey                                               ,Not Adjusted,3074,3299,225,6.8
6188,2011,March,Bandera                                              ,Not Adjusted,8411,9150,739,8.1
6189,2011,June,Bandera                                              ,Not Adjusted,8435,9193,758,8.2
6190,2011,September,Bandera                                              ,Not Adjusted,8517,9252,735,7.9
6191,2011,December,Bandera                                              ,Not Adjusted,8597,9226,629,6.8
6192,2011,March,Bastrop                                              ,Not Adjusted,32490,35423,2933,8.3
6193,2011,June,Bastrop                                              ,Not Adjusted,32595,35818,3223,9.0
6194,2011,September,Bastrop                                              ,Not Adjusted,32983,36024,3041,8.4
6195,2011,December,Bastrop                                              ,Not Adjusted,33414,35949,2535,7.1
6196,2011,March,Baylor                                               ,Not Adjusted,1615,1725,110,6.4
6197,2011,June,Baylor                                               ,Not Adjusted,1686,1817,131,7.2
6198,2011,September,Baylor                                               ,Not Adjusted,1865,1990,125,6.3
6199,2011,December,Baylor                                               ,Not Adjusted,1962,2061,99,4.8
6200,2011,March,Bee                                                  ,Not Adjusted,9700,10653,953,8.9
6201,2011,June,Bee                                                  ,Not Adjusted,9596,10646,1050,9.9
6202,2011,September,Bee                                                  ,Not Adjusted,9714,10670,956,9.0
6203,2011,December,Bee                                                  ,Not Adjusted,9741,10539,798,7.6
6204,2011,March,Bell                                                 ,Not Adjusted,122631,133439,10808,8.1
6205,2011,June,Bell                                                 ,Not Adjusted,121815,133819,12004,9.0
6206,2011,September,Bell                                                 ,Not Adjusted,122339,133917,11578,8.6
6207,2011,December,Bell                                                 ,Not Adjusted,122615,132740,10125,7.6
6208,2011,March,Bexar                                                ,Not Adjusted,764067,824542,60475,7.3
6209,2011,June,Bexar                                                ,Not Adjusted,764793,832599,67806,8.1
6210,2011,September,Bexar                                                ,Not Adjusted,770490,834633,64143,7.7
6211,2011,December,Bexar                                                ,Not Adjusted,777050,830808,53758,6.5
6212,2011,March,Blanco                                               ,Not Adjusted,5030,5343,313,5.9
6213,2011,June,Blanco                                               ,Not Adjusted,5091,5447,356,6.5
6214,2011,September,Blanco                                               ,Not Adjusted,5113,5441,328,6.0
6215,2011,December,Blanco                                               ,Not Adjusted,5193,5470,277,5.1
6216,2011,March,Borden                                               ,Not Adjusted,352,375,23,6.1
6217,2011,June,Borden                                               ,Not Adjusted,374,397,23,5.8
6218,2011,September,Borden                                               ,Not Adjusted,363,385,22,5.7
6219,2011,December,Borden                                               ,Not Adjusted,408,428,20,4.7
6220,2011,March,Bosque                                               ,Not Adjusted,7676,8412,736,8.7
6221,2011,June,Bosque                                               ,Not Adjusted,7710,8495,785,9.2
6222,2011,September,Bosque                                               ,Not Adjusted,7695,8426,731,8.7
6223,2011,December,Bosque                                               ,Not Adjusted,7706,8328,622,7.5
6224,2011,March,Bowie                                                ,Not Adjusted,38899,42459,3560,8.4
6225,2011,June,Bowie                                                ,Not Adjusted,38695,42579,3884,9.1
6226,2011,September,Bowie                                                ,Not Adjusted,38827,42567,3740,8.8
6227,2011,December,Bowie                                                ,Not Adjusted,38899,42192,3293,7.8
6228,2011,March,Brazoria                                             ,Not Adjusted,144092,157199,13107,8.3
6229,2011,June,Brazoria                                             ,Not Adjusted,144682,158925,14243,9.0
6230,2011,September,Brazoria                                             ,Not Adjusted,146364,159570,13206,8.3
6231,2011,December,Brazoria                                             ,Not Adjusted,148256,160209,11953,7.5
6232,2011,March,Brazos                                               ,Not Adjusted,94539,100480,5941,5.9
6233,2011,June,Brazos                                               ,Not Adjusted,90792,97963,7171,7.3
6234,2011,September,Brazos                                               ,Not Adjusted,94069,100517,6448,6.4
6235,2011,December,Brazos                                               ,Not Adjusted,94400,99665,5265,5.3
6236,2011,March,Brewster                                             ,Not Adjusted,4558,4840,282,5.8
6237,2011,June,Brewster                                             ,Not Adjusted,4440,4746,306,6.4
6238,2011,September,Brewster                                             ,Not Adjusted,4650,4932,282,5.7
6239,2011,December,Brewster                                             ,Not Adjusted,4683,4913,230,4.7
6240,2011,March,Briscoe                                              ,Not Adjusted,664,708,44,6.2
6241,2011,June,Briscoe                                              ,Not Adjusted,691,742,51,6.9
6242,2011,September,Briscoe                                              ,Not Adjusted,694,741,47,6.3
6243,2011,December,Briscoe                                              ,Not Adjusted,674,715,41,5.7
6244,2011,March,Brooks                                               ,Not Adjusted,2384,2672,288,10.8
6245,2011,June,Brooks                                               ,Not Adjusted,2374,2722,348,12.8
6246,2011,September,Brooks                                               ,Not Adjusted,2390,2689,299,11.1
6247,2011,December,Brooks                                               ,Not Adjusted,2454,2703,249,9.2
6248,2011,March,Brown                                                ,Not Adjusted,14956,16626,1670,10.0
6249,2011,June,Brown                                                ,Not Adjusted,15072,16505,1433,8.7
6250,2011,September,Brown                                                ,Not Adjusted,14968,16356,1388,8.5
6251,2011,December,Brown                                                ,Not Adjusted,15090,16229,1139,7.0
6252,2011,March,Burleson                                             ,Not Adjusted,7240,7859,619,7.9
6253,2011,June,Burleson                                             ,Not Adjusted,6993,7625,632,8.3
6254,2011,September,Burleson                                             ,Not Adjusted,7240,7837,597,7.6
6255,2011,December,Burleson                                             ,Not Adjusted,7269,7747,478,6.2
6256,2011,March,Burnet                                               ,Not Adjusted,19134,20509,1375,6.7
6257,2011,June,Burnet                                               ,Not Adjusted,19405,21030,1625,7.7
6258,2011,September,Burnet                                               ,Not Adjusted,19380,20892,1512,7.2
6259,2011,December,Burnet                                               ,Not Adjusted,19031,20292,1261,6.2
6260,2011,March,Caldwell                                             ,Not Adjusted,15253,16672,1419,8.5
6261,2011,June,Caldwell                                             ,Not Adjusted,15299,16964,1665,9.8
6262,2011,September,Caldwell                                             ,Not Adjusted,15479,17017,1538,9.0
6263,2011,December,Caldwell                                             ,Not Adjusted,15681,16949,1268,7.5
6264,2011,March,Calhoun                                              ,Not Adjusted,9851,10769,918,8.5
6265,2011,June,Calhoun                                              ,Not Adjusted,9687,10700,1013,9.5
6266,2011,September,Calhoun                                              ,Not Adjusted,9518,10456,938,9.0
6267,2011,December,Calhoun                                              ,Not Adjusted,9498,10346,848,8.2
6268,2011,March,Callahan                                             ,Not Adjusted,5571,6017,446,7.4
6269,2011,June,Callahan                                             ,Not Adjusted,5524,6034,510,8.5
6270,2011,September,Callahan                                             ,Not Adjusted,5561,6013,452,7.5
6271,2011,December,Callahan                                             ,Not Adjusted,5627,6004,377,6.3
6272,2011,March,Cameron                                              ,Not Adjusted,146507,166055,19548,11.8
6273,2011,June,Cameron                                              ,Not Adjusted,146181,167148,20967,12.5
6274,2011,September,Cameron                                              ,Not Adjusted,146225,166176,19951,12.0
6275,2011,December,Cameron                                              ,Not Adjusted,147539,165251,17712,10.7
6276,2011,March,Camp                                                 ,Not Adjusted,5169,5684,515,9.1
6277,2011,June,Camp                                                 ,Not Adjusted,5170,5753,583,10.1
6278,2011,September,Camp                                                 ,Not Adjusted,5199,5736,537,9.4
6279,2011,December,Camp                                                 ,Not Adjusted,5169,5615,446,7.9
6280,2011,March,Carson                                               ,Not Adjusted,3205,3377,172,5.1
6281,2011,June,Carson                                               ,Not Adjusted,3252,3454,202,5.8
6282,2011,September,Carson                                               ,Not Adjusted,3281,3468,187,5.4
6283,2011,December,Carson                                               ,Not Adjusted,3292,3435,143,4.2
6284,2011,March,Cass                                                 ,Not Adjusted,11885,13365,1480,11.1
6285,2011,June,Cass                                                 ,Not Adjusted,11922,13493,1571,11.6
6286,2011,September,Cass                                                 ,Not Adjusted,11859,13353,1494,11.2
6287,2011,December,Cass                                                 ,Not Adjusted,11862,13131,1269,9.7
6288,2011,March,Castro                                               ,Not Adjusted,3810,4018,208,5.2
6289,2011,June,Castro                                               ,Not Adjusted,3942,4176,234,5.6
6290,2011,September,Castro                                               ,Not Adjusted,3959,4175,216,5.2
6291,2011,December,Castro                                               ,Not Adjusted,3952,4133,181,4.4
6292,2011,March,Chambers                                             ,Not Adjusted,15061,16621,1560,9.4
6293,2011,June,Chambers                                             ,Not Adjusted,15112,16919,1807,10.7
6294,2011,September,Chambers                                             ,Not Adjusted,15290,16946,1656,9.8
6295,2011,December,Chambers                                             ,Not Adjusted,15491,16933,1442,8.5
6296,2011,March,Cherokee                                             ,Not Adjusted,19877,21652,1775,8.2
6297,2011,June,Cherokee                                             ,Not Adjusted,20387,22395,2008,9.0
6298,2011,September,Cherokee                                             ,Not Adjusted,20480,22419,1939,8.6
6299,2011,December,Cherokee                                             ,Not Adjusted,20947,22619,1672,7.4
6300,2011,March,Childress                                            ,Not Adjusted,2874,3043,169,5.6
6301,2011,June,Childress                                            ,Not Adjusted,2954,3138,184,5.9
6302,2011,September,Childress                                            ,Not Adjusted,2904,3067,163,5.3
6303,2011,December,Childress                                            ,Not Adjusted,2930,3067,137,4.5
6304,2011,March,Clay                                                 ,Not Adjusted,5136,5502,366,6.7
6305,2011,June,Clay                                                 ,Not Adjusted,5182,5582,400,7.2
6306,2011,September,Clay                                                 ,Not Adjusted,5146,5522,376,6.8
6307,2011,December,Clay                                                 ,Not Adjusted,5197,5523,326,5.9
6308,2011,March,Cochran                                              ,Not Adjusted,1328,1461,133,9.1
6309,2011,June,Cochran                                              ,Not Adjusted,1406,1543,137,8.9
6310,2011,September,Cochran                                              ,Not Adjusted,1408,1551,143,9.2
6311,2011,December,Cochran                                              ,Not Adjusted,1409,1524,115,7.5
6312,2011,March,Coke                                                 ,Not Adjusted,1417,1507,90,6.0
6313,2011,June,Coke                                                 ,Not Adjusted,1470,1571,101,6.4
6314,2011,September,Coke                                                 ,Not Adjusted,1450,1542,92,6.0
6315,2011,December,Coke                                                 ,Not Adjusted,1492,1564,72,4.6
6316,2011,March,Coleman                                              ,Not Adjusted,3059,3399,340,10.0
6317,2011,June,Coleman                                              ,Not Adjusted,3087,3429,342,10.0
6318,2011,September,Coleman                                              ,Not Adjusted,3163,3464,301,8.7
6319,2011,December,Coleman                                              ,Not Adjusted,3114,3375,261,7.7
6320,2011,March,Collin                                               ,Not Adjusted,404447,435234,30787,7.1
6321,2011,June,Collin                                               ,Not Adjusted,405469,439019,33550,7.6
6322,2011,September,Collin                                               ,Not Adjusted,410367,441900,31533,7.1
6323,2011,December,Collin                                               ,Not Adjusted,413691,439894,26203,6.0
6324,2011,March,Collingsworth                                        ,Not Adjusted,1266,1350,84,6.2
6325,2011,June,Collingsworth                                        ,Not Adjusted,1237,1328,91,6.9
6326,2011,September,Collingsworth                                        ,Not Adjusted,1225,1302,77,5.9
6327,2011,December,Collingsworth                                        ,Not Adjusted,1226,1286,60,4.7
6328,2011,March,Colorado                                             ,Not Adjusted,9058,9836,778,7.9
6329,2011,June,Colorado                                             ,Not Adjusted,9477,10329,852,8.2
6330,2011,September,Colorado                                             ,Not Adjusted,9460,10331,871,8.4
6331,2011,December,Colorado                                             ,Not Adjusted,9563,10283,720,7.0
6332,2011,March,Comal                                                ,Not Adjusted,50478,54340,3862,7.1
6333,2011,June,Comal                                                ,Not Adjusted,50465,54776,4311,7.9
6334,2011,September,Comal                                                ,Not Adjusted,50913,54887,3974,7.2
6335,2011,December,Comal                                                ,Not Adjusted,51402,54773,3371,6.2
6336,2011,March,Comanche                                             ,Not Adjusted,5409,5902,493,8.4
6337,2011,June,Comanche                                             ,Not Adjusted,5582,6108,526,8.6
6338,2011,September,Comanche                                             ,Not Adjusted,5511,5978,467,7.8
6339,2011,December,Comanche                                             ,Not Adjusted,5563,5943,380,6.4
6340,2011,March,Concho                                               ,Not Adjusted,1488,1571,83,5.3
6341,2011,June,Concho                                               ,Not Adjusted,1531,1614,83,5.1
6342,2011,September,Concho                                               ,Not Adjusted,1526,1600,74,4.6
6343,2011,December,Concho                                               ,Not Adjusted,1528,1596,68,4.3
6344,2011,March,Cooke                                                ,Not Adjusted,18577,19918,1341,6.7
6345,2011,June,Cooke                                                ,Not Adjusted,18957,20373,1416,7.0
6346,2011,September,Cooke                                                ,Not Adjusted,19533,20814,1281,6.2
6347,2011,December,Cooke                                                ,Not Adjusted,19805,20895,1090,5.2
6348,2011,March,Coryell                                              ,Not Adjusted,23656,25641,1985,7.7
6349,2011,June,Coryell                                              ,Not Adjusted,23509,25731,2222,8.6
6350,2011,September,Coryell                                              ,Not Adjusted,23613,25749,2136,8.3
6351,2011,December,Coryell                                              ,Not Adjusted,23667,25515,1848,7.2
6352,2011,March,Cottle                                               ,Not Adjusted,611,662,51,7.7
6353,2011,June,Cottle                                               ,Not Adjusted,635,686,51,7.4
6354,2011,September,Cottle                                               ,Not Adjusted,618,675,57,8.4
6355,2011,December,Cottle                                               ,Not Adjusted,628,683,55,8.1
6356,2011,March,Crane                                                ,Not Adjusted,1753,1885,132,7.0
6357,2011,June,Crane                                                ,Not Adjusted,1769,1916,147,7.7
6358,2011,September,Crane                                                ,Not Adjusted,1824,1960,136,6.9
6359,2011,December,Crane                                                ,Not Adjusted,1856,1962,106,5.4
6360,2011,March,Crockett                                             ,Not Adjusted,1549,1679,130,7.7
6361,2011,June,Crockett                                             ,Not Adjusted,1625,1755,130,7.4
6362,2011,September,Crockett                                             ,Not Adjusted,1591,1711,120,7.0
6363,2011,December,Crockett                                             ,Not Adjusted,1640,1739,99,5.7
6364,2011,March,Crosby                                               ,Not Adjusted,2714,2979,265,8.9
6365,2011,June,Crosby                                               ,Not Adjusted,2768,3049,281,9.2
6366,2011,September,Crosby                                               ,Not Adjusted,2789,3066,277,9.0
6367,2011,December,Crosby                                               ,Not Adjusted,2806,3040,234,7.7
6368,2011,March,Culberson                                            ,Not Adjusted,934,1015,81,8.0
6369,2011,June,Culberson                                            ,Not Adjusted,943,1020,77,7.5
6370,2011,September,Culberson                                            ,Not Adjusted,971,1042,71,6.8
6371,2011,December,Culberson                                            ,Not Adjusted,963,1020,57,5.6
6372,2011,March,Dallam                                               ,Not Adjusted,3779,3966,187,4.7
6373,2011,June,Dallam                                               ,Not Adjusted,3953,4161,208,5.0
6374,2011,September,Dallam                                               ,Not Adjusted,3968,4155,187,4.5
6375,2011,December,Dallam                                               ,Not Adjusted,3927,4085,158,3.9
6376,2011,March,Dallas                                               ,Not Adjusted,1101158,1203363,102205,8.5
6377,2011,June,Dallas                                               ,Not Adjusted,1103265,1213063,109798,9.1
6378,2011,September,Dallas                                               ,Not Adjusted,1116950,1221041,104091,8.5
6379,2011,December,Dallas                                               ,Not Adjusted,1126384,1216211,89827,7.4
6380,2011,March,Dawson                                               ,Not Adjusted,4848,5259,411,7.8
6381,2011,June,Dawson                                               ,Not Adjusted,4847,5283,436,8.3
6382,2011,September,Dawson                                               ,Not Adjusted,4807,5236,429,8.2
6383,2011,December,Dawson                                               ,Not Adjusted,4868,5217,349,6.7
6384,2011,March,Deaf Smith                                           ,Not Adjusted,9062,9586,524,5.5
6385,2011,June,Deaf Smith                                           ,Not Adjusted,9240,9850,610,6.2
6386,2011,September,Deaf Smith                                           ,Not Adjusted,9210,9766,556,5.7
6387,2011,December,Deaf Smith                                           ,Not Adjusted,9138,9603,465,4.8
6388,2011,March,Delta                                                ,Not Adjusted,2406,2631,225,8.6
6389,2011,June,Delta                                                ,Not Adjusted,2410,2654,244,9.2
6390,2011,September,Delta                                                ,Not Adjusted,2426,2651,225,8.5
6391,2011,December,Delta                                                ,Not Adjusted,2433,2622,189,7.2
6392,2011,March,Denton                                               ,Not Adjusted,350621,376432,25811,6.9
6393,2011,June,Denton                                               ,Not Adjusted,351653,379997,28344,7.5
6394,2011,September,Denton                                               ,Not Adjusted,355801,382225,26424,6.9
6395,2011,December,Denton                                               ,Not Adjusted,358585,380645,22060,5.8
6396,2011,March,DeWitt                                               ,Not Adjusted,8622,9275,653,7.0
6397,2011,June,DeWitt                                               ,Not Adjusted,8857,9563,706,7.4
6398,2011,September,DeWitt                                               ,Not Adjusted,8943,9573,630,6.6
6399,2011,December,DeWitt                                               ,Not Adjusted,9149,9666,517,5.3
6400,2011,March,Dickens                                              ,Not Adjusted,743,899,156,17.4
6401,2011,June,Dickens                                              ,Not Adjusted,783,931,148,15.9
6402,2011,September,Dickens                                              ,Not Adjusted,768,911,143,15.7
6403,2011,December,Dickens                                              ,Not Adjusted,799,911,112,12.3
6404,2011,March,Dimmit                                               ,Not Adjusted,4084,4469,385,8.6
6405,2011,June,Dimmit                                               ,Not Adjusted,4570,5019,449,8.9
6406,2011,September,Dimmit                                               ,Not Adjusted,5015,5412,397,7.3
6407,2011,December,Dimmit                                               ,Not Adjusted,4886,5220,334,6.4
6408,2011,March,Donley                                               ,Not Adjusted,1680,1793,113,6.3
6409,2011,June,Donley                                               ,Not Adjusted,1719,1864,145,7.8
6410,2011,September,Donley                                               ,Not Adjusted,1676,1799,123,6.8
6411,2011,December,Donley                                               ,Not Adjusted,1724,1821,97,5.3
6412,2011,March,Duval                                                ,Not Adjusted,4645,5189,544,10.5
6413,2011,June,Duval                                                ,Not Adjusted,4723,5260,537,10.2
6414,2011,September,Duval                                                ,Not Adjusted,4806,5299,493,9.3
6415,2011,December,Duval                                                ,Not Adjusted,4823,5249,426,8.1
6416,2011,March,Eastland                                             ,Not Adjusted,7753,8421,668,7.9
6417,2011,June,Eastland                                             ,Not Adjusted,7813,8585,772,9.0
6418,2011,September,Eastland                                             ,Not Adjusted,7805,8481,676,8.0
6419,2011,December,Eastland                                             ,Not Adjusted,7808,8367,559,6.7
6420,2011,March,Ector                                                ,Not Adjusted,66587,71359,4772,6.7
6421,2011,June,Ector                                                ,Not Adjusted,67534,72677,5143,7.1
6422,2011,September,Ector                                                ,Not Adjusted,69206,73764,4558,6.2
6423,2011,December,Ector                                                ,Not Adjusted,70910,74572,3662,4.9
6424,2011,March,Edwards                                              ,Not Adjusted,924,994,70,7.0
6425,2011,June,Edwards                                              ,Not Adjusted,967,1045,78,7.5
6426,2011,September,Edwards                                              ,Not Adjusted,916,983,67,6.8
6427,2011,December,Edwards                                              ,Not Adjusted,911,962,51,5.3
6428,2011,March,Ellis                                                ,Not Adjusted,70100,76170,6070,8.0
6429,2011,June,Ellis                                                ,Not Adjusted,70291,77208,6917,9.0
6430,2011,September,Ellis                                                ,Not Adjusted,71163,77459,6296,8.1
6431,2011,December,Ellis                                                ,Not Adjusted,71753,77050,5297,6.9
6432,2011,March,El Paso                                              ,Not Adjusted,312517,346183,33666,9.7
6433,2011,June,El Paso                                              ,Not Adjusted,310338,347151,36813,10.6
6434,2011,September,El Paso                                              ,Not Adjusted,314736,349654,34918,10.0
6435,2011,December,El Paso                                              ,Not Adjusted,315963,346332,30369,8.8
6436,2011,March,Erath                                                ,Not Adjusted,19565,20799,1234,5.9
6437,2011,June,Erath                                                ,Not Adjusted,19466,20960,1494,7.1
6438,2011,September,Erath                                                ,Not Adjusted,19378,20698,1320,6.4
6439,2011,December,Erath                                                ,Not Adjusted,19574,20655,1081,5.2
6440,2011,March,Falls                                                ,Not Adjusted,6529,7137,608,8.5
6441,2011,June,Falls                                                ,Not Adjusted,6606,7278,672,9.2
6442,2011,September,Falls                                                ,Not Adjusted,6642,7294,652,8.9
6443,2011,December,Falls                                                ,Not Adjusted,6602,7155,553,7.7
6444,2011,March,Fannin                                               ,Not Adjusted,13907,15203,1296,8.5
6445,2011,June,Fannin                                               ,Not Adjusted,14007,15427,1420,9.2
6446,2011,September,Fannin                                               ,Not Adjusted,13989,15325,1336,8.7
6447,2011,December,Fannin                                               ,Not Adjusted,14156,15287,1131,7.4
6448,2011,March,Fayette                                              ,Not Adjusted,11704,12437,733,5.9
6449,2011,June,Fayette                                              ,Not Adjusted,11716,12568,852,6.8
6450,2011,September,Fayette                                              ,Not Adjusted,11826,12605,779,6.2
6451,2011,December,Fayette                                              ,Not Adjusted,11954,12583,629,5.0
6452,2011,March,Fisher                                               ,Not Adjusted,1781,1917,136,7.1
6453,2011,June,Fisher                                               ,Not Adjusted,1813,1965,152,7.7
6454,2011,September,Fisher                                               ,Not Adjusted,1811,1950,139,7.1
6455,2011,December,Fisher                                               ,Not Adjusted,1859,1963,104,5.3
6456,2011,March,Floyd                                                ,Not Adjusted,3034,3305,271,8.2
6457,2011,June,Floyd                                                ,Not Adjusted,3101,3380,279,8.3
6458,2011,September,Floyd                                                ,Not Adjusted,3101,3359,258,7.7
6459,2011,December,Floyd                                                ,Not Adjusted,3069,3300,231,7.0
6460,2011,March,Foard                                                ,Not Adjusted,606,661,55,8.3
6461,2011,June,Foard                                                ,Not Adjusted,628,685,57,8.3
6462,2011,September,Foard                                                ,Not Adjusted,623,674,51,7.6
6463,2011,December,Foard                                                ,Not Adjusted,637,679,42,6.2
6464,2011,March,Fort Bend                                            ,Not Adjusted,283087,305830,22743,7.4
6465,2011,June,Fort Bend                                            ,Not Adjusted,283938,308540,24602,8.0
6466,2011,September,Fort Bend                                            ,Not Adjusted,287382,310564,23182,7.5
6467,2011,December,Fort Bend                                            ,Not Adjusted,291244,310681,19437,6.3
6468,2011,March,Franklin                                             ,Not Adjusted,4379,4771,392,8.2
6469,2011,June,Franklin                                             ,Not Adjusted,4400,4842,442,9.1
6470,2011,September,Franklin                                             ,Not Adjusted,4342,4753,411,8.6
6471,2011,December,Franklin                                             ,Not Adjusted,4305,4661,356,7.6
6472,2011,March,Freestone                                            ,Not Adjusted,7368,8035,667,8.3
6473,2011,June,Freestone                                            ,Not Adjusted,7442,8184,742,9.1
6474,2011,September,Freestone                                            ,Not Adjusted,7493,8174,681,8.3
6475,2011,December,Freestone                                            ,Not Adjusted,7432,7985,553,6.9
6476,2011,March,Frio                                                 ,Not Adjusted,7318,7857,539,6.9
6477,2011,June,Frio                                                 ,Not Adjusted,7381,7976,595,7.5
6478,2011,September,Frio                                                 ,Not Adjusted,7592,8135,543,6.7
6479,2011,December,Frio                                                 ,Not Adjusted,7720,8181,461,5.6
6480,2011,March,Gaines                                               ,Not Adjusted,7982,8420,438,5.2
6481,2011,June,Gaines                                               ,Not Adjusted,8075,8585,510,5.9
6482,2011,September,Gaines                                               ,Not Adjusted,8122,8587,465,5.4
6483,2011,December,Gaines                                               ,Not Adjusted,8375,8746,371,4.2
6484,2011,March,Galveston                                            ,Not Adjusted,134979,148382,13403,9.0
6485,2011,June,Galveston                                            ,Not Adjusted,135467,150269,14802,9.9
6486,2011,September,Galveston                                            ,Not Adjusted,137106,151074,13968,9.2
6487,2011,December,Galveston                                            ,Not Adjusted,138924,151330,12406,8.2
6488,2011,March,Garza                                                ,Not Adjusted,2080,2215,135,6.1
6489,2011,June,Garza                                                ,Not Adjusted,2060,2215,155,7.0
6490,2011,September,Garza                                                ,Not Adjusted,2107,2253,146,6.5
6491,2011,December,Garza                                                ,Not Adjusted,2108,2230,122,5.5
6492,2011,March,Gillespie                                            ,Not Adjusted,11685,12364,679,5.5
6493,2011,June,Gillespie                                            ,Not Adjusted,11843,12614,771,6.1
6494,2011,September,Gillespie                                            ,Not Adjusted,11634,12359,725,5.9
6495,2011,December,Gillespie                                            ,Not Adjusted,12035,12599,564,4.5
6496,2011,March,Glasscock                                            ,Not Adjusted,686,717,31,4.3
6497,2011,June,Glasscock                                            ,Not Adjusted,742,779,37,4.7
6498,2011,September,Glasscock                                            ,Not Adjusted,743,778,35,4.5
6499,2011,December,Glasscock                                            ,Not Adjusted,750,778,28,3.6
6500,2011,March,Goliad                                               ,Not Adjusted,3096,3315,219,6.6
6501,2011,June,Goliad                                               ,Not Adjusted,3132,3386,254,7.5
6502,2011,September,Goliad                                               ,Not Adjusted,3177,3397,220,6.5
6503,2011,December,Goliad                                               ,Not Adjusted,3239,3437,198,5.8
6504,2011,March,Gonzales                                             ,Not Adjusted,8738,9356,618,6.6
6505,2011,June,Gonzales                                             ,Not Adjusted,8976,9653,677,7.0
6506,2011,September,Gonzales                                             ,Not Adjusted,9030,9638,608,6.3
6507,2011,December,Gonzales                                             ,Not Adjusted,9055,9543,488,5.1
6508,2011,March,Gray                                                 ,Not Adjusted,8777,9483,706,7.4
6509,2011,June,Gray                                                 ,Not Adjusted,9043,9796,753,7.7
6510,2011,September,Gray                                                 ,Not Adjusted,9111,9801,690,7.0
6511,2011,December,Gray                                                 ,Not Adjusted,9171,9724,553,5.7
6512,2011,March,Grayson                                              ,Not Adjusted,55153,60038,4885,8.1
6513,2011,June,Grayson                                              ,Not Adjusted,55081,60419,5338,8.8
6514,2011,September,Grayson                                              ,Not Adjusted,55516,60506,4990,8.2
6515,2011,December,Grayson                                              ,Not Adjusted,55833,60133,4300,7.2
6516,2011,March,Gregg                                                ,Not Adjusted,56013,60544,4531,7.5
6517,2011,June,Gregg                                                ,Not Adjusted,55716,60627,4911,8.1
6518,2011,September,Gregg                                                ,Not Adjusted,56953,61612,4659,7.6
6519,2011,December,Gregg                                                ,Not Adjusted,57562,61431,3869,6.3
6520,2011,March,Grimes                                               ,Not Adjusted,10448,11390,942,8.3
6521,2011,June,Grimes                                               ,Not Adjusted,10630,11674,1044,8.9
6522,2011,September,Grimes                                               ,Not Adjusted,10866,11835,969,8.2
6523,2011,December,Grimes                                               ,Not Adjusted,10975,11802,827,7.0
6524,2011,March,Guadalupe                                            ,Not Adjusted,61923,66298,4375,6.6
6525,2011,June,Guadalupe                                            ,Not Adjusted,62066,67011,4945,7.4
6526,2011,September,Guadalupe                                            ,Not Adjusted,62501,67179,4678,7.0
6527,2011,December,Guadalupe                                            ,Not Adjusted,62996,66872,3876,5.8
6528,2011,March,Hale                                                 ,Not Adjusted,14807,15976,1169,7.3
6529,2011,June,Hale                                                 ,Not Adjusted,14929,16375,1446,8.8
6530,2011,September,Hale                                                 ,Not Adjusted,15163,16466,1303,7.9
6531,2011,December,Hale                                                 ,Not Adjusted,15186,16309,1123,6.9
6532,2011,March,Hall                                                 ,Not Adjusted,1291,1412,121,8.6
6533,2011,June,Hall                                                 ,Not Adjusted,1301,1431,130,9.1
6534,2011,September,Hall                                                 ,Not Adjusted,1291,1425,134,9.4
6535,2011,December,Hall                                                 ,Not Adjusted,1267,1379,112,8.1
6536,2011,March,Hamilton                                             ,Not Adjusted,3618,3872,254,6.6
6537,2011,June,Hamilton                                             ,Not Adjusted,3647,3928,281,7.2
6538,2011,September,Hamilton                                             ,Not Adjusted,3577,3838,261,6.8
6539,2011,December,Hamilton                                             ,Not Adjusted,3732,3948,216,5.5
6540,2011,March,Hansford                                             ,Not Adjusted,2855,2978,123,4.1
6541,2011,June,Hansford                                             ,Not Adjusted,2988,3139,151,4.8
6542,2011,September,Hansford                                             ,Not Adjusted,2932,3066,134,4.4
6543,2011,December,Hansford                                             ,Not Adjusted,2969,3072,103,3.4
6544,2011,March,Hardeman                                             ,Not Adjusted,1759,1906,147,7.7
6545,2011,June,Hardeman                                             ,Not Adjusted,1795,1946,151,7.8
6546,2011,September,Hardeman                                             ,Not Adjusted,1732,1866,134,7.2
6547,2011,December,Hardeman                                             ,Not Adjusted,1707,1813,106,5.8
6548,2011,March,Hardin                                               ,Not Adjusted,23564,26212,2648,10.1
6549,2011,June,Hardin                                               ,Not Adjusted,23635,26430,2795,10.6
6550,2011,September,Hardin                                               ,Not Adjusted,23917,26545,2628,9.9
6551,2011,December,Hardin                                               ,Not Adjusted,23926,26227,2301,8.8
6552,2011,March,Harris                                               ,Not Adjusted,1922103,2093714,171611,8.2
6553,2011,June,Harris                                               ,Not Adjusted,1926788,2112752,185964,8.8
6554,2011,September,Harris                                               ,Not Adjusted,1950908,2125458,174550,8.2
6555,2011,December,Harris                                               ,Not Adjusted,1977755,2127413,149658,7.0
6556,2011,March,Harrison                                             ,Not Adjusted,28493,31264,2771,8.9
6557,2011,June,Harrison                                             ,Not Adjusted,28800,31835,3035,9.5
6558,2011,September,Harrison                                             ,Not Adjusted,28873,31709,2836,8.9
6559,2011,December,Harrison                                             ,Not Adjusted,29015,31442,2427,7.7
6560,2011,March,Hartley                                              ,Not Adjusted,2646,2764,118,4.3
6561,2011,June,Hartley                                              ,Not Adjusted,2743,2880,137,4.8
6562,2011,September,Hartley                                              ,Not Adjusted,2749,2861,112,3.9
6563,2011,December,Hartley                                              ,Not Adjusted,2777,2872,95,3.3
6564,2011,March,Haskell                                              ,Not Adjusted,2886,3048,162,5.3
6565,2011,June,Haskell                                              ,Not Adjusted,2964,3159,195,6.2
6566,2011,September,Haskell                                              ,Not Adjusted,2870,3044,174,5.7
6567,2011,December,Haskell                                              ,Not Adjusted,2761,2913,152,5.2
6568,2011,March,Hays                                                 ,Not Adjusted,76866,82452,5586,6.8
6569,2011,June,Hays                                                 ,Not Adjusted,76993,83344,6351,7.6
6570,2011,September,Hays                                                 ,Not Adjusted,77886,83956,6070,7.2
6571,2011,December,Hays                                                 ,Not Adjusted,78926,83960,5034,6.0
6572,2011,March,Hemphill                                             ,Not Adjusted,2254,2335,81,3.5
6573,2011,June,Hemphill                                             ,Not Adjusted,2319,2417,98,4.1
6574,2011,September,Hemphill                                             ,Not Adjusted,2339,2428,89,3.7
6575,2011,December,Hemphill                                             ,Not Adjusted,2380,2452,72,2.9
6576,2011,March,Henderson                                            ,Not Adjusted,31970,35023,3053,8.7
6577,2011,June,Henderson                                            ,Not Adjusted,32016,35382,3366,9.5
6578,2011,September,Henderson                                            ,Not Adjusted,31997,35184,3187,9.1
6579,2011,December,Henderson                                            ,Not Adjusted,32059,34800,2741,7.9
6580,2011,March,Hidalgo                                              ,Not Adjusted,287550,326396,38846,11.9
6581,2011,June,Hidalgo                                              ,Not Adjusted,285485,328112,42627,13.0
6582,2011,September,Hidalgo                                              ,Not Adjusted,287526,326341,38815,11.9
6583,2011,December,Hidalgo                                              ,Not Adjusted,293814,329646,35832,10.9
6584,2011,March,Hill                                                 ,Not Adjusted,14396,15763,1367,8.7
6585,2011,June,Hill                                                 ,Not Adjusted,14462,15962,1500,9.4
6586,2011,September,Hill                                                 ,Not Adjusted,14675,16070,1395,8.7
6587,2011,December,Hill                                                 ,Not Adjusted,14768,15918,1150,7.2
6588,2011,March,Hockley                                              ,Not Adjusted,10502,11231,729,6.5
6589,2011,June,Hockley                                              ,Not Adjusted,10607,11443,836,7.3
6590,2011,September,Hockley                                              ,Not Adjusted,10668,11440,772,6.7
6591,2011,December,Hockley                                              ,Not Adjusted,10965,11593,628,5.4
6592,2011,March,Hood                                                 ,Not Adjusted,21420,23423,2003,8.6
6593,2011,June,Hood                                                 ,Not Adjusted,21620,23756,2136,9.0
6594,2011,September,Hood                                                 ,Not Adjusted,21873,23846,1973,8.3
6595,2011,December,Hood                                                 ,Not Adjusted,22121,23766,1645,6.9
6596,2011,March,Hopkins                                              ,Not Adjusted,15454,16752,1298,7.7
6597,2011,June,Hopkins                                              ,Not Adjusted,15512,16928,1416,8.4
6598,2011,September,Hopkins                                              ,Not Adjusted,15989,17274,1285,7.4
6599,2011,December,Hopkins                                              ,Not Adjusted,15824,16939,1115,6.6
6600,2011,March,Houston                                              ,Not Adjusted,9828,10623,795,7.5
6601,2011,June,Houston                                              ,Not Adjusted,10036,10936,900,8.2
6602,2011,September,Houston                                              ,Not Adjusted,9568,10502,934,8.9
6603,2011,December,Houston                                              ,Not Adjusted,9706,10507,801,7.6
6604,2011,March,Howard                                               ,Not Adjusted,12260,13126,866,6.6
6605,2011,June,Howard                                               ,Not Adjusted,12292,13313,1021,7.7
6606,2011,September,Howard                                               ,Not Adjusted,12341,13269,928,7.0
6607,2011,December,Howard                                               ,Not Adjusted,12583,13337,754,5.7
6608,2011,March,Hudspeth                                             ,Not Adjusted,1258,1364,106,7.8
6609,2011,June,Hudspeth                                             ,Not Adjusted,1282,1413,131,9.3
6610,2011,September,Hudspeth                                             ,Not Adjusted,1297,1422,125,8.8
6611,2011,December,Hudspeth                                             ,Not Adjusted,1296,1400,104,7.4
6612,2011,March,Hunt                                                 ,Not Adjusted,34630,38081,3451,9.1
6613,2011,June,Hunt                                                 ,Not Adjusted,34740,38594,3854,10.0
6614,2011,September,Hunt                                                 ,Not Adjusted,35178,38839,3661,9.4
6615,2011,December,Hunt                                                 ,Not Adjusted,35471,38600,3129,8.1
6616,2011,March,Hutchinson                                           ,Not Adjusted,9106,9938,832,8.4
6617,2011,June,Hutchinson                                           ,Not Adjusted,9093,9978,885,8.9
6618,2011,September,Hutchinson                                           ,Not Adjusted,9192,9993,801,8.0
6619,2011,December,Hutchinson                                           ,Not Adjusted,9241,9928,687,6.9
6620,2011,March,Irion                                                ,Not Adjusted,819,865,46,5.3
6621,2011,June,Irion                                                ,Not Adjusted,825,879,54,6.1
6622,2011,September,Irion                                                ,Not Adjusted,837,890,53,6.0
6623,2011,December,Irion                                                ,Not Adjusted,847,893,46,5.2
6624,2011,March,Jack                                                 ,Not Adjusted,3433,3703,270,7.3
6625,2011,June,Jack                                                 ,Not Adjusted,3455,3748,293,7.8
6626,2011,September,Jack                                                 ,Not Adjusted,3462,3732,270,7.2
6627,2011,December,Jack                                                 ,Not Adjusted,3468,3698,230,6.2
6628,2011,March,Jackson                                              ,Not Adjusted,6717,7177,460,6.4
6629,2011,June,Jackson                                              ,Not Adjusted,6978,7536,558,7.4
6630,2011,September,Jackson                                              ,Not Adjusted,7055,7525,470,6.2
6631,2011,December,Jackson                                              ,Not Adjusted,7065,7456,391,5.2
6632,2011,March,Jasper                                               ,Not Adjusted,12958,14952,1994,13.3
6633,2011,June,Jasper                                               ,Not Adjusted,13118,15170,2052,13.5
6634,2011,September,Jasper                                               ,Not Adjusted,13188,15102,1914,12.7
6635,2011,December,Jasper                                               ,Not Adjusted,13495,15159,1664,11.0
6636,2011,March,Jeff Davis                                           ,Not Adjusted,1182,1243,61,4.9
6637,2011,June,Jeff Davis                                           ,Not Adjusted,1253,1319,66,5.0
6638,2011,September,Jeff Davis                                           ,Not Adjusted,1200,1263,63,5.0
6639,2011,December,Jeff Davis                                           ,Not Adjusted,1168,1232,64,5.2
6640,2011,March,Jefferson                                            ,Not Adjusted,101429,115141,13712,11.9
6641,2011,June,Jefferson                                            ,Not Adjusted,101730,116248,14518,12.5
6642,2011,September,Jefferson                                            ,Not Adjusted,102960,116675,13715,11.8
6643,2011,December,Jefferson                                            ,Not Adjusted,103031,115222,12191,10.6
6644,2011,March,Jim Hogg                                             ,Not Adjusted,2106,2325,219,9.4
6645,2011,June,Jim Hogg                                             ,Not Adjusted,2073,2302,229,9.9
6646,2011,September,Jim Hogg                                             ,Not Adjusted,2126,2329,203,8.7
6647,2011,December,Jim Hogg                                             ,Not Adjusted,2160,2321,161,6.9
6648,2011,March,Jim Wells                                            ,Not Adjusted,17446,19093,1647,8.6
6649,2011,June,Jim Wells                                            ,Not Adjusted,17973,19790,1817,9.2
6650,2011,September,Jim Wells                                            ,Not Adjusted,18591,20219,1628,8.1
6651,2011,December,Jim Wells                                            ,Not Adjusted,19202,20568,1366,6.6
6652,2011,March,Johnson                                              ,Not Adjusted,66093,72059,5966,8.3
6653,2011,June,Johnson                                              ,Not Adjusted,66755,73244,6489,8.9
6654,2011,September,Johnson                                              ,Not Adjusted,67429,73297,5868,8.0
6655,2011,December,Johnson                                              ,Not Adjusted,68132,73132,5000,6.8
6656,2011,March,Jones                                                ,Not Adjusted,5597,6127,530,8.7
6657,2011,June,Jones                                                ,Not Adjusted,5607,6178,571,9.2
6658,2011,September,Jones                                                ,Not Adjusted,5632,6191,559,9.0
6659,2011,December,Jones                                                ,Not Adjusted,5677,6155,478,7.8
6660,2011,March,Karnes                                               ,Not Adjusted,4464,4841,377,7.8
6661,2011,June,Karnes                                               ,Not Adjusted,4502,4955,453,9.1
6662,2011,September,Karnes                                               ,Not Adjusted,4443,4846,403,8.3
6663,2011,December,Karnes                                               ,Not Adjusted,4621,4950,329,6.6
6664,2011,March,Kaufman                                              ,Not Adjusted,46847,51161,4314,8.4
6665,2011,June,Kaufman                                              ,Not Adjusted,47004,51694,4690,9.1
6666,2011,September,Kaufman                                              ,Not Adjusted,47554,51887,4333,8.4
6667,2011,December,Kaufman                                              ,Not Adjusted,47919,51610,3691,7.2
6668,2011,March,Kendall                                              ,Not Adjusted,15738,16763,1025,6.1
6669,2011,June,Kendall                                              ,Not Adjusted,15796,16982,1186,7.0
6670,2011,September,Kendall                                              ,Not Adjusted,15952,17065,1113,6.5
6671,2011,December,Kendall                                              ,Not Adjusted,16100,17024,924,5.4
6672,2011,March,Kenedy                                               ,Not Adjusted,217,231,14,6.1
6673,2011,June,Kenedy                                               ,Not Adjusted,222,238,16,6.7
6674,2011,September,Kenedy                                               ,Not Adjusted,230,250,20,8.0
6675,2011,December,Kenedy                                               ,Not Adjusted,245,260,15,5.8
6676,2011,March,Kent                                                 ,Not Adjusted,522,553,31,5.6
6677,2011,June,Kent                                                 ,Not Adjusted,532,559,27,4.8
6678,2011,September,Kent                                                 ,Not Adjusted,528,553,25,4.5
6679,2011,December,Kent                                                 ,Not Adjusted,533,560,27,4.8
6680,2011,March,Kerr                                                 ,Not Adjusted,20054,21539,1485,6.9
6681,2011,June,Kerr                                                 ,Not Adjusted,20645,22339,1694,7.6
6682,2011,September,Kerr                                                 ,Not Adjusted,20182,21753,1571,7.2
6683,2011,December,Kerr                                                 ,Not Adjusted,20610,21878,1268,5.8
6684,2011,March,Kimble                                               ,Not Adjusted,2054,2207,153,6.9
6685,2011,June,Kimble                                               ,Not Adjusted,2155,2326,171,7.4
6686,2011,September,Kimble                                               ,Not Adjusted,2042,2184,142,6.5
6687,2011,December,Kimble                                               ,Not Adjusted,2151,2259,108,4.8
6688,2011,March,King                                                 ,Not Adjusted,262,273,11,4.0
6689,2011,June,King                                                 ,Not Adjusted,308,321,13,4.0
6690,2011,September,King                                                 ,Not Adjusted,294,306,12,3.9
6691,2011,December,King                                                 ,Not Adjusted,274,285,11,3.9
6692,2011,March,Kinney                                               ,Not Adjusted,1125,1274,149,11.7
6693,2011,June,Kinney                                               ,Not Adjusted,1155,1297,142,10.9
6694,2011,September,Kinney                                               ,Not Adjusted,1156,1280,124,9.7
6695,2011,December,Kinney                                               ,Not Adjusted,1159,1275,116,9.1
6696,2011,March,Kleberg                                              ,Not Adjusted,13987,15227,1240,8.1
6697,2011,June,Kleberg                                              ,Not Adjusted,14041,15490,1449,9.4
6698,2011,September,Kleberg                                              ,Not Adjusted,14205,15479,1274,8.2
6699,2011,December,Kleberg                                              ,Not Adjusted,14500,15600,1100,7.1
6700,2011,March,Knox                                                 ,Not Adjusted,1750,1870,120,6.4
6701,2011,June,Knox                                                 ,Not Adjusted,1827,1952,125,6.4
6702,2011,September,Knox                                                 ,Not Adjusted,1844,1953,109,5.6
6703,2011,December,Knox                                                 ,Not Adjusted,1808,1907,99,5.2
6704,2011,March,Lamar                                                ,Not Adjusted,21193,23518,2325,9.9
6705,2011,June,Lamar                                                ,Not Adjusted,20970,23527,2557,10.9
6706,2011,September,Lamar                                                ,Not Adjusted,21037,23500,2463,10.5
6707,2011,December,Lamar                                                ,Not Adjusted,20919,23111,2192,9.5
6708,2011,March,Lamb                                                 ,Not Adjusted,6167,6699,532,7.9
6709,2011,June,Lamb                                                 ,Not Adjusted,6306,6880,574,8.3
6710,2011,September,Lamb                                                 ,Not Adjusted,6232,6772,540,8.0
6711,2011,December,Lamb                                                 ,Not Adjusted,6294,6782,488,7.2
6712,2011,March,Lampasas                                             ,Not Adjusted,8424,9115,691,7.6
6713,2011,June,Lampasas                                             ,Not Adjusted,8388,9159,771,8.4
6714,2011,September,Lampasas                                             ,Not Adjusted,8437,9185,748,8.1
6715,2011,December,Lampasas                                             ,Not Adjusted,8461,9110,649,7.1
6716,2011,March,La Salle                                             ,Not Adjusted,2820,3051,231,7.6
6717,2011,June,La Salle                                             ,Not Adjusted,2880,3124,244,7.8
6718,2011,September,La Salle                                             ,Not Adjusted,3063,3270,207,6.3
6719,2011,December,La Salle                                             ,Not Adjusted,3127,3304,177,5.4
6720,2011,March,Lavaca                                               ,Not Adjusted,8982,9590,608,6.3
6721,2011,June,Lavaca                                               ,Not Adjusted,9081,9746,665,6.8
6722,2011,September,Lavaca                                               ,Not Adjusted,9025,9622,597,6.2
6723,2011,December,Lavaca                                               ,Not Adjusted,9143,9617,474,4.9
6724,2011,March,Lee                                                  ,Not Adjusted,7942,8530,588,6.9
6725,2011,June,Lee                                                  ,Not Adjusted,8309,8951,642,7.2
6726,2011,September,Lee                                                  ,Not Adjusted,8538,9167,629,6.9
6727,2011,December,Lee                                                  ,Not Adjusted,8357,8878,521,5.9
6728,2011,March,Leon                                                 ,Not Adjusted,6529,7179,650,9.1
6729,2011,June,Leon                                                 ,Not Adjusted,6688,7389,701,9.5
6730,2011,September,Leon                                                 ,Not Adjusted,6576,7243,667,9.2
6731,2011,December,Leon                                                 ,Not Adjusted,6383,6935,552,8.0
6732,2011,March,Liberty                                              ,Not Adjusted,27028,30603,3575,11.7
6733,2011,June,Liberty                                              ,Not Adjusted,27157,30971,3814,12.3
6734,2011,September,Liberty                                              ,Not Adjusted,27491,31018,3527,11.4
6735,2011,December,Liberty                                              ,Not Adjusted,27849,31027,3178,10.2
6736,2011,March,Limestone                                            ,Not Adjusted,8771,9600,829,8.6
6737,2011,June,Limestone                                            ,Not Adjusted,8866,9768,902,9.2
6738,2011,September,Limestone                                            ,Not Adjusted,8663,9511,848,8.9
6739,2011,December,Limestone                                            ,Not Adjusted,8751,9433,682,7.2
6740,2011,March,Lipscomb                                             ,Not Adjusted,1644,1724,80,4.6
6741,2011,June,Lipscomb                                             ,Not Adjusted,1696,1786,90,5.0
6742,2011,September,Lipscomb                                             ,Not Adjusted,1702,1791,89,5.0
6743,2011,December,Lipscomb                                             ,Not Adjusted,1717,1787,70,3.9
6744,2011,March,Live Oak                                             ,Not Adjusted,4650,4963,313,6.3
6745,2011,June,Live Oak                                             ,Not Adjusted,4967,5339,372,7.0
6746,2011,September,Live Oak                                             ,Not Adjusted,5137,5471,334,6.1
6747,2011,December,Live Oak                                             ,Not Adjusted,5175,5450,275,5.0
6748,2011,March,Llano                                                ,Not Adjusted,7458,8095,637,7.9
6749,2011,June,Llano                                                ,Not Adjusted,7495,8187,692,8.5
6750,2011,September,Llano                                                ,Not Adjusted,7372,8049,677,8.4
6751,2011,December,Llano                                                ,Not Adjusted,7261,7816,555,7.1
6752,2011,March,Loving                                               ,Not Adjusted,60,65,5,7.7
6753,2011,June,Loving                                               ,Not Adjusted,56,60,4,6.7
6754,2011,September,Loving                                               ,Not Adjusted,64,68,4,5.9
6755,2011,December,Loving                                               ,Not Adjusted,73,77,4,5.2
6756,2011,March,Lubbock                                              ,Not Adjusted,136915,145512,8597,5.9
6757,2011,June,Lubbock                                              ,Not Adjusted,135446,146029,10583,7.2
6758,2011,September,Lubbock                                              ,Not Adjusted,136286,145656,9370,6.4
6759,2011,December,Lubbock                                              ,Not Adjusted,138047,145754,7707,5.3
6760,2011,March,Lynn                                                 ,Not Adjusted,2846,3047,201,6.6
6761,2011,June,Lynn                                                 ,Not Adjusted,2890,3134,244,7.8
6762,2011,September,Lynn                                                 ,Not Adjusted,2911,3137,226,7.2
6763,2011,December,Lynn                                                 ,Not Adjusted,2931,3110,179,5.8
6764,2011,March,McCulloch                                            ,Not Adjusted,4032,4291,259,6.0
6765,2011,June,McCulloch                                            ,Not Adjusted,4145,4450,305,6.9
6766,2011,September,McCulloch                                            ,Not Adjusted,4175,4449,274,6.2
6767,2011,December,McCulloch                                            ,Not Adjusted,4233,4471,238,5.3
6768,2011,March,McLennan                                             ,Not Adjusted,104357,112995,8638,7.6
6769,2011,June,McLennan                                             ,Not Adjusted,104562,114293,9731,8.5
6770,2011,September,McLennan                                             ,Not Adjusted,105175,114188,9013,7.9
6771,2011,December,McLennan                                             ,Not Adjusted,104726,112366,7640,6.8
6772,2011,March,McMullen                                             ,Not Adjusted,582,602,20,3.3
6773,2011,June,McMullen                                             ,Not Adjusted,637,660,23,3.5
6774,2011,September,McMullen                                             ,Not Adjusted,655,677,22,3.2
6775,2011,December,McMullen                                             ,Not Adjusted,695,714,19,2.7
6776,2011,March,Madison                                              ,Not Adjusted,4238,4638,400,8.6
6777,2011,June,Madison                                              ,Not Adjusted,4306,4766,460,9.7
6778,2011,September,Madison                                              ,Not Adjusted,4324,4734,410,8.7
6779,2011,December,Madison                                              ,Not Adjusted,4375,4706,331,7.0
6780,2011,March,Marion                                               ,Not Adjusted,4018,4485,467,10.4
6781,2011,June,Marion                                               ,Not Adjusted,3930,4446,516,11.6
6782,2011,September,Marion                                               ,Not Adjusted,3914,4407,493,11.2
6783,2011,December,Marion                                               ,Not Adjusted,3964,4379,415,9.5
6784,2011,March,Martin                                               ,Not Adjusted,2149,2284,135,5.9
6785,2011,June,Martin                                               ,Not Adjusted,2214,2365,151,6.4
6786,2011,September,Martin                                               ,Not Adjusted,2266,2403,137,5.7
6787,2011,December,Martin                                               ,Not Adjusted,2296,2410,114,4.7
6788,2011,March,Mason                                                ,Not Adjusted,1838,1958,120,6.1
6789,2011,June,Mason                                                ,Not Adjusted,1872,2009,137,6.8
6790,2011,September,Mason                                                ,Not Adjusted,1853,1980,127,6.4
6791,2011,December,Mason                                                ,Not Adjusted,1858,1964,106,5.4
6792,2011,March,Matagorda                                            ,Not Adjusted,15861,17973,2112,11.8
6793,2011,June,Matagorda                                            ,Not Adjusted,15656,17968,2312,12.9
6794,2011,September,Matagorda                                            ,Not Adjusted,15510,17618,2108,12.0
6795,2011,December,Matagorda                                            ,Not Adjusted,15733,17723,1990,11.2
6796,2011,March,Maverick                                             ,Not Adjusted,20487,24477,3990,16.3
6797,2011,June,Maverick                                             ,Not Adjusted,20517,24064,3547,14.7
6798,2011,September,Maverick                                             ,Not Adjusted,20566,23548,2982,12.7
6799,2011,December,Maverick                                             ,Not Adjusted,20786,23822,3036,12.7
6800,2011,March,Medina                                               ,Not Adjusted,18546,20086,1540,7.7
6801,2011,June,Medina                                               ,Not Adjusted,18654,20353,1699,8.3
6802,2011,September,Medina                                               ,Not Adjusted,18802,20445,1643,8.0
6803,2011,December,Medina                                               ,Not Adjusted,18948,20321,1373,6.8
6804,2011,March,Menard                                               ,Not Adjusted,866,935,69,7.4
6805,2011,June,Menard                                               ,Not Adjusted,882,959,77,8.0
6806,2011,September,Menard                                               ,Not Adjusted,882,951,69,7.3
6807,2011,December,Menard                                               ,Not Adjusted,889,951,62,6.5
6808,2011,March,Midland                                              ,Not Adjusted,70906,74628,3722,5.0
6809,2011,June,Midland                                              ,Not Adjusted,72152,76378,4226,5.5
6810,2011,September,Midland                                              ,Not Adjusted,74026,77926,3900,5.0
6811,2011,December,Midland                                              ,Not Adjusted,75301,78430,3129,4.0
6812,2011,March,Milam                                                ,Not Adjusted,9284,10424,1140,10.9
6813,2011,June,Milam                                                ,Not Adjusted,9311,10496,1185,11.3
6814,2011,September,Milam                                                ,Not Adjusted,9393,10486,1093,10.4
6815,2011,December,Milam                                                ,Not Adjusted,9453,10382,929,8.9
6816,2011,March,Mills                                                ,Not Adjusted,2017,2166,149,6.9
6817,2011,June,Mills                                                ,Not Adjusted,2034,2186,152,7.0
6818,2011,September,Mills                                                ,Not Adjusted,2035,2187,152,7.0
6819,2011,December,Mills                                                ,Not Adjusted,2087,2206,119,5.4
6820,2011,March,Mitchell                                             ,Not Adjusted,2722,2949,227,7.7
6821,2011,June,Mitchell                                             ,Not Adjusted,2698,2947,249,8.4
6822,2011,September,Mitchell                                             ,Not Adjusted,2748,2995,247,8.2
6823,2011,December,Mitchell                                             ,Not Adjusted,2707,2905,198,6.8
6824,2011,March,Montague                                             ,Not Adjusted,8965,9616,651,6.8
6825,2011,June,Montague                                             ,Not Adjusted,9110,9809,699,7.1
6826,2011,September,Montague                                             ,Not Adjusted,9161,9820,659,6.7
6827,2011,December,Montague                                             ,Not Adjusted,9193,9727,534,5.5
6828,2011,March,Montgomery                                           ,Not Adjusted,212856,229912,17056,7.4
6829,2011,June,Montgomery                                           ,Not Adjusted,213392,231908,18516,8.0
6830,2011,September,Montgomery                                           ,Not Adjusted,216108,233501,17393,7.4
6831,2011,December,Montgomery                                           ,Not Adjusted,219098,233623,14525,6.2
6832,2011,March,Moore                                                ,Not Adjusted,11038,11614,576,5.0
6833,2011,June,Moore                                                ,Not Adjusted,11271,11940,669,5.6
6834,2011,September,Moore                                                ,Not Adjusted,11188,11780,592,5.0
6835,2011,December,Moore                                                ,Not Adjusted,11281,11779,498,4.2
6836,2011,March,Morris                                               ,Not Adjusted,5087,5821,734,12.6
6837,2011,June,Morris                                               ,Not Adjusted,5095,5857,762,13.0
6838,2011,September,Morris                                               ,Not Adjusted,5119,5846,727,12.4
6839,2011,December,Morris                                               ,Not Adjusted,5188,5821,633,10.9
6840,2011,March,Motley                                               ,Not Adjusted,545,585,40,6.8
6841,2011,June,Motley                                               ,Not Adjusted,581,624,43,6.9
6842,2011,September,Motley                                               ,Not Adjusted,562,607,45,7.4
6843,2011,December,Motley                                               ,Not Adjusted,525,566,41,7.2
6844,2011,March,Nacogdoches                                          ,Not Adjusted,28850,30896,2046,6.6
6845,2011,June,Nacogdoches                                          ,Not Adjusted,27928,30482,2554,8.4
6846,2011,September,Nacogdoches                                          ,Not Adjusted,28498,30779,2281,7.4
6847,2011,December,Nacogdoches                                          ,Not Adjusted,28466,30356,1890,6.2
6848,2011,March,Navarro                                              ,Not Adjusted,20906,22892,1986,8.7
6849,2011,June,Navarro                                              ,Not Adjusted,20578,22734,2156,9.5
6850,2011,September,Navarro                                              ,Not Adjusted,21506,23452,1946,8.3
6851,2011,December,Navarro                                              ,Not Adjusted,21841,23482,1641,7.0
6852,2011,March,Newton                                               ,Not Adjusted,5221,5999,778,13.0
6853,2011,June,Newton                                               ,Not Adjusted,5252,6109,857,14.0
6854,2011,September,Newton                                               ,Not Adjusted,5314,6109,795,13.0
6855,2011,December,Newton                                               ,Not Adjusted,5312,6036,724,12.0
6856,2011,March,Nolan                                                ,Not Adjusted,6838,7387,549,7.4
6857,2011,June,Nolan                                                ,Not Adjusted,6930,7517,587,7.8
6858,2011,September,Nolan                                                ,Not Adjusted,6748,7300,552,7.6
6859,2011,December,Nolan                                                ,Not Adjusted,6713,7162,449,6.3
6860,2011,March,Nueces                                               ,Not Adjusted,149509,163129,13620,8.3
6861,2011,June,Nueces                                               ,Not Adjusted,150712,165495,14783,8.9
6862,2011,September,Nueces                                               ,Not Adjusted,151486,165159,13673,8.3
6863,2011,December,Nueces                                               ,Not Adjusted,152744,164434,11690,7.1
6864,2011,March,Ochiltree                                            ,Not Adjusted,4681,4935,254,5.1
6865,2011,June,Ochiltree                                            ,Not Adjusted,4931,5224,293,5.6
6866,2011,September,Ochiltree                                            ,Not Adjusted,4908,5169,261,5.0
6867,2011,December,Ochiltree                                            ,Not Adjusted,4986,5190,204,3.9
6868,2011,March,Oldham                                               ,Not Adjusted,922,968,46,4.8
6869,2011,June,Oldham                                               ,Not Adjusted,941,991,50,5.0
6870,2011,September,Oldham                                               ,Not Adjusted,948,992,44,4.4
6871,2011,December,Oldham                                               ,Not Adjusted,949,986,37,3.8
6872,2011,March,Orange                                               ,Not Adjusted,34389,39042,4653,11.9
6873,2011,June,Orange                                               ,Not Adjusted,34458,39443,4985,12.6
6874,2011,September,Orange                                               ,Not Adjusted,34882,39611,4729,11.9
6875,2011,December,Orange                                               ,Not Adjusted,34915,39026,4111,10.5
6876,2011,March,Palo Pinto                                           ,Not Adjusted,12153,13264,1111,8.4
6877,2011,June,Palo Pinto                                           ,Not Adjusted,12469,13664,1195,8.7
6878,2011,September,Palo Pinto                                           ,Not Adjusted,12555,13683,1128,8.2
6879,2011,December,Palo Pinto                                           ,Not Adjusted,12541,13476,935,6.9
6880,2011,March,Panola                                               ,Not Adjusted,10606,11588,982,8.5
6881,2011,June,Panola                                               ,Not Adjusted,10683,11777,1094,9.3
6882,2011,September,Panola                                               ,Not Adjusted,11531,12570,1039,8.3
6883,2011,December,Panola                                               ,Not Adjusted,11342,12254,912,7.4
6884,2011,March,Parker                                               ,Not Adjusted,52589,56750,4161,7.3
6885,2011,June,Parker                                               ,Not Adjusted,53121,57623,4502,7.8
6886,2011,September,Parker                                               ,Not Adjusted,53686,57806,4120,7.1
6887,2011,December,Parker                                               ,Not Adjusted,54257,57706,3449,6.0
6888,2011,March,Parmer                                               ,Not Adjusted,5062,5290,228,4.3
6889,2011,June,Parmer                                               ,Not Adjusted,5105,5393,288,5.3
6890,2011,September,Parmer                                               ,Not Adjusted,5093,5348,255,4.8
6891,2011,December,Parmer                                               ,Not Adjusted,5036,5239,203,3.9
6892,2011,March,Pecos                                                ,Not Adjusted,6649,7123,474,6.7
6893,2011,June,Pecos                                                ,Not Adjusted,6783,7280,497,6.8
6894,2011,September,Pecos                                                ,Not Adjusted,6839,7277,438,6.0
6895,2011,December,Pecos                                                ,Not Adjusted,6685,7048,363,5.2
6896,2011,March,Polk                                                 ,Not Adjusted,15946,17736,1790,10.1
6897,2011,June,Polk                                                 ,Not Adjusted,15955,17787,1832,10.3
6898,2011,September,Polk                                                 ,Not Adjusted,15826,17556,1730,9.9
6899,2011,December,Polk                                                 ,Not Adjusted,16036,17521,1485,8.5
6900,2011,March,Potter                                               ,Not Adjusted,54729,58215,3486,6.0
6901,2011,June,Potter                                               ,Not Adjusted,54793,58811,4018,6.8
6902,2011,September,Potter                                               ,Not Adjusted,55266,59014,3748,6.4
6903,2011,December,Potter                                               ,Not Adjusted,55603,58742,3139,5.3
6904,2011,March,Presidio                                             ,Not Adjusted,3146,3753,607,16.2
6905,2011,June,Presidio                                             ,Not Adjusted,3219,3856,637,16.5
6906,2011,September,Presidio                                             ,Not Adjusted,3250,3804,554,14.6
6907,2011,December,Presidio                                             ,Not Adjusted,3298,3780,482,12.8
6908,2011,March,Rains                                                ,Not Adjusted,4822,5263,441,8.4
6909,2011,June,Rains                                                ,Not Adjusted,4694,5165,471,9.1
6910,2011,September,Rains                                                ,Not Adjusted,4703,5167,464,9.0
6911,2011,December,Rains                                                ,Not Adjusted,4750,5132,382,7.4
6912,2011,March,Randall                                              ,Not Adjusted,64071,67472,3401,5.0
6913,2011,June,Randall                                              ,Not Adjusted,64337,68271,3934,5.8
6914,2011,September,Randall                                              ,Not Adjusted,64814,68454,3640,5.3
6915,2011,December,Randall                                              ,Not Adjusted,65115,68113,2998,4.4
6916,2011,March,Reagan                                               ,Not Adjusted,1890,1983,93,4.7
6917,2011,June,Reagan                                               ,Not Adjusted,1885,1992,107,5.4
6918,2011,September,Reagan                                               ,Not Adjusted,1897,1989,92,4.6
6919,2011,December,Reagan                                               ,Not Adjusted,1979,2051,72,3.5
6920,2011,March,Real                                                 ,Not Adjusted,989,1099,110,10.0
6921,2011,June,Real                                                 ,Not Adjusted,1125,1255,130,10.4
6922,2011,September,Real                                                 ,Not Adjusted,1033,1157,124,10.7
6923,2011,December,Real                                                 ,Not Adjusted,960,1064,104,9.8
6924,2011,March,Red River                                            ,Not Adjusted,4860,5519,659,11.9
6925,2011,June,Red River                                            ,Not Adjusted,4802,5548,746,13.4
6926,2011,September,Red River                                            ,Not Adjusted,4808,5510,702,12.7
6927,2011,December,Red River                                            ,Not Adjusted,4776,5366,590,11.0
6928,2011,March,Reeves                                               ,Not Adjusted,5151,5600,449,8.0
6929,2011,June,Reeves                                               ,Not Adjusted,5176,5729,553,9.7
6930,2011,September,Reeves                                               ,Not Adjusted,5063,5549,486,8.8
6931,2011,December,Reeves                                               ,Not Adjusted,4994,5400,406,7.5
6932,2011,March,Refugio                                              ,Not Adjusted,3127,3404,277,8.1
6933,2011,June,Refugio                                              ,Not Adjusted,3163,3459,296,8.6
6934,2011,September,Refugio                                              ,Not Adjusted,3163,3437,274,8.0
6935,2011,December,Refugio                                              ,Not Adjusted,3258,3480,222,6.4
6936,2011,March,Roberts                                              ,Not Adjusted,458,484,26,5.4
6937,2011,June,Roberts                                              ,Not Adjusted,464,491,27,5.5
6938,2011,September,Roberts                                              ,Not Adjusted,456,481,25,5.2
6939,2011,December,Roberts                                              ,Not Adjusted,465,487,22,4.5
6940,2011,March,Robertson                                            ,Not Adjusted,6878,7617,739,9.7
6941,2011,June,Robertson                                            ,Not Adjusted,6675,7457,782,10.5
6942,2011,September,Robertson                                            ,Not Adjusted,6904,7634,730,9.6
6943,2011,December,Robertson                                            ,Not Adjusted,6924,7549,625,8.3
6944,2011,March,Rockwall                                             ,Not Adjusted,37314,40348,3034,7.5
6945,2011,June,Rockwall                                             ,Not Adjusted,37388,40627,3239,8.0
6946,2011,September,Rockwall                                             ,Not Adjusted,37857,40898,3041,7.4
6947,2011,December,Rockwall                                             ,Not Adjusted,38178,40730,2552,6.3
6948,2011,March,Runnels                                              ,Not Adjusted,4680,5059,379,7.5
6949,2011,June,Runnels                                              ,Not Adjusted,4726,5152,426,8.3
6950,2011,September,Runnels                                              ,Not Adjusted,4744,5223,479,9.2
6951,2011,December,Runnels                                              ,Not Adjusted,4850,5150,300,5.8
6952,2011,March,Rusk                                                 ,Not Adjusted,22280,24013,1733,7.2
6953,2011,June,Rusk                                                 ,Not Adjusted,22199,24172,1973,8.2
6954,2011,September,Rusk                                                 ,Not Adjusted,22694,24500,1806,7.4
6955,2011,December,Rusk                                                 ,Not Adjusted,22938,24446,1508,6.2
6956,2011,March,Sabine                                               ,Not Adjusted,2874,3458,584,16.9
6957,2011,June,Sabine                                               ,Not Adjusted,2962,3577,615,17.2
6958,2011,September,Sabine                                               ,Not Adjusted,2927,3464,537,15.5
6959,2011,December,Sabine                                               ,Not Adjusted,2887,3390,503,14.8
6960,2011,March,San Augustine                                        ,Not Adjusted,2726,3201,475,14.8
6961,2011,June,San Augustine                                        ,Not Adjusted,2691,3170,479,15.1
6962,2011,September,San Augustine                                        ,Not Adjusted,2679,3130,451,14.4
6963,2011,December,San Augustine                                        ,Not Adjusted,2681,3088,407,13.2
6964,2011,March,San Jacinto                                          ,Not Adjusted,10175,11343,1168,10.3
6965,2011,June,San Jacinto                                          ,Not Adjusted,10240,11479,1239,10.8
6966,2011,September,San Jacinto                                          ,Not Adjusted,10325,11453,1128,9.8
6967,2011,December,San Jacinto                                          ,Not Adjusted,10355,11351,996,8.8
6968,2011,March,San Patricio                                         ,Not Adjusted,26959,30104,3145,10.4
6969,2011,June,San Patricio                                         ,Not Adjusted,27261,30548,3287,10.8
6970,2011,September,San Patricio                                         ,Not Adjusted,27381,30333,2952,9.7
6971,2011,December,San Patricio                                         ,Not Adjusted,27576,30144,2568,8.5
6972,2011,March,San Saba                                             ,Not Adjusted,2385,2541,156,6.1
6973,2011,June,San Saba                                             ,Not Adjusted,2368,2540,172,6.8
6974,2011,September,San Saba                                             ,Not Adjusted,2375,2537,162,6.4
6975,2011,December,San Saba                                             ,Not Adjusted,2306,2449,143,5.8
6976,2011,March,Schleicher                                           ,Not Adjusted,1526,1639,113,6.9
6977,2011,June,Schleicher                                           ,Not Adjusted,1613,1721,108,6.3
6978,2011,September,Schleicher                                           ,Not Adjusted,1633,1732,99,5.7
6979,2011,December,Schleicher                                           ,Not Adjusted,1693,1766,73,4.1
6980,2011,March,Scurry                                               ,Not Adjusted,6772,7196,424,5.9
6981,2011,June,Scurry                                               ,Not Adjusted,6801,7318,517,7.1
6982,2011,September,Scurry                                               ,Not Adjusted,7106,7532,426,5.7
6983,2011,December,Scurry                                               ,Not Adjusted,7359,7719,360,4.7
6984,2011,March,Shackelford                                          ,Not Adjusted,1802,1905,103,5.4
6985,2011,June,Shackelford                                          ,Not Adjusted,1911,2024,113,5.6
6986,2011,September,Shackelford                                          ,Not Adjusted,1982,2083,101,4.8
6987,2011,December,Shackelford                                          ,Not Adjusted,2078,2155,77,3.6
6988,2011,March,Shelby                                               ,Not Adjusted,10641,11701,1060,9.1
6989,2011,June,Shelby                                               ,Not Adjusted,10794,11929,1135,9.5
6990,2011,September,Shelby                                               ,Not Adjusted,11209,12233,1024,8.4
6991,2011,December,Shelby                                               ,Not Adjusted,11328,12186,858,7.0
6992,2011,March,Sherman                                              ,Not Adjusted,1470,1536,66,4.3
6993,2011,June,Sherman                                              ,Not Adjusted,1538,1623,85,5.2
6994,2011,September,Sherman                                              ,Not Adjusted,1523,1602,79,4.9
6995,2011,December,Sherman                                              ,Not Adjusted,1528,1593,65,4.1
6996,2011,March,Smith                                                ,Not Adjusted,93296,101150,7854,7.8
6997,2011,June,Smith                                                ,Not Adjusted,93394,101937,8543,8.4
6998,2011,September,Smith                                                ,Not Adjusted,93909,102351,8442,8.2
6999,2011,December,Smith                                                ,Not Adjusted,95390,102962,7572,7.4
7000,2011,March,Somervell                                            ,Not Adjusted,3711,4045,334,8.3
7001,2011,June,Somervell                                            ,Not Adjusted,3744,4093,349,8.5
7002,2011,September,Somervell                                            ,Not Adjusted,3785,4121,336,8.2
7003,2011,December,Somervell                                            ,Not Adjusted,3827,4115,288,7.0
7004,2011,March,Starr                                                ,Not Adjusted,21893,26634,4741,17.8
7005,2011,June,Starr                                                ,Not Adjusted,21480,26076,4596,17.6
7006,2011,September,Starr                                                ,Not Adjusted,21816,25658,3842,15.0
7007,2011,December,Starr                                                ,Not Adjusted,22424,26618,4194,15.8
7008,2011,March,Stephens                                             ,Not Adjusted,4017,4399,382,8.7
7009,2011,June,Stephens                                             ,Not Adjusted,4110,4503,393,8.7
7010,2011,September,Stephens                                             ,Not Adjusted,4152,4515,363,8.0
7011,2011,December,Stephens                                             ,Not Adjusted,4111,4392,281,6.4
7012,2011,March,Sterling                                             ,Not Adjusted,626,663,37,5.6
7013,2011,June,Sterling                                             ,Not Adjusted,654,692,38,5.5
7014,2011,September,Sterling                                             ,Not Adjusted,676,708,32,4.5
7015,2011,December,Sterling                                             ,Not Adjusted,666,692,26,3.8
7016,2011,March,Stonewall                                            ,Not Adjusted,674,712,38,5.3
7017,2011,June,Stonewall                                            ,Not Adjusted,721,767,46,6.0
7018,2011,September,Stonewall                                            ,Not Adjusted,723,767,44,5.7
7019,2011,December,Stonewall                                            ,Not Adjusted,722,759,37,4.9
7020,2011,March,Sutton                                               ,Not Adjusted,1782,1934,152,7.9
7021,2011,June,Sutton                                               ,Not Adjusted,1806,1961,155,7.9
7022,2011,September,Sutton                                               ,Not Adjusted,1839,1973,134,6.8
7023,2011,December,Sutton                                               ,Not Adjusted,1842,1948,106,5.4
7024,2011,March,Swisher                                              ,Not Adjusted,2908,3121,213,6.8
7025,2011,June,Swisher                                              ,Not Adjusted,2979,3231,252,7.8
7026,2011,September,Swisher                                              ,Not Adjusted,2958,3190,232,7.3
7027,2011,December,Swisher                                              ,Not Adjusted,2953,3134,181,5.8
7028,2011,March,Tarrant                                              ,Not Adjusted,865800,940954,75154,8.0
7029,2011,June,Tarrant                                              ,Not Adjusted,873584,954100,80516,8.4
7030,2011,September,Tarrant                                              ,Not Adjusted,882392,958018,75626,7.9
7031,2011,December,Tarrant                                              ,Not Adjusted,891826,955784,63958,6.7
7032,2011,March,Taylor                                               ,Not Adjusted,60326,64687,4361,6.7
7033,2011,June,Taylor                                               ,Not Adjusted,59816,64719,4903,7.6
7034,2011,September,Taylor                                               ,Not Adjusted,60061,64572,4511,7.0
7035,2011,December,Taylor                                               ,Not Adjusted,60680,64413,3733,5.8
7036,2011,March,Terrell                                              ,Not Adjusted,472,506,34,6.7
7037,2011,June,Terrell                                              ,Not Adjusted,481,518,37,7.1
7038,2011,September,Terrell                                              ,Not Adjusted,502,536,34,6.3
7039,2011,December,Terrell                                              ,Not Adjusted,487,518,31,6.0
7040,2011,March,Terry                                                ,Not Adjusted,5399,5831,432,7.4
7041,2011,June,Terry                                                ,Not Adjusted,5506,5975,469,7.8
7042,2011,September,Terry                                                ,Not Adjusted,5465,5923,458,7.7
7043,2011,December,Terry                                                ,Not Adjusted,5447,5839,392,6.7
7044,2011,March,Throckmorton                                         ,Not Adjusted,797,858,61,7.1
7045,2011,June,Throckmorton                                         ,Not Adjusted,841,914,73,8.0
7046,2011,September,Throckmorton                                         ,Not Adjusted,809,872,63,7.2
7047,2011,December,Throckmorton                                         ,Not Adjusted,820,870,50,5.7
7048,2011,March,Titus                                                ,Not Adjusted,12733,13882,1149,8.3
7049,2011,June,Titus                                                ,Not Adjusted,12520,13808,1288,9.3
7050,2011,September,Titus                                                ,Not Adjusted,12595,13783,1188,8.6
7051,2011,December,Titus                                                ,Not Adjusted,12381,13362,981,7.3
7052,2011,March,Tom Green                                            ,Not Adjusted,49499,52850,3351,6.3
7053,2011,June,Tom Green                                            ,Not Adjusted,49440,53264,3824,7.2
7054,2011,September,Tom Green                                            ,Not Adjusted,50000,53582,3582,6.7
7055,2011,December,Tom Green                                            ,Not Adjusted,50572,53485,2913,5.4
7056,2011,March,Travis                                               ,Not Adjusted,550038,588354,38316,6.5
7057,2011,June,Travis                                               ,Not Adjusted,550349,592945,42596,7.2
7058,2011,September,Travis                                               ,Not Adjusted,556985,598230,41245,6.9
7059,2011,December,Travis                                               ,Not Adjusted,564695,598826,34131,5.7
7060,2011,March,Trinity                                              ,Not Adjusted,5133,5700,567,9.9
7061,2011,June,Trinity                                              ,Not Adjusted,5135,5740,605,10.5
7062,2011,September,Trinity                                              ,Not Adjusted,5228,5820,592,10.2
7063,2011,December,Trinity                                              ,Not Adjusted,5185,5700,515,9.0
7064,2011,March,Tyler                                                ,Not Adjusted,6928,7878,950,12.1
7065,2011,June,Tyler                                                ,Not Adjusted,6918,7985,1067,13.4
7066,2011,September,Tyler                                                ,Not Adjusted,6860,7871,1011,12.8
7067,2011,December,Tyler                                                ,Not Adjusted,6881,7760,879,11.3
7068,2011,March,Upshur                                               ,Not Adjusted,16907,18452,1545,8.4
7069,2011,June,Upshur                                               ,Not Adjusted,16847,18512,1665,9.0
7070,2011,September,Upshur                                               ,Not Adjusted,17223,18778,1555,8.3
7071,2011,December,Upshur                                               ,Not Adjusted,17406,18722,1316,7.0
7072,2011,March,Upton                                                ,Not Adjusted,1436,1519,83,5.5
7073,2011,June,Upton                                                ,Not Adjusted,1483,1578,95,6.0
7074,2011,September,Upton                                                ,Not Adjusted,1522,1615,93,5.8
7075,2011,December,Upton                                                ,Not Adjusted,1494,1563,69,4.4
7076,2011,March,Uvalde                                               ,Not Adjusted,10803,11891,1088,9.1
7077,2011,June,Uvalde                                               ,Not Adjusted,11232,12420,1188,9.6
7078,2011,September,Uvalde                                               ,Not Adjusted,11147,12295,1148,9.3
7079,2011,December,Uvalde                                               ,Not Adjusted,11183,12199,1016,8.3
7080,2011,March,Val Verde                                            ,Not Adjusted,18552,20491,1939,9.5
7081,2011,June,Val Verde                                            ,Not Adjusted,18766,20737,1971,9.5
7082,2011,September,Val Verde                                            ,Not Adjusted,18709,20488,1779,8.7
7083,2011,December,Val Verde                                            ,Not Adjusted,18668,20328,1660,8.2
7084,2011,March,Van Zandt                                            ,Not Adjusted,21756,23699,1943,8.2
7085,2011,June,Van Zandt                                            ,Not Adjusted,21823,23950,2127,8.9
7086,2011,September,Van Zandt                                            ,Not Adjusted,21687,23711,2024,8.5
7087,2011,December,Van Zandt                                            ,Not Adjusted,22099,23806,1707,7.2
7088,2011,March,Victoria                                             ,Not Adjusted,40015,43157,3142,7.3
7089,2011,June,Victoria                                             ,Not Adjusted,40399,43755,3356,7.7
7090,2011,September,Victoria                                             ,Not Adjusted,40956,44043,3087,7.0
7091,2011,December,Victoria                                             ,Not Adjusted,41781,44393,2612,5.9
7092,2011,March,Walker                                               ,Not Adjusted,21343,23092,1749,7.6
7093,2011,June,Walker                                               ,Not Adjusted,20785,22937,2152,9.4
7094,2011,September,Walker                                               ,Not Adjusted,21289,23281,1992,8.6
7095,2011,December,Walker                                               ,Not Adjusted,21478,23112,1634,7.1
7096,2011,March,Waller                                               ,Not Adjusted,18429,20072,1643,8.2
7097,2011,June,Waller                                               ,Not Adjusted,18556,20517,1961,9.6
7098,2011,September,Waller                                               ,Not Adjusted,18779,20546,1767,8.6
7099,2011,December,Waller                                               ,Not Adjusted,19012,20458,1446,7.1
7100,2011,March,Ward                                                 ,Not Adjusted,4367,4707,340,7.2
7101,2011,June,Ward                                                 ,Not Adjusted,4585,4948,363,7.3
7102,2011,September,Ward                                                 ,Not Adjusted,4784,5139,355,6.9
7103,2011,December,Ward                                                 ,Not Adjusted,4891,5158,267,5.2
7104,2011,March,Washington                                           ,Not Adjusted,14671,15692,1021,6.5
7105,2011,June,Washington                                           ,Not Adjusted,14642,15877,1235,7.8
7106,2011,September,Washington                                           ,Not Adjusted,14659,15771,1112,7.1
7107,2011,December,Washington                                           ,Not Adjusted,14701,15610,909,5.8
7108,2011,March,Webb                                                 ,Not Adjusted,98704,106950,8246,7.7
7109,2011,June,Webb                                                 ,Not Adjusted,98367,107703,9336,8.7
7110,2011,September,Webb                                                 ,Not Adjusted,100195,108481,8286,7.6
7111,2011,December,Webb                                                 ,Not Adjusted,102236,109299,7063,6.5
7112,2011,March,Wharton                                              ,Not Adjusted,19590,21377,1787,8.4
7113,2011,June,Wharton                                              ,Not Adjusted,19716,21673,1957,9.0
7114,2011,September,Wharton                                              ,Not Adjusted,19670,21587,1917,8.9
7115,2011,December,Wharton                                              ,Not Adjusted,20030,21655,1625,7.5
7116,2011,March,Wheeler                                              ,Not Adjusted,2631,2777,146,5.3
7117,2011,June,Wheeler                                              ,Not Adjusted,2852,3014,162,5.4
7118,2011,September,Wheeler                                              ,Not Adjusted,2670,2823,153,5.4
7119,2011,December,Wheeler                                              ,Not Adjusted,2829,2948,119,4.0
7120,2011,March,Wichita                                              ,Not Adjusted,54962,59158,4196,7.1
7121,2011,June,Wichita                                              ,Not Adjusted,54882,59567,4685,7.9
7122,2011,September,Wichita                                              ,Not Adjusted,54463,58706,4243,7.2
7123,2011,December,Wichita                                              ,Not Adjusted,55148,58755,3607,6.1
7124,2011,March,Wilbarger                                            ,Not Adjusted,5598,6064,466,7.7
7125,2011,June,Wilbarger                                            ,Not Adjusted,5596,6114,518,8.5
7126,2011,September,Wilbarger                                            ,Not Adjusted,5493,5935,442,7.4
7127,2011,December,Wilbarger                                            ,Not Adjusted,5661,6026,365,6.1
7128,2011,March,Willacy                                              ,Not Adjusted,6699,7943,1244,15.7
7129,2011,June,Willacy                                              ,Not Adjusted,6606,7929,1323,16.7
7130,2011,September,Willacy                                              ,Not Adjusted,6094,7520,1426,19.0
7131,2011,December,Willacy                                              ,Not Adjusted,6278,7535,1257,16.7
7132,2011,March,Williamson                                           ,Not Adjusted,212810,228899,16089,7.0
7133,2011,June,Williamson                                           ,Not Adjusted,213231,230816,17585,7.6
7134,2011,September,Williamson                                           ,Not Adjusted,215586,232587,17001,7.3
7135,2011,December,Williamson                                           ,Not Adjusted,218391,232540,14149,6.1
7136,2011,March,Wilson                                               ,Not Adjusted,19965,21389,1424,6.7
7137,2011,June,Wilson                                               ,Not Adjusted,20020,21669,1649,7.6
7138,2011,September,Wilson                                               ,Not Adjusted,20181,21704,1523,7.0
7139,2011,December,Wilson                                               ,Not Adjusted,20350,21574,1224,5.7
7140,2011,March,Winkler                                              ,Not Adjusted,2742,2980,238,8.0
7141,2011,June,Winkler                                              ,Not Adjusted,2820,3074,254,8.3
7142,2011,September,Winkler                                              ,Not Adjusted,2856,3075,219,7.1
7143,2011,December,Winkler                                              ,Not Adjusted,2912,3096,184,5.9
7144,2011,March,Wise                                                 ,Not Adjusted,25613,27889,2276,8.2
7145,2011,June,Wise                                                 ,Not Adjusted,25902,28359,2457,8.7
7146,2011,September,Wise                                                 ,Not Adjusted,26179,28371,2192,7.7
7147,2011,December,Wise                                                 ,Not Adjusted,26452,28278,1826,6.5
7148,2011,March,Wood                                                 ,Not Adjusted,15533,17010,1477,8.7
7149,2011,June,Wood                                                 ,Not Adjusted,15467,17115,1648,9.6
7150,2011,September,Wood                                                 ,Not Adjusted,15426,17019,1593,9.4
7151,2011,December,Wood                                                 ,Not Adjusted,15500,16857,1357,8.1
7152,2011,March,Yoakum                                               ,Not Adjusted,3733,3972,239,6.0
7153,2011,June,Yoakum                                               ,Not Adjusted,3959,4210,251,6.0
7154,2011,September,Yoakum                                               ,Not Adjusted,4145,4376,231,5.3
7155,2011,December,Yoakum                                               ,Not Adjusted,4276,4457,181,4.1
7156,2011,March,Young                                                ,Not Adjusted,7907,8577,670,7.8
7157,2011,June,Young                                                ,Not Adjusted,7961,8676,715,8.2
7158,2011,September,Young                                                ,Not Adjusted,7978,8597,619,7.2
7159,2011,December,Young                                                ,Not Adjusted,8053,8577,524,6.1
7160,2011,March,Zapata                                               ,Not Adjusted,5705,6267,562,9.0
7161,2011,June,Zapata                                               ,Not Adjusted,5873,6490,617,9.5
7162,2011,September,Zapata                                               ,Not Adjusted,6064,6588,524,8.0
7163,2011,December,Zapata                                               ,Not Adjusted,6221,6665,444,6.7
7164,2011,March,Zavala                                               ,Not Adjusted,4041,4677,636,13.6
7165,2011,June,Zavala                                               ,Not Adjusted,3934,4662,728,15.6
7166,2011,September,Zavala                                               ,Not Adjusted,3792,4482,690,15.4
7167,2011,December,Zavala                                               ,Not Adjusted,4013,4616,603,13.1
7168,2012,March,Texas,Not Adjusted,11723236,12557540,834304,6.6
7169,2012,March,Texas,Adjusted,11722322,12563758,841436,6.7
7170,2012,June,Texas,Not Adjusted,11780372,12704860,924488,7.3
7171,2012,June,Texas,Adjusted,11776105,12632078,855973,6.8
7172,2012,September,Texas,Not Adjusted,11869056,12676366,807310,6.4
7173,2012,September,Texas,Adjusted,11857386,12683588,826202,6.5
7174,2012,December,Texas,Not Adjusted,11916186,12709575,793389,6.2
7175,2012,December,Texas,Adjusted,11905455,12730458,825003,6.5
7176,2012,March,Anderson                                             ,Not Adjusted,21101,22405,1304,5.8
7177,2012,June,Anderson                                             ,Not Adjusted,21043,22621,1578,7.0
7178,2012,September,Anderson                                             ,Not Adjusted,21009,22369,1360,6.1
7179,2012,December,Anderson                                             ,Not Adjusted,20596,21935,1339,6.1
7180,2012,March,Andrews                                              ,Not Adjusted,8070,8391,321,3.8
7181,2012,June,Andrews                                              ,Not Adjusted,8151,8534,383,4.5
7182,2012,September,Andrews                                              ,Not Adjusted,8192,8510,318,3.7
7183,2012,December,Andrews                                              ,Not Adjusted,8410,8733,323,3.7
7184,2012,March,Angelina                                             ,Not Adjusted,35135,37630,2495,6.6
7185,2012,June,Angelina                                             ,Not Adjusted,35365,38205,2840,7.4
7186,2012,September,Angelina                                             ,Not Adjusted,35375,37865,2490,6.6
7187,2012,December,Angelina                                             ,Not Adjusted,35189,37696,2507,6.7
7188,2012,March,Aransas                                              ,Not Adjusted,9173,9859,686,7.0
7189,2012,June,Aransas                                              ,Not Adjusted,9250,9985,735,7.4
7190,2012,September,Aransas                                              ,Not Adjusted,9306,9957,651,6.5
7191,2012,December,Aransas                                              ,Not Adjusted,9237,9878,641,6.5
7192,2012,March,Archer                                               ,Not Adjusted,4153,4383,230,5.2
7193,2012,June,Archer                                               ,Not Adjusted,4154,4420,266,6.0
7194,2012,September,Archer                                               ,Not Adjusted,4110,4331,221,5.1
7195,2012,December,Archer                                               ,Not Adjusted,4062,4284,222,5.2
7196,2012,March,Armstrong                                            ,Not Adjusted,972,1018,46,4.5
7197,2012,June,Armstrong                                            ,Not Adjusted,989,1038,49,4.7
7198,2012,September,Armstrong                                            ,Not Adjusted,986,1026,40,3.9
7199,2012,December,Armstrong                                            ,Not Adjusted,972,1013,41,4.0
7200,2012,March,Atascosa                                             ,Not Adjusted,18526,19858,1332,6.7
7201,2012,June,Atascosa                                             ,Not Adjusted,18738,20230,1492,7.4
7202,2012,September,Atascosa                                             ,Not Adjusted,18850,20105,1255,6.2
7203,2012,December,Atascosa                                             ,Not Adjusted,18820,20055,1235,6.2
7204,2012,March,Austin                                               ,Not Adjusted,13025,13901,876,6.3
7205,2012,June,Austin                                               ,Not Adjusted,13182,14168,986,7.0
7206,2012,September,Austin                                               ,Not Adjusted,13317,14153,836,5.9
7207,2012,December,Austin                                               ,Not Adjusted,13326,14160,834,5.9
7208,2012,March,Bailey                                               ,Not Adjusted,2898,3131,233,7.4
7209,2012,June,Bailey                                               ,Not Adjusted,3093,3339,246,7.4
7210,2012,September,Bailey                                               ,Not Adjusted,3022,3213,191,5.9
7211,2012,December,Bailey                                               ,Not Adjusted,2831,3041,210,6.9
7212,2012,March,Bandera                                              ,Not Adjusted,8437,9026,589,6.5
7213,2012,June,Bandera                                              ,Not Adjusted,8531,9174,643,7.0
7214,2012,September,Bandera                                              ,Not Adjusted,8600,9169,569,6.2
7215,2012,December,Bandera                                              ,Not Adjusted,8587,9129,542,5.9
7216,2012,March,Bastrop                                              ,Not Adjusted,32523,34976,2453,7.0
7217,2012,June,Bastrop                                              ,Not Adjusted,32783,35367,2584,7.3
7218,2012,September,Bastrop                                              ,Not Adjusted,33165,35329,2164,6.1
7219,2012,December,Bastrop                                              ,Not Adjusted,33406,35530,2124,6.0
7220,2012,March,Baylor                                               ,Not Adjusted,1842,1930,88,4.6
7221,2012,June,Baylor                                               ,Not Adjusted,1816,1918,102,5.3
7222,2012,September,Baylor                                               ,Not Adjusted,1705,1800,95,5.3
7223,2012,December,Baylor                                               ,Not Adjusted,1610,1704,94,5.5
7224,2012,March,Bee                                                  ,Not Adjusted,10012,10735,723,6.7
7225,2012,June,Bee                                                  ,Not Adjusted,10140,10971,831,7.6
7226,2012,September,Bee                                                  ,Not Adjusted,10124,10827,703,6.5
7227,2012,December,Bee                                                  ,Not Adjusted,10123,10875,752,6.9
7228,2012,March,Bell                                                 ,Not Adjusted,123558,133179,9621,7.2
7229,2012,June,Bell                                                 ,Not Adjusted,123303,134166,10863,8.1
7230,2012,September,Bell                                                 ,Not Adjusted,124873,134282,9409,7.0
7231,2012,December,Bell                                                 ,Not Adjusted,124244,133391,9147,6.9
7232,2012,March,Bexar                                                ,Not Adjusted,780801,832686,51885,6.2
7233,2012,June,Bexar                                                ,Not Adjusted,785282,843432,58150,6.9
7234,2012,September,Bexar                                                ,Not Adjusted,790346,840687,50341,6.0
7235,2012,December,Bexar                                                ,Not Adjusted,794007,842891,48884,5.8
7236,2012,March,Blanco                                               ,Not Adjusted,5084,5355,271,5.1
7237,2012,June,Blanco                                               ,Not Adjusted,5278,5594,316,5.6
7238,2012,September,Blanco                                               ,Not Adjusted,5293,5564,271,4.9
7239,2012,December,Blanco                                               ,Not Adjusted,5200,5459,259,4.7
7240,2012,March,Borden                                               ,Not Adjusted,390,406,16,3.9
7241,2012,June,Borden                                               ,Not Adjusted,416,434,18,4.1
7242,2012,September,Borden                                               ,Not Adjusted,397,415,18,4.3
7243,2012,December,Borden                                               ,Not Adjusted,398,415,17,4.1
7244,2012,March,Bosque                                               ,Not Adjusted,7513,8096,583,7.2
7245,2012,June,Bosque                                               ,Not Adjusted,7657,8299,642,7.7
7246,2012,September,Bosque                                               ,Not Adjusted,7652,8208,556,6.8
7247,2012,December,Bosque                                               ,Not Adjusted,7486,8016,530,6.6
7248,2012,March,Bowie                                                ,Not Adjusted,38680,41725,3045,7.3
7249,2012,June,Bowie                                                ,Not Adjusted,38822,42099,3277,7.8
7250,2012,September,Bowie                                                ,Not Adjusted,38286,41206,2920,7.1
7251,2012,December,Bowie                                                ,Not Adjusted,38108,40940,2832,6.9
7252,2012,March,Brazoria                                             ,Not Adjusted,148863,159575,10712,6.7
7253,2012,June,Brazoria                                             ,Not Adjusted,149813,161365,11552,7.2
7254,2012,September,Brazoria                                             ,Not Adjusted,151436,161468,10032,6.2
7255,2012,December,Brazoria                                             ,Not Adjusted,152485,162294,9809,6.0
7256,2012,March,Brazos                                               ,Not Adjusted,93822,98754,4932,5.0
7257,2012,June,Brazos                                               ,Not Adjusted,93054,99030,5976,6.0
7258,2012,September,Brazos                                               ,Not Adjusted,95714,100714,5000,5.0
7259,2012,December,Brazos                                               ,Not Adjusted,96702,101496,4794,4.7
7260,2012,March,Brewster                                             ,Not Adjusted,4482,4701,219,4.7
7261,2012,June,Brewster                                             ,Not Adjusted,4498,4761,263,5.5
7262,2012,September,Brewster                                             ,Not Adjusted,4186,4399,213,4.8
7263,2012,December,Brewster                                             ,Not Adjusted,3988,4194,206,4.9
7264,2012,March,Briscoe                                              ,Not Adjusted,588,622,34,5.5
7265,2012,June,Briscoe                                              ,Not Adjusted,630,668,38,5.7
7266,2012,September,Briscoe                                              ,Not Adjusted,618,651,33,5.1
7267,2012,December,Briscoe                                              ,Not Adjusted,600,635,35,5.5
7268,2012,March,Brooks                                               ,Not Adjusted,2464,2694,230,8.5
7269,2012,June,Brooks                                               ,Not Adjusted,2463,2730,267,9.8
7270,2012,September,Brooks                                               ,Not Adjusted,2522,2744,222,8.1
7271,2012,December,Brooks                                               ,Not Adjusted,2516,2747,231,8.4
7272,2012,March,Brown                                                ,Not Adjusted,15037,16100,1063,6.6
7273,2012,June,Brown                                                ,Not Adjusted,15051,16246,1195,7.4
7274,2012,September,Brown                                                ,Not Adjusted,15032,16029,997,6.2
7275,2012,December,Brown                                                ,Not Adjusted,14806,15837,1031,6.5
7276,2012,March,Burleson                                             ,Not Adjusted,7112,7580,468,6.2
7277,2012,June,Burleson                                             ,Not Adjusted,7097,7625,528,6.9
7278,2012,September,Burleson                                             ,Not Adjusted,7290,7755,465,6.0
7279,2012,December,Burleson                                             ,Not Adjusted,7321,7791,470,6.0
7280,2012,March,Burnet                                               ,Not Adjusted,18969,20172,1203,6.0
7281,2012,June,Burnet                                               ,Not Adjusted,19327,20641,1314,6.4
7282,2012,September,Burnet                                               ,Not Adjusted,19327,20483,1156,5.6
7283,2012,December,Burnet                                               ,Not Adjusted,19258,20378,1120,5.5
7284,2012,March,Caldwell                                             ,Not Adjusted,15440,16672,1232,7.4
7285,2012,June,Caldwell                                             ,Not Adjusted,15554,16886,1332,7.9
7286,2012,September,Caldwell                                             ,Not Adjusted,15737,16864,1127,6.7
7287,2012,December,Caldwell                                             ,Not Adjusted,15860,16954,1094,6.5
7288,2012,March,Calhoun                                              ,Not Adjusted,9401,10181,780,7.7
7289,2012,June,Calhoun                                              ,Not Adjusted,9612,10442,830,7.9
7290,2012,September,Calhoun                                              ,Not Adjusted,9770,10472,702,6.7
7291,2012,December,Calhoun                                              ,Not Adjusted,10038,10701,663,6.2
7292,2012,March,Callahan                                             ,Not Adjusted,5575,5923,348,5.9
7293,2012,June,Callahan                                             ,Not Adjusted,5514,5913,399,6.7
7294,2012,September,Callahan                                             ,Not Adjusted,5583,5926,343,5.8
7295,2012,December,Callahan                                             ,Not Adjusted,5581,5908,327,5.5
7296,2012,March,Cameron                                              ,Not Adjusted,149123,165797,16674,10.1
7297,2012,June,Cameron                                              ,Not Adjusted,148790,166793,18003,10.8
7298,2012,September,Cameron                                              ,Not Adjusted,148917,165375,16458,10.0
7299,2012,December,Cameron                                              ,Not Adjusted,149845,166652,16807,10.1
7300,2012,March,Camp                                                 ,Not Adjusted,5073,5503,430,7.8
7301,2012,June,Camp                                                 ,Not Adjusted,5110,5587,477,8.5
7302,2012,September,Camp                                                 ,Not Adjusted,5008,5435,427,7.9
7303,2012,December,Camp                                                 ,Not Adjusted,5050,5460,410,7.5
7304,2012,March,Carson                                               ,Not Adjusted,3110,3251,141,4.3
7305,2012,June,Carson                                               ,Not Adjusted,3161,3323,162,4.9
7306,2012,September,Carson                                               ,Not Adjusted,3155,3297,142,4.3
7307,2012,December,Carson                                               ,Not Adjusted,3114,3256,142,4.4
7308,2012,March,Cass                                                 ,Not Adjusted,11665,12824,1159,9.0
7309,2012,June,Cass                                                 ,Not Adjusted,11745,12983,1238,9.5
7310,2012,September,Cass                                                 ,Not Adjusted,11595,12730,1135,8.9
7311,2012,December,Cass                                                 ,Not Adjusted,11465,12574,1109,8.8
7312,2012,March,Castro                                               ,Not Adjusted,3783,3956,173,4.4
7313,2012,June,Castro                                               ,Not Adjusted,3991,4192,201,4.8
7314,2012,September,Castro                                               ,Not Adjusted,3953,4120,167,4.1
7315,2012,December,Castro                                               ,Not Adjusted,3833,3987,154,3.9
7316,2012,March,Chambers                                             ,Not Adjusted,15605,16901,1296,7.7
7317,2012,June,Chambers                                             ,Not Adjusted,15695,17232,1537,8.9
7318,2012,September,Chambers                                             ,Not Adjusted,15875,17169,1294,7.5
7319,2012,December,Chambers                                             ,Not Adjusted,15993,17289,1296,7.5
7320,2012,March,Cherokee                                             ,Not Adjusted,20394,21899,1505,6.9
7321,2012,June,Cherokee                                             ,Not Adjusted,20529,22274,1745,7.8
7322,2012,September,Cherokee                                             ,Not Adjusted,20341,21863,1522,7.0
7323,2012,December,Cherokee                                             ,Not Adjusted,20233,21751,1518,7.0
7324,2012,March,Childress                                            ,Not Adjusted,2857,2985,128,4.3
7325,2012,June,Childress                                            ,Not Adjusted,2878,3020,142,4.7
7326,2012,September,Childress                                            ,Not Adjusted,2788,2909,121,4.2
7327,2012,December,Childress                                            ,Not Adjusted,2776,2892,116,4.0
7328,2012,March,Clay                                                 ,Not Adjusted,5044,5333,289,5.4
7329,2012,June,Clay                                                 ,Not Adjusted,5060,5394,334,6.2
7330,2012,September,Clay                                                 ,Not Adjusted,4998,5285,287,5.4
7331,2012,December,Clay                                                 ,Not Adjusted,4927,5203,276,5.3
7332,2012,March,Cochran                                              ,Not Adjusted,1309,1427,118,8.3
7333,2012,June,Cochran                                              ,Not Adjusted,1415,1527,112,7.3
7334,2012,September,Cochran                                              ,Not Adjusted,1363,1464,101,6.9
7335,2012,December,Cochran                                              ,Not Adjusted,1289,1381,92,6.7
7336,2012,March,Coke                                                 ,Not Adjusted,1421,1486,65,4.4
7337,2012,June,Coke                                                 ,Not Adjusted,1414,1497,83,5.5
7338,2012,September,Coke                                                 ,Not Adjusted,1373,1445,72,5.0
7339,2012,December,Coke                                                 ,Not Adjusted,1349,1421,72,5.1
7340,2012,March,Coleman                                              ,Not Adjusted,3064,3310,246,7.4
7341,2012,June,Coleman                                              ,Not Adjusted,3090,3370,280,8.3
7342,2012,September,Coleman                                              ,Not Adjusted,3139,3376,237,7.0
7343,2012,December,Coleman                                              ,Not Adjusted,3019,3234,215,6.6
7344,2012,March,Collin                                               ,Not Adjusted,417038,442955,25917,5.9
7345,2012,June,Collin                                               ,Not Adjusted,418853,447547,28694,6.4
7346,2012,September,Collin                                               ,Not Adjusted,421808,446891,25083,5.6
7347,2012,December,Collin                                               ,Not Adjusted,423865,448228,24363,5.4
7348,2012,March,Collingsworth                                        ,Not Adjusted,1180,1238,58,4.7
7349,2012,June,Collingsworth                                        ,Not Adjusted,1217,1286,69,5.4
7350,2012,September,Collingsworth                                        ,Not Adjusted,1190,1250,60,4.8
7351,2012,December,Collingsworth                                        ,Not Adjusted,1152,1209,57,4.7
7352,2012,March,Colorado                                             ,Not Adjusted,9382,10018,636,6.3
7353,2012,June,Colorado                                             ,Not Adjusted,9818,10505,687,6.5
7354,2012,September,Colorado                                             ,Not Adjusted,9602,10240,638,6.2
7355,2012,December,Colorado                                             ,Not Adjusted,9406,9989,583,5.8
7356,2012,March,Comal                                                ,Not Adjusted,52058,55349,3291,5.9
7357,2012,June,Comal                                                ,Not Adjusted,52383,56073,3690,6.6
7358,2012,September,Comal                                                ,Not Adjusted,52837,56038,3201,5.7
7359,2012,December,Comal                                                ,Not Adjusted,53030,56184,3154,5.6
7360,2012,March,Comanche                                             ,Not Adjusted,5342,5717,375,6.6
7361,2012,June,Comanche                                             ,Not Adjusted,5467,5881,414,7.0
7362,2012,September,Comanche                                             ,Not Adjusted,5474,5804,330,5.7
7363,2012,December,Comanche                                             ,Not Adjusted,5384,5719,335,5.9
7364,2012,March,Concho                                               ,Not Adjusted,1402,1462,60,4.1
7365,2012,June,Concho                                               ,Not Adjusted,1507,1581,74,4.7
7366,2012,September,Concho                                               ,Not Adjusted,1469,1529,60,3.9
7367,2012,December,Concho                                               ,Not Adjusted,1408,1461,53,3.6
7368,2012,March,Cooke                                                ,Not Adjusted,19631,20669,1038,5.0
7369,2012,June,Cooke                                                ,Not Adjusted,19672,20803,1131,5.4
7370,2012,September,Cooke                                                ,Not Adjusted,19576,20567,991,4.8
7371,2012,December,Cooke                                                ,Not Adjusted,19586,20549,963,4.7
7372,2012,March,Coryell                                              ,Not Adjusted,23401,25151,1750,7.0
7373,2012,June,Coryell                                              ,Not Adjusted,23369,25410,2041,8.0
7374,2012,September,Coryell                                              ,Not Adjusted,23664,25498,1834,7.2
7375,2012,December,Coryell                                              ,Not Adjusted,23532,25294,1762,7.0
7376,2012,March,Cottle                                               ,Not Adjusted,606,658,52,7.9
7377,2012,June,Cottle                                               ,Not Adjusted,662,714,52,7.3
7378,2012,September,Cottle                                               ,Not Adjusted,634,679,45,6.6
7379,2012,December,Cottle                                               ,Not Adjusted,570,614,44,7.2
7380,2012,March,Crane                                                ,Not Adjusted,1922,2020,98,4.9
7381,2012,June,Crane                                                ,Not Adjusted,1971,2092,121,5.8
7382,2012,September,Crane                                                ,Not Adjusted,2014,2108,94,4.5
7383,2012,December,Crane                                                ,Not Adjusted,1962,2046,84,4.1
7384,2012,March,Crockett                                             ,Not Adjusted,1601,1686,85,5.0
7385,2012,June,Crockett                                             ,Not Adjusted,1723,1824,101,5.5
7386,2012,September,Crockett                                             ,Not Adjusted,1711,1794,83,4.6
7387,2012,December,Crockett                                             ,Not Adjusted,1762,1846,84,4.6
7388,2012,March,Crosby                                               ,Not Adjusted,2650,2867,217,7.6
7389,2012,June,Crosby                                               ,Not Adjusted,2757,2991,234,7.8
7390,2012,September,Crosby                                               ,Not Adjusted,2739,2930,191,6.5
7391,2012,December,Crosby                                               ,Not Adjusted,2654,2823,169,6.0
7392,2012,March,Culberson                                            ,Not Adjusted,932,991,59,6.0
7393,2012,June,Culberson                                            ,Not Adjusted,957,1026,69,6.7
7394,2012,September,Culberson                                            ,Not Adjusted,915,968,53,5.5
7395,2012,December,Culberson                                            ,Not Adjusted,930,980,50,5.1
7396,2012,March,Dallam                                               ,Not Adjusted,3830,3975,145,3.6
7397,2012,June,Dallam                                               ,Not Adjusted,4013,4180,167,4.0
7398,2012,September,Dallam                                               ,Not Adjusted,3880,4019,139,3.5
7399,2012,December,Dallam                                               ,Not Adjusted,3771,3900,129,3.3
7400,2012,March,Dallas                                               ,Not Adjusted,1126933,1213238,86305,7.1
7401,2012,June,Dallas                                               ,Not Adjusted,1131596,1224548,92952,7.6
7402,2012,September,Dallas                                               ,Not Adjusted,1140381,1223165,82784,6.8
7403,2012,December,Dallas                                               ,Not Adjusted,1146062,1226412,80350,6.6
7404,2012,March,Dawson                                               ,Not Adjusted,4700,5031,331,6.6
7405,2012,June,Dawson                                               ,Not Adjusted,4806,5165,359,7.0
7406,2012,September,Dawson                                               ,Not Adjusted,4756,5060,304,6.0
7407,2012,December,Dawson                                               ,Not Adjusted,4829,5117,288,5.6
7408,2012,March,Deaf Smith                                           ,Not Adjusted,8701,9123,422,4.6
7409,2012,June,Deaf Smith                                           ,Not Adjusted,9140,9620,480,5.0
7410,2012,September,Deaf Smith                                           ,Not Adjusted,9073,9477,404,4.3
7411,2012,December,Deaf Smith                                           ,Not Adjusted,8690,9095,405,4.5
7412,2012,March,Delta                                                ,Not Adjusted,2426,2599,173,6.7
7413,2012,June,Delta                                                ,Not Adjusted,2453,2643,190,7.2
7414,2012,September,Delta                                                ,Not Adjusted,2504,2675,171,6.4
7415,2012,December,Delta                                                ,Not Adjusted,2487,2650,163,6.2
7416,2012,March,Denton                                               ,Not Adjusted,363472,385371,21899,5.7
7417,2012,June,Denton                                               ,Not Adjusted,365060,389212,24152,6.2
7418,2012,September,Denton                                               ,Not Adjusted,367429,388544,21115,5.4
7419,2012,December,Denton                                               ,Not Adjusted,369250,389765,20515,5.3
7420,2012,March,DeWitt                                               ,Not Adjusted,9154,9611,457,4.8
7421,2012,June,DeWitt                                               ,Not Adjusted,9354,9875,521,5.3
7422,2012,September,DeWitt                                               ,Not Adjusted,9345,9778,433,4.4
7423,2012,December,DeWitt                                               ,Not Adjusted,9275,9699,424,4.4
7424,2012,March,Dickens                                              ,Not Adjusted,735,829,94,11.3
7425,2012,June,Dickens                                              ,Not Adjusted,767,861,94,10.9
7426,2012,September,Dickens                                              ,Not Adjusted,731,813,82,10.1
7427,2012,December,Dickens                                              ,Not Adjusted,719,797,78,9.8
7428,2012,March,Dimmit                                               ,Not Adjusted,5339,5665,326,5.8
7429,2012,June,Dimmit                                               ,Not Adjusted,5495,5866,371,6.3
7430,2012,September,Dimmit                                               ,Not Adjusted,5527,5834,307,5.3
7431,2012,December,Dimmit                                               ,Not Adjusted,5594,5933,339,5.7
7432,2012,March,Donley                                               ,Not Adjusted,1608,1700,92,5.4
7433,2012,June,Donley                                               ,Not Adjusted,1603,1723,120,7.0
7434,2012,September,Donley                                               ,Not Adjusted,1587,1681,94,5.6
7435,2012,December,Donley                                               ,Not Adjusted,1609,1705,96,5.6
7436,2012,March,Duval                                                ,Not Adjusted,4924,5309,385,7.3
7437,2012,June,Duval                                                ,Not Adjusted,5138,5555,417,7.5
7438,2012,September,Duval                                                ,Not Adjusted,5184,5541,357,6.4
7439,2012,December,Duval                                                ,Not Adjusted,5081,5442,361,6.6
7440,2012,March,Eastland                                             ,Not Adjusted,7759,8296,537,6.5
7441,2012,June,Eastland                                             ,Not Adjusted,7772,8404,632,7.5
7442,2012,September,Eastland                                             ,Not Adjusted,7731,8234,503,6.1
7443,2012,December,Eastland                                             ,Not Adjusted,7666,8168,502,6.1
7444,2012,March,Ector                                                ,Not Adjusted,72280,75719,3439,4.5
7445,2012,June,Ector                                                ,Not Adjusted,72832,76774,3942,5.1
7446,2012,September,Ector                                                ,Not Adjusted,74920,78244,3324,4.2
7447,2012,December,Ector                                                ,Not Adjusted,74359,77548,3189,4.1
7448,2012,March,Edwards                                              ,Not Adjusted,869,921,52,5.6
7449,2012,June,Edwards                                              ,Not Adjusted,904,966,62,6.4
7450,2012,September,Edwards                                              ,Not Adjusted,864,926,62,6.7
7451,2012,December,Edwards                                              ,Not Adjusted,827,888,61,6.9
7452,2012,March,Ellis                                                ,Not Adjusted,70991,76169,5178,6.8
7453,2012,June,Ellis                                                ,Not Adjusted,71362,76998,5636,7.3
7454,2012,September,Ellis                                                ,Not Adjusted,71891,76743,4852,6.3
7455,2012,December,Ellis                                                ,Not Adjusted,72170,77008,4838,6.3
7456,2012,March,El Paso                                              ,Not Adjusted,316977,346171,29194,8.4
7457,2012,June,El Paso                                              ,Not Adjusted,314417,346433,32016,9.2
7458,2012,September,El Paso                                              ,Not Adjusted,318289,346551,28262,8.2
7459,2012,December,El Paso                                              ,Not Adjusted,319557,347402,27845,8.0
7460,2012,March,Erath                                                ,Not Adjusted,18966,20010,1044,5.2
7461,2012,June,Erath                                                ,Not Adjusted,19212,20471,1259,6.2
7462,2012,September,Erath                                                ,Not Adjusted,19073,20116,1043,5.2
7463,2012,December,Erath                                                ,Not Adjusted,18437,19492,1055,5.4
7464,2012,March,Falls                                                ,Not Adjusted,6373,6867,494,7.2
7465,2012,June,Falls                                                ,Not Adjusted,6436,6975,539,7.7
7466,2012,September,Falls                                                ,Not Adjusted,6456,6940,484,7.0
7467,2012,December,Falls                                                ,Not Adjusted,6359,6833,474,6.9
7468,2012,March,Fannin                                               ,Not Adjusted,13859,14905,1046,7.0
7469,2012,June,Fannin                                               ,Not Adjusted,14039,15162,1123,7.4
7470,2012,September,Fannin                                               ,Not Adjusted,14055,15043,988,6.6
7471,2012,December,Fannin                                               ,Not Adjusted,14057,15171,1114,7.3
7472,2012,March,Fayette                                              ,Not Adjusted,11692,12275,583,4.7
7473,2012,June,Fayette                                              ,Not Adjusted,12045,12707,662,5.2
7474,2012,September,Fayette                                              ,Not Adjusted,12032,12603,571,4.5
7475,2012,December,Fayette                                              ,Not Adjusted,11986,12548,562,4.5
7476,2012,March,Fisher                                               ,Not Adjusted,1784,1880,96,5.1
7477,2012,June,Fisher                                               ,Not Adjusted,1835,1950,115,5.9
7478,2012,September,Fisher                                               ,Not Adjusted,1813,1914,101,5.3
7479,2012,December,Fisher                                               ,Not Adjusted,1785,1877,92,4.9
7480,2012,March,Floyd                                                ,Not Adjusted,2954,3161,207,6.5
7481,2012,June,Floyd                                                ,Not Adjusted,3093,3317,224,6.8
7482,2012,September,Floyd                                                ,Not Adjusted,2986,3172,186,5.9
7483,2012,December,Floyd                                                ,Not Adjusted,2876,3071,195,6.3
7484,2012,March,Foard                                                ,Not Adjusted,585,622,37,5.9
7485,2012,June,Foard                                                ,Not Adjusted,592,631,39,6.2
7486,2012,September,Foard                                                ,Not Adjusted,586,619,33,5.3
7487,2012,December,Foard                                                ,Not Adjusted,568,600,32,5.3
7488,2012,March,Fort Bend                                            ,Not Adjusted,296896,315358,18462,5.9
7489,2012,June,Fort Bend                                            ,Not Adjusted,298643,319326,20683,6.5
7490,2012,September,Fort Bend                                            ,Not Adjusted,302204,320274,18070,5.6
7491,2012,December,Fort Bend                                            ,Not Adjusted,304387,321942,17555,5.5
7492,2012,March,Franklin                                             ,Not Adjusted,4303,4643,340,7.3
7493,2012,June,Franklin                                             ,Not Adjusted,4322,4686,364,7.8
7494,2012,September,Franklin                                             ,Not Adjusted,4299,4616,317,6.9
7495,2012,December,Franklin                                             ,Not Adjusted,4264,4601,337,7.3
7496,2012,March,Freestone                                            ,Not Adjusted,7379,7895,516,6.5
7497,2012,June,Freestone                                            ,Not Adjusted,7640,8220,580,7.1
7498,2012,September,Freestone                                            ,Not Adjusted,7629,8157,528,6.5
7499,2012,December,Freestone                                            ,Not Adjusted,7411,7957,546,6.9
7500,2012,March,Frio                                                 ,Not Adjusted,8174,8596,422,4.9
7501,2012,June,Frio                                                 ,Not Adjusted,8292,8775,483,5.5
7502,2012,September,Frio                                                 ,Not Adjusted,8182,8585,403,4.7
7503,2012,December,Frio                                                 ,Not Adjusted,8240,8652,412,4.8
7504,2012,March,Gaines                                               ,Not Adjusted,8194,8553,359,4.2
7505,2012,June,Gaines                                               ,Not Adjusted,8606,9030,424,4.7
7506,2012,September,Gaines                                               ,Not Adjusted,8569,8917,348,3.9
7507,2012,December,Gaines                                               ,Not Adjusted,8508,8845,337,3.8
7508,2012,March,Galveston                                            ,Not Adjusted,139907,151343,11436,7.6
7509,2012,June,Galveston                                            ,Not Adjusted,140830,153489,12659,8.2
7510,2012,September,Galveston                                            ,Not Adjusted,142461,153627,11166,7.3
7511,2012,December,Galveston                                            ,Not Adjusted,143387,154396,11009,7.1
7512,2012,March,Garza                                                ,Not Adjusted,2060,2169,109,5.0
7513,2012,June,Garza                                                ,Not Adjusted,2088,2206,118,5.3
7514,2012,September,Garza                                                ,Not Adjusted,2082,2178,96,4.4
7515,2012,December,Garza                                                ,Not Adjusted,2099,2196,97,4.4
7516,2012,March,Gillespie                                            ,Not Adjusted,11734,12287,553,4.5
7517,2012,June,Gillespie                                            ,Not Adjusted,11841,12479,638,5.1
7518,2012,September,Gillespie                                            ,Not Adjusted,11760,12314,554,4.5
7519,2012,December,Gillespie                                            ,Not Adjusted,11808,12333,525,4.3
7520,2012,March,Glasscock                                            ,Not Adjusted,704,734,30,4.1
7521,2012,June,Glasscock                                            ,Not Adjusted,782,817,35,4.3
7522,2012,September,Glasscock                                            ,Not Adjusted,749,777,28,3.6
7523,2012,December,Glasscock                                            ,Not Adjusted,699,724,25,3.5
7524,2012,March,Goliad                                               ,Not Adjusted,3244,3425,181,5.3
7525,2012,June,Goliad                                               ,Not Adjusted,3287,3496,209,6.0
7526,2012,September,Goliad                                               ,Not Adjusted,3336,3518,182,5.2
7527,2012,December,Goliad                                               ,Not Adjusted,3325,3511,186,5.3
7528,2012,March,Gonzales                                             ,Not Adjusted,8835,9309,474,5.1
7529,2012,June,Gonzales                                             ,Not Adjusted,9231,9769,538,5.5
7530,2012,September,Gonzales                                             ,Not Adjusted,9033,9486,453,4.8
7531,2012,December,Gonzales                                             ,Not Adjusted,8829,9269,440,4.7
7532,2012,March,Gray                                                 ,Not Adjusted,9106,9634,528,5.5
7533,2012,June,Gray                                                 ,Not Adjusted,9254,9856,602,6.1
7534,2012,September,Gray                                                 ,Not Adjusted,9174,9699,525,5.4
7535,2012,December,Gray                                                 ,Not Adjusted,9191,9676,485,5.0
7536,2012,March,Grayson                                              ,Not Adjusted,55344,59444,4100,6.9
7537,2012,June,Grayson                                              ,Not Adjusted,56156,60540,4384,7.2
7538,2012,September,Grayson                                              ,Not Adjusted,55941,59750,3809,6.4
7539,2012,December,Grayson                                              ,Not Adjusted,56411,60393,3982,6.6
7540,2012,March,Gregg                                                ,Not Adjusted,58253,61874,3621,5.9
7541,2012,June,Gregg                                                ,Not Adjusted,57522,61658,4136,6.7
7542,2012,September,Gregg                                                ,Not Adjusted,57497,61228,3731,6.1
7543,2012,December,Gregg                                                ,Not Adjusted,57311,60961,3650,6.0
7544,2012,March,Grimes                                               ,Not Adjusted,10848,11604,756,6.5
7545,2012,June,Grimes                                               ,Not Adjusted,11143,11980,837,7.0
7546,2012,September,Grimes                                               ,Not Adjusted,11133,11861,728,6.1
7547,2012,December,Grimes                                               ,Not Adjusted,11144,11839,695,5.9
7548,2012,March,Guadalupe                                            ,Not Adjusted,63909,67601,3692,5.5
7549,2012,June,Guadalupe                                            ,Not Adjusted,64338,68561,4223,6.2
7550,2012,September,Guadalupe                                            ,Not Adjusted,64676,68375,3699,5.4
7551,2012,December,Guadalupe                                            ,Not Adjusted,64922,68566,3644,5.3
7552,2012,March,Hale                                                 ,Not Adjusted,14627,15762,1135,7.2
7553,2012,June,Hale                                                 ,Not Adjusted,14848,16140,1292,8.0
7554,2012,September,Hale                                                 ,Not Adjusted,14891,15861,970,6.1
7555,2012,December,Hale                                                 ,Not Adjusted,14301,15300,999,6.5
7556,2012,March,Hall                                                 ,Not Adjusted,1231,1337,106,7.9
7557,2012,June,Hall                                                 ,Not Adjusted,1264,1379,115,8.3
7558,2012,September,Hall                                                 ,Not Adjusted,1249,1345,96,7.1
7559,2012,December,Hall                                                 ,Not Adjusted,1225,1319,94,7.1
7560,2012,March,Hamilton                                             ,Not Adjusted,3588,3795,207,5.5
7561,2012,June,Hamilton                                             ,Not Adjusted,3571,3809,238,6.2
7562,2012,September,Hamilton                                             ,Not Adjusted,3491,3691,200,5.4
7563,2012,December,Hamilton                                             ,Not Adjusted,3413,3627,214,5.9
7564,2012,March,Hansford                                             ,Not Adjusted,2903,2999,96,3.2
7565,2012,June,Hansford                                             ,Not Adjusted,3028,3148,120,3.8
7566,2012,September,Hansford                                             ,Not Adjusted,2966,3062,96,3.1
7567,2012,December,Hansford                                             ,Not Adjusted,2909,3009,100,3.3
7568,2012,March,Hardeman                                             ,Not Adjusted,1662,1765,103,5.8
7569,2012,June,Hardeman                                             ,Not Adjusted,1667,1777,110,6.2
7570,2012,September,Hardeman                                             ,Not Adjusted,1678,1776,98,5.5
7571,2012,December,Hardeman                                             ,Not Adjusted,1619,1716,97,5.7
7572,2012,March,Hardin                                               ,Not Adjusted,23974,26046,2072,8.0
7573,2012,June,Hardin                                               ,Not Adjusted,23688,26090,2402,9.2
7574,2012,September,Hardin                                               ,Not Adjusted,23418,25524,2106,8.3
7575,2012,December,Hardin                                               ,Not Adjusted,23240,25399,2159,8.5
7576,2012,March,Harris                                               ,Not Adjusted,1991789,2132171,140382,6.6
7577,2012,June,Harris                                               ,Not Adjusted,2003415,2158341,154926,7.2
7578,2012,September,Harris                                               ,Not Adjusted,2028731,2164124,135393,6.3
7579,2012,December,Harris                                               ,Not Adjusted,2043132,2175738,132606,6.1
7580,2012,March,Harrison                                             ,Not Adjusted,29426,31698,2272,7.2
7581,2012,June,Harrison                                             ,Not Adjusted,29537,32079,2542,7.9
7582,2012,September,Harrison                                             ,Not Adjusted,29500,31809,2309,7.3
7583,2012,December,Harrison                                             ,Not Adjusted,29629,31893,2264,7.1
7584,2012,March,Hartley                                              ,Not Adjusted,2738,2828,90,3.2
7585,2012,June,Hartley                                              ,Not Adjusted,2860,2975,115,3.9
7586,2012,September,Hartley                                              ,Not Adjusted,2840,2932,92,3.1
7587,2012,December,Hartley                                              ,Not Adjusted,2830,2919,89,3.0
7588,2012,March,Haskell                                              ,Not Adjusted,2620,2773,153,5.5
7589,2012,June,Haskell                                              ,Not Adjusted,2663,2825,162,5.7
7590,2012,September,Haskell                                              ,Not Adjusted,2620,2755,135,4.9
7591,2012,December,Haskell                                              ,Not Adjusted,2585,2712,127,4.7
7592,2012,March,Hays                                                 ,Not Adjusted,79838,84677,4839,5.7
7593,2012,June,Hays                                                 ,Not Adjusted,80279,85839,5560,6.5
7594,2012,September,Hays                                                 ,Not Adjusted,81261,86009,4748,5.5
7595,2012,December,Hays                                                 ,Not Adjusted,82072,86606,4534,5.2
7596,2012,March,Hemphill                                             ,Not Adjusted,2464,2529,65,2.6
7597,2012,June,Hemphill                                             ,Not Adjusted,2549,2635,86,3.3
7598,2012,September,Hemphill                                             ,Not Adjusted,2479,2551,72,2.8
7599,2012,December,Hemphill                                             ,Not Adjusted,2395,2467,72,2.9
7600,2012,March,Henderson                                            ,Not Adjusted,31781,34350,2569,7.5
7601,2012,June,Henderson                                            ,Not Adjusted,32077,34892,2815,8.1
7602,2012,September,Henderson                                            ,Not Adjusted,31935,34389,2454,7.1
7603,2012,December,Henderson                                            ,Not Adjusted,31842,34310,2468,7.2
7604,2012,March,Hidalgo                                              ,Not Adjusted,293636,326664,33028,10.1
7605,2012,June,Hidalgo                                              ,Not Adjusted,291381,329001,37620,11.4
7606,2012,September,Hidalgo                                              ,Not Adjusted,292298,325670,33372,10.2
7607,2012,December,Hidalgo                                              ,Not Adjusted,297504,332222,34718,10.5
7608,2012,March,Hill                                                 ,Not Adjusted,14545,15637,1092,7.0
7609,2012,June,Hill                                                 ,Not Adjusted,14604,15818,1214,7.7
7610,2012,September,Hill                                                 ,Not Adjusted,14855,15848,993,6.3
7611,2012,December,Hill                                                 ,Not Adjusted,14868,15857,989,6.2
7612,2012,March,Hockley                                              ,Not Adjusted,10948,11596,648,5.6
7613,2012,June,Hockley                                              ,Not Adjusted,11344,12034,690,5.7
7614,2012,September,Hockley                                              ,Not Adjusted,11255,11839,584,4.9
7615,2012,December,Hockley                                              ,Not Adjusted,11211,11781,570,4.8
7616,2012,March,Hood                                                 ,Not Adjusted,21998,23508,1510,6.4
7617,2012,June,Hood                                                 ,Not Adjusted,22223,23880,1657,6.9
7618,2012,September,Hood                                                 ,Not Adjusted,22374,23835,1461,6.1
7619,2012,December,Hood                                                 ,Not Adjusted,22454,23898,1444,6.0
7620,2012,March,Hopkins                                              ,Not Adjusted,15711,16770,1059,6.3
7621,2012,June,Hopkins                                              ,Not Adjusted,16026,17260,1234,7.1
7622,2012,September,Hopkins                                              ,Not Adjusted,16302,17366,1064,6.1
7623,2012,December,Hopkins                                              ,Not Adjusted,16070,17074,1004,5.9
7624,2012,March,Houston                                              ,Not Adjusted,9352,10085,733,7.3
7625,2012,June,Houston                                              ,Not Adjusted,9465,10231,766,7.5
7626,2012,September,Houston                                              ,Not Adjusted,9318,9975,657,6.6
7627,2012,December,Houston                                              ,Not Adjusted,9117,9743,626,6.4
7628,2012,March,Howard                                               ,Not Adjusted,12469,13197,728,5.5
7629,2012,June,Howard                                               ,Not Adjusted,12524,13384,860,6.4
7630,2012,September,Howard                                               ,Not Adjusted,12712,13413,701,5.2
7631,2012,December,Howard                                               ,Not Adjusted,12778,13453,675,5.0
7632,2012,March,Hudspeth                                             ,Not Adjusted,1213,1309,96,7.3
7633,2012,June,Hudspeth                                             ,Not Adjusted,1241,1352,111,8.2
7634,2012,September,Hudspeth                                             ,Not Adjusted,1240,1334,94,7.0
7635,2012,December,Hudspeth                                             ,Not Adjusted,1210,1299,89,6.9
7636,2012,March,Hunt                                                 ,Not Adjusted,34931,37930,2999,7.9
7637,2012,June,Hunt                                                 ,Not Adjusted,35144,38686,3542,9.2
7638,2012,September,Hunt                                                 ,Not Adjusted,35406,38511,3105,8.1
7639,2012,December,Hunt                                                 ,Not Adjusted,35509,38412,2903,7.6
7640,2012,March,Hutchinson                                           ,Not Adjusted,9199,9824,625,6.4
7641,2012,June,Hutchinson                                           ,Not Adjusted,9212,9918,706,7.1
7642,2012,September,Hutchinson                                           ,Not Adjusted,9124,9727,603,6.2
7643,2012,December,Hutchinson                                           ,Not Adjusted,9144,9744,600,6.2
7644,2012,March,Irion                                                ,Not Adjusted,799,837,38,4.5
7645,2012,June,Irion                                                ,Not Adjusted,820,864,44,5.1
7646,2012,September,Irion                                                ,Not Adjusted,829,865,36,4.2
7647,2012,December,Irion                                                ,Not Adjusted,811,844,33,3.9
7648,2012,March,Jack                                                 ,Not Adjusted,3563,3774,211,5.6
7649,2012,June,Jack                                                 ,Not Adjusted,3554,3788,234,6.2
7650,2012,September,Jack                                                 ,Not Adjusted,3602,3811,209,5.5
7651,2012,December,Jack                                                 ,Not Adjusted,3628,3842,214,5.6
7652,2012,March,Jackson                                              ,Not Adjusted,7052,7425,373,5.0
7653,2012,June,Jackson                                              ,Not Adjusted,7177,7604,427,5.6
7654,2012,September,Jackson                                              ,Not Adjusted,7000,7353,353,4.8
7655,2012,December,Jackson                                              ,Not Adjusted,6874,7218,344,4.8
7656,2012,March,Jasper                                               ,Not Adjusted,13313,14836,1523,10.3
7657,2012,June,Jasper                                               ,Not Adjusted,13397,15109,1712,11.3
7658,2012,September,Jasper                                               ,Not Adjusted,13391,14903,1512,10.1
7659,2012,December,Jasper                                               ,Not Adjusted,13084,14652,1568,10.7
7660,2012,March,Jeff Davis                                           ,Not Adjusted,1143,1202,59,4.9
7661,2012,June,Jeff Davis                                           ,Not Adjusted,1207,1271,64,5.0
7662,2012,September,Jeff Davis                                           ,Not Adjusted,1160,1216,56,4.6
7663,2012,December,Jeff Davis                                           ,Not Adjusted,1124,1176,52,4.4
7664,2012,March,Jefferson                                            ,Not Adjusted,102185,113772,11587,10.2
7665,2012,June,Jefferson                                            ,Not Adjusted,101007,114806,13799,12.0
7666,2012,September,Jefferson                                            ,Not Adjusted,99906,112162,12256,10.9
7667,2012,December,Jefferson                                            ,Not Adjusted,99121,111880,12759,11.4
7668,2012,March,Jim Hogg                                             ,Not Adjusted,2156,2307,151,6.5
7669,2012,June,Jim Hogg                                             ,Not Adjusted,2173,2335,162,6.9
7670,2012,September,Jim Hogg                                             ,Not Adjusted,2251,2395,144,6.0
7671,2012,December,Jim Hogg                                             ,Not Adjusted,2179,2332,153,6.6
7672,2012,March,Jim Wells                                            ,Not Adjusted,19443,20669,1226,5.9
7673,2012,June,Jim Wells                                            ,Not Adjusted,19589,20998,1409,6.7
7674,2012,September,Jim Wells                                            ,Not Adjusted,19273,20462,1189,5.8
7675,2012,December,Jim Wells                                            ,Not Adjusted,19099,20293,1194,5.9
7676,2012,March,Johnson                                              ,Not Adjusted,67692,72560,4868,6.7
7677,2012,June,Johnson                                              ,Not Adjusted,68235,73570,5335,7.3
7678,2012,September,Johnson                                              ,Not Adjusted,68550,73119,4569,6.2
7679,2012,December,Johnson                                              ,Not Adjusted,69005,73426,4421,6.0
7680,2012,March,Jones                                                ,Not Adjusted,5475,5912,437,7.4
7681,2012,June,Jones                                                ,Not Adjusted,5466,5933,467,7.9
7682,2012,September,Jones                                                ,Not Adjusted,5490,5880,390,6.6
7683,2012,December,Jones                                                ,Not Adjusted,5441,5816,375,6.4
7684,2012,March,Karnes                                               ,Not Adjusted,4722,5034,312,6.2
7685,2012,June,Karnes                                               ,Not Adjusted,4895,5268,373,7.1
7686,2012,September,Karnes                                               ,Not Adjusted,5138,5446,308,5.7
7687,2012,December,Karnes                                               ,Not Adjusted,5180,5466,286,5.2
7688,2012,March,Kaufman                                              ,Not Adjusted,47657,51237,3580,7.0
7689,2012,June,Kaufman                                              ,Not Adjusted,47884,51816,3932,7.6
7690,2012,September,Kaufman                                              ,Not Adjusted,48179,51549,3370,6.5
7691,2012,December,Kaufman                                              ,Not Adjusted,48401,51691,3290,6.4
7692,2012,March,Kendall                                              ,Not Adjusted,16344,17262,918,5.3
7693,2012,June,Kendall                                              ,Not Adjusted,16545,17582,1037,5.9
7694,2012,September,Kendall                                              ,Not Adjusted,16677,17588,911,5.2
7695,2012,December,Kendall                                              ,Not Adjusted,16630,17497,867,5.0
7696,2012,March,Kenedy                                               ,Not Adjusted,221,233,12,5.2
7697,2012,June,Kenedy                                               ,Not Adjusted,240,253,13,5.1
7698,2012,September,Kenedy                                               ,Not Adjusted,256,270,14,5.2
7699,2012,December,Kenedy                                               ,Not Adjusted,264,276,12,4.3
7700,2012,March,Kent                                                 ,Not Adjusted,519,540,21,3.9
7701,2012,June,Kent                                                 ,Not Adjusted,540,564,24,4.3
7702,2012,September,Kent                                                 ,Not Adjusted,543,562,19,3.4
7703,2012,December,Kent                                                 ,Not Adjusted,514,534,20,3.7
7704,2012,March,Kerr                                                 ,Not Adjusted,20217,21439,1222,5.7
7705,2012,June,Kerr                                                 ,Not Adjusted,20721,22103,1382,6.3
7706,2012,September,Kerr                                                 ,Not Adjusted,20347,21546,1199,5.6
7707,2012,December,Kerr                                                 ,Not Adjusted,20262,21423,1161,5.4
7708,2012,March,Kimble                                               ,Not Adjusted,2033,2138,105,4.9
7709,2012,June,Kimble                                               ,Not Adjusted,2152,2267,115,5.1
7710,2012,September,Kimble                                               ,Not Adjusted,2075,2179,104,4.8
7711,2012,December,Kimble                                               ,Not Adjusted,2068,2166,98,4.5
7712,2012,March,King                                                 ,Not Adjusted,231,243,12,4.9
7713,2012,June,King                                                 ,Not Adjusted,256,267,11,4.1
7714,2012,September,King                                                 ,Not Adjusted,246,255,9,3.5
7715,2012,December,King                                                 ,Not Adjusted,217,226,9,4.0
7716,2012,March,Kinney                                               ,Not Adjusted,1105,1227,122,9.9
7717,2012,June,Kinney                                               ,Not Adjusted,1162,1277,115,9.0
7718,2012,September,Kinney                                               ,Not Adjusted,1198,1298,100,7.7
7719,2012,December,Kinney                                               ,Not Adjusted,1131,1232,101,8.2
7720,2012,March,Kleberg                                              ,Not Adjusted,14491,15522,1031,6.6
7721,2012,June,Kleberg                                              ,Not Adjusted,14207,15397,1190,7.7
7722,2012,September,Kleberg                                              ,Not Adjusted,14242,15221,979,6.4
7723,2012,December,Kleberg                                              ,Not Adjusted,14344,15314,970,6.3
7724,2012,March,Knox                                                 ,Not Adjusted,1719,1811,92,5.1
7725,2012,June,Knox                                                 ,Not Adjusted,1739,1841,102,5.5
7726,2012,September,Knox                                                 ,Not Adjusted,1727,1817,90,5.0
7727,2012,December,Knox                                                 ,Not Adjusted,1681,1767,86,4.9
7728,2012,March,Lamar                                                ,Not Adjusted,20547,22653,2106,9.3
7729,2012,June,Lamar                                                ,Not Adjusted,20727,22890,2163,9.4
7730,2012,September,Lamar                                                ,Not Adjusted,20638,22654,2016,8.9
7731,2012,December,Lamar                                                ,Not Adjusted,20234,22178,1944,8.8
7732,2012,March,Lamb                                                 ,Not Adjusted,5854,6777,923,13.6
7733,2012,June,Lamb                                                 ,Not Adjusted,6044,6514,470,7.2
7734,2012,September,Lamb                                                 ,Not Adjusted,5997,6400,403,6.3
7735,2012,December,Lamb                                                 ,Not Adjusted,5754,6148,394,6.4
7736,2012,March,Lampasas                                             ,Not Adjusted,8384,9006,622,6.9
7737,2012,June,Lampasas                                             ,Not Adjusted,8404,9120,716,7.9
7738,2012,September,Lampasas                                             ,Not Adjusted,8513,9127,614,6.7
7739,2012,December,Lampasas                                             ,Not Adjusted,8438,9061,623,6.9
7740,2012,March,La Salle                                             ,Not Adjusted,3322,3487,165,4.7
7741,2012,June,La Salle                                             ,Not Adjusted,3547,3722,175,4.7
7742,2012,September,La Salle                                             ,Not Adjusted,3663,3809,146,3.8
7743,2012,December,La Salle                                             ,Not Adjusted,3700,3859,159,4.1
7744,2012,March,Lavaca                                               ,Not Adjusted,9058,9497,439,4.6
7745,2012,June,Lavaca                                               ,Not Adjusted,9180,9684,504,5.2
7746,2012,September,Lavaca                                               ,Not Adjusted,8905,9348,443,4.7
7747,2012,December,Lavaca                                               ,Not Adjusted,8827,9237,410,4.4
7748,2012,March,Lee                                                  ,Not Adjusted,8416,8895,479,5.4
7749,2012,June,Lee                                                  ,Not Adjusted,8675,9224,549,6.0
7750,2012,September,Lee                                                  ,Not Adjusted,9082,9544,462,4.8
7751,2012,December,Lee                                                  ,Not Adjusted,8798,9236,438,4.7
7752,2012,March,Leon                                                 ,Not Adjusted,6315,6822,507,7.4
7753,2012,June,Leon                                                 ,Not Adjusted,6496,7050,554,7.9
7754,2012,September,Leon                                                 ,Not Adjusted,6490,6976,486,7.0
7755,2012,December,Leon                                                 ,Not Adjusted,6517,7006,489,7.0
7756,2012,March,Liberty                                              ,Not Adjusted,27602,30475,2873,9.4
7757,2012,June,Liberty                                              ,Not Adjusted,27835,31076,3241,10.4
7758,2012,September,Liberty                                              ,Not Adjusted,28146,30958,2812,9.1
7759,2012,December,Liberty                                              ,Not Adjusted,28272,31088,2816,9.1
7760,2012,March,Limestone                                            ,Not Adjusted,8883,9531,648,6.8
7761,2012,June,Limestone                                            ,Not Adjusted,8971,9696,725,7.5
7762,2012,September,Limestone                                            ,Not Adjusted,8980,9599,619,6.4
7763,2012,December,Limestone                                            ,Not Adjusted,8922,9521,599,6.3
7764,2012,March,Lipscomb                                             ,Not Adjusted,1690,1753,63,3.6
7765,2012,June,Lipscomb                                             ,Not Adjusted,1759,1835,76,4.1
7766,2012,September,Lipscomb                                             ,Not Adjusted,1726,1789,63,3.5
7767,2012,December,Lipscomb                                             ,Not Adjusted,1678,1742,64,3.7
7768,2012,March,Live Oak                                             ,Not Adjusted,5186,5441,255,4.7
7769,2012,June,Live Oak                                             ,Not Adjusted,5606,5896,290,4.9
7770,2012,September,Live Oak                                             ,Not Adjusted,5660,5913,253,4.3
7771,2012,December,Live Oak                                             ,Not Adjusted,5706,5961,255,4.3
7772,2012,March,Llano                                                ,Not Adjusted,7427,7969,542,6.8
7773,2012,June,Llano                                                ,Not Adjusted,7755,8337,582,7.0
7774,2012,September,Llano                                                ,Not Adjusted,7582,8108,526,6.5
7775,2012,December,Llano                                                ,Not Adjusted,7370,7889,519,6.6
7776,2012,March,Loving                                               ,Not Adjusted,69,73,4,5.5
7777,2012,June,Loving                                               ,Not Adjusted,59,64,5,7.8
7778,2012,September,Loving                                               ,Not Adjusted,59,63,4,6.3
7779,2012,December,Loving                                               ,Not Adjusted,68,72,4,5.6
7780,2012,March,Lubbock                                              ,Not Adjusted,136529,144365,7836,5.4
7781,2012,June,Lubbock                                              ,Not Adjusted,137087,146060,8973,6.1
7782,2012,September,Lubbock                                              ,Not Adjusted,138144,145378,7234,5.0
7783,2012,December,Lubbock                                              ,Not Adjusted,138676,145621,6945,4.8
7784,2012,March,Lynn                                                 ,Not Adjusted,2727,2922,195,6.7
7785,2012,June,Lynn                                                 ,Not Adjusted,2820,3025,205,6.8
7786,2012,September,Lynn                                                 ,Not Adjusted,2809,2967,158,5.3
7787,2012,December,Lynn                                                 ,Not Adjusted,2736,2885,149,5.2
7788,2012,March,McCulloch                                            ,Not Adjusted,4145,4368,223,5.1
7789,2012,June,McCulloch                                            ,Not Adjusted,4213,4469,256,5.7
7790,2012,September,McCulloch                                            ,Not Adjusted,4179,4407,228,5.2
7791,2012,December,McCulloch                                            ,Not Adjusted,4110,4336,226,5.2
7792,2012,March,McLennan                                             ,Not Adjusted,104624,111957,7333,6.5
7793,2012,June,McLennan                                             ,Not Adjusted,104437,112723,8286,7.4
7794,2012,September,McLennan                                             ,Not Adjusted,105407,112387,6980,6.2
7795,2012,December,McLennan                                             ,Not Adjusted,104923,111683,6760,6.1
7796,2012,March,McMullen                                             ,Not Adjusted,703,720,17,2.4
7797,2012,June,McMullen                                             ,Not Adjusted,729,749,20,2.7
7798,2012,September,McMullen                                             ,Not Adjusted,733,748,15,2.0
7799,2012,December,McMullen                                             ,Not Adjusted,757,773,16,2.1
7800,2012,March,Madison                                              ,Not Adjusted,4269,4581,312,6.8
7801,2012,June,Madison                                              ,Not Adjusted,4364,4737,373,7.9
7802,2012,September,Madison                                              ,Not Adjusted,4404,4724,320,6.8
7803,2012,December,Madison                                              ,Not Adjusted,4335,4640,305,6.6
7804,2012,March,Marion                                               ,Not Adjusted,3910,4311,401,9.3
7805,2012,June,Marion                                               ,Not Adjusted,3936,4345,409,9.4
7806,2012,September,Marion                                               ,Not Adjusted,3953,4332,379,8.7
7807,2012,December,Marion                                               ,Not Adjusted,4006,4398,392,8.9
7808,2012,March,Martin                                               ,Not Adjusted,2240,2342,102,4.4
7809,2012,June,Martin                                               ,Not Adjusted,2323,2444,121,5.0
7810,2012,September,Martin                                               ,Not Adjusted,2356,2460,104,4.2
7811,2012,December,Martin                                               ,Not Adjusted,2316,2416,100,4.1
7812,2012,March,Mason                                                ,Not Adjusted,1836,1936,100,5.2
7813,2012,June,Mason                                                ,Not Adjusted,1908,2018,110,5.5
7814,2012,September,Mason                                                ,Not Adjusted,1853,1953,100,5.1
7815,2012,December,Mason                                                ,Not Adjusted,1864,1958,94,4.8
7816,2012,March,Matagorda                                            ,Not Adjusted,15202,16920,1718,10.2
7817,2012,June,Matagorda                                            ,Not Adjusted,15422,17293,1871,10.8
7818,2012,September,Matagorda                                            ,Not Adjusted,15408,17024,1616,9.5
7819,2012,December,Matagorda                                            ,Not Adjusted,15024,16701,1677,10.0
7820,2012,March,Maverick                                             ,Not Adjusted,20481,23668,3187,13.5
7821,2012,June,Maverick                                             ,Not Adjusted,20494,23441,2947,12.6
7822,2012,September,Maverick                                             ,Not Adjusted,20341,22814,2473,10.8
7823,2012,December,Maverick                                             ,Not Adjusted,20550,23389,2839,12.1
7824,2012,March,Medina                                               ,Not Adjusted,18691,19972,1281,6.4
7825,2012,June,Medina                                               ,Not Adjusted,18922,20365,1443,7.1
7826,2012,September,Medina                                               ,Not Adjusted,19007,20270,1263,6.2
7827,2012,December,Medina                                               ,Not Adjusted,18966,20196,1230,6.1
7828,2012,March,Menard                                               ,Not Adjusted,910,969,59,6.1
7829,2012,June,Menard                                               ,Not Adjusted,923,990,67,6.8
7830,2012,September,Menard                                               ,Not Adjusted,933,992,59,5.9
7831,2012,December,Menard                                               ,Not Adjusted,890,948,58,6.1
7832,2012,March,Midland                                              ,Not Adjusted,76982,80031,3049,3.8
7833,2012,June,Midland                                              ,Not Adjusted,78483,82078,3595,4.4
7834,2012,September,Midland                                              ,Not Adjusted,80376,83413,3037,3.6
7835,2012,December,Midland                                              ,Not Adjusted,80498,83328,2830,3.4
7836,2012,March,Milam                                                ,Not Adjusted,9329,10187,858,8.4
7837,2012,June,Milam                                                ,Not Adjusted,9540,10486,946,9.0
7838,2012,September,Milam                                                ,Not Adjusted,9427,10254,827,8.1
7839,2012,December,Milam                                                ,Not Adjusted,9176,10068,892,8.9
7840,2012,March,Mills                                                ,Not Adjusted,1977,2088,111,5.3
7841,2012,June,Mills                                                ,Not Adjusted,2034,2159,125,5.8
7842,2012,September,Mills                                                ,Not Adjusted,1976,2085,109,5.2
7843,2012,December,Mills                                                ,Not Adjusted,1935,2041,106,5.2
7844,2012,March,Mitchell                                             ,Not Adjusted,2701,2876,175,6.1
7845,2012,June,Mitchell                                             ,Not Adjusted,2741,2931,190,6.5
7846,2012,September,Mitchell                                             ,Not Adjusted,2723,2878,155,5.4
7847,2012,December,Mitchell                                             ,Not Adjusted,2677,2824,147,5.2
7848,2012,March,Montague                                             ,Not Adjusted,9067,9601,534,5.6
7849,2012,June,Montague                                             ,Not Adjusted,9266,9840,574,5.8
7850,2012,September,Montague                                             ,Not Adjusted,9532,10034,502,5.0
7851,2012,December,Montague                                             ,Not Adjusted,9623,10104,481,4.8
7852,2012,March,Montgomery                                           ,Not Adjusted,222489,236263,13774,5.8
7853,2012,June,Montgomery                                           ,Not Adjusted,223892,239506,15614,6.5
7854,2012,September,Montgomery                                           ,Not Adjusted,226762,240351,13589,5.7
7855,2012,December,Montgomery                                           ,Not Adjusted,228240,241189,12949,5.4
7856,2012,March,Moore                                                ,Not Adjusted,11026,11496,470,4.1
7857,2012,June,Moore                                                ,Not Adjusted,11147,11719,572,4.9
7858,2012,September,Moore                                                ,Not Adjusted,11063,11539,476,4.1
7859,2012,December,Moore                                                ,Not Adjusted,10856,11321,465,4.1
7860,2012,March,Morris                                               ,Not Adjusted,5211,5783,572,9.9
7861,2012,June,Morris                                               ,Not Adjusted,5292,5881,589,10.0
7862,2012,September,Morris                                               ,Not Adjusted,5323,5858,535,9.1
7863,2012,December,Morris                                               ,Not Adjusted,5229,5766,537,9.3
7864,2012,March,Motley                                               ,Not Adjusted,479,513,34,6.6
7865,2012,June,Motley                                               ,Not Adjusted,509,540,31,5.7
7866,2012,September,Motley                                               ,Not Adjusted,497,524,27,5.2
7867,2012,December,Motley                                               ,Not Adjusted,469,496,27,5.4
7868,2012,March,Nacogdoches                                          ,Not Adjusted,28109,29935,1826,6.1
7869,2012,June,Nacogdoches                                          ,Not Adjusted,27451,29719,2268,7.6
7870,2012,September,Nacogdoches                                          ,Not Adjusted,27248,29136,1888,6.5
7871,2012,December,Nacogdoches                                          ,Not Adjusted,27215,29020,1805,6.2
7872,2012,March,Navarro                                              ,Not Adjusted,21034,22773,1739,7.6
7873,2012,June,Navarro                                              ,Not Adjusted,21020,22804,1784,7.8
7874,2012,September,Navarro                                              ,Not Adjusted,21979,23603,1624,6.9
7875,2012,December,Navarro                                              ,Not Adjusted,21792,23331,1539,6.6
7876,2012,March,Newton                                               ,Not Adjusted,5216,5833,617,10.6
7877,2012,June,Newton                                               ,Not Adjusted,5174,5870,696,11.9
7878,2012,September,Newton                                               ,Not Adjusted,5107,5726,619,10.8
7879,2012,December,Newton                                               ,Not Adjusted,5052,5711,659,11.5
7880,2012,March,Nolan                                                ,Not Adjusted,6602,7033,431,6.1
7881,2012,June,Nolan                                                ,Not Adjusted,6743,7215,472,6.5
7882,2012,September,Nolan                                                ,Not Adjusted,6687,7066,379,5.4
7883,2012,December,Nolan                                                ,Not Adjusted,6603,6983,380,5.4
7884,2012,March,Nueces                                               ,Not Adjusted,155070,165794,10724,6.5
7885,2012,June,Nueces                                               ,Not Adjusted,155831,167714,11883,7.1
7886,2012,September,Nueces                                               ,Not Adjusted,156445,166740,10295,6.2
7887,2012,December,Nueces                                               ,Not Adjusted,155870,165933,10063,6.1
7888,2012,March,Ochiltree                                            ,Not Adjusted,4987,5176,189,3.7
7889,2012,June,Ochiltree                                            ,Not Adjusted,5259,5492,233,4.2
7890,2012,September,Ochiltree                                            ,Not Adjusted,5179,5381,202,3.8
7891,2012,December,Ochiltree                                            ,Not Adjusted,5025,5212,187,3.6
7892,2012,March,Oldham                                               ,Not Adjusted,900,937,37,3.9
7893,2012,June,Oldham                                               ,Not Adjusted,921,966,45,4.7
7894,2012,September,Oldham                                               ,Not Adjusted,914,956,42,4.4
7895,2012,December,Oldham                                               ,Not Adjusted,898,940,42,4.5
7896,2012,March,Orange                                               ,Not Adjusted,35212,38997,3785,9.7
7897,2012,June,Orange                                               ,Not Adjusted,34776,39178,4402,11.2
7898,2012,September,Orange                                               ,Not Adjusted,34419,38426,4007,10.4
7899,2012,December,Orange                                               ,Not Adjusted,34177,38382,4205,11.0
7900,2012,March,Palo Pinto                                           ,Not Adjusted,12310,13186,876,6.6
7901,2012,June,Palo Pinto                                           ,Not Adjusted,12664,13646,982,7.2
7902,2012,September,Palo Pinto                                           ,Not Adjusted,12623,13484,861,6.4
7903,2012,December,Palo Pinto                                           ,Not Adjusted,12449,13307,858,6.4
7904,2012,March,Panola                                               ,Not Adjusted,11211,12032,821,6.8
7905,2012,June,Panola                                               ,Not Adjusted,11337,12247,910,7.4
7906,2012,September,Panola                                               ,Not Adjusted,11659,12452,793,6.4
7907,2012,December,Panola                                               ,Not Adjusted,11618,12455,837,6.7
7908,2012,March,Parker                                               ,Not Adjusted,53960,57348,3388,5.9
7909,2012,June,Parker                                               ,Not Adjusted,54456,58256,3800,6.5
7910,2012,September,Parker                                               ,Not Adjusted,54739,57981,3242,5.6
7911,2012,December,Parker                                               ,Not Adjusted,55021,58166,3145,5.4
7912,2012,March,Parmer                                               ,Not Adjusted,4722,4911,189,3.8
7913,2012,June,Parmer                                               ,Not Adjusted,4893,5128,235,4.6
7914,2012,September,Parmer                                               ,Not Adjusted,4867,5065,198,3.9
7915,2012,December,Parmer                                               ,Not Adjusted,4657,4847,190,3.9
7916,2012,March,Pecos                                                ,Not Adjusted,6765,7129,364,5.1
7917,2012,June,Pecos                                                ,Not Adjusted,6727,7114,387,5.4
7918,2012,September,Pecos                                                ,Not Adjusted,6521,6865,344,5.0
7919,2012,December,Pecos                                                ,Not Adjusted,6321,6648,327,4.9
7920,2012,March,Polk                                                 ,Not Adjusted,16099,17492,1393,8.0
7921,2012,June,Polk                                                 ,Not Adjusted,16146,17657,1511,8.6
7922,2012,September,Polk                                                 ,Not Adjusted,16173,17494,1321,7.6
7923,2012,December,Polk                                                 ,Not Adjusted,16040,17377,1337,7.7
7924,2012,March,Potter                                               ,Not Adjusted,54951,57992,3041,5.2
7925,2012,June,Potter                                               ,Not Adjusted,54888,58367,3479,6.0
7926,2012,September,Potter                                               ,Not Adjusted,55140,58061,2921,5.0
7927,2012,December,Potter                                               ,Not Adjusted,55371,58261,2890,5.0
7928,2012,March,Presidio                                             ,Not Adjusted,3308,3724,416,11.2
7929,2012,June,Presidio                                             ,Not Adjusted,3378,3966,588,14.8
7930,2012,September,Presidio                                             ,Not Adjusted,3330,3891,561,14.4
7931,2012,December,Presidio                                             ,Not Adjusted,3294,3799,505,13.3
7932,2012,March,Rains                                                ,Not Adjusted,4904,5256,352,6.7
7933,2012,June,Rains                                                ,Not Adjusted,4811,5192,381,7.3
7934,2012,September,Rains                                                ,Not Adjusted,4870,5222,352,6.7
7935,2012,December,Rains                                                ,Not Adjusted,4858,5205,347,6.7
7936,2012,March,Randall                                              ,Not Adjusted,64817,67703,2886,4.3
7937,2012,June,Randall                                              ,Not Adjusted,64851,68213,3362,4.9
7938,2012,September,Randall                                              ,Not Adjusted,64953,67796,2843,4.2
7939,2012,December,Randall                                              ,Not Adjusted,65133,67864,2731,4.0
7940,2012,March,Reagan                                               ,Not Adjusted,2007,2070,63,3.0
7941,2012,June,Reagan                                               ,Not Adjusted,2110,2188,78,3.6
7942,2012,September,Reagan                                               ,Not Adjusted,1979,2046,67,3.3
7943,2012,December,Reagan                                               ,Not Adjusted,1898,1971,73,3.7
7944,2012,March,Real                                                 ,Not Adjusted,931,1032,101,9.8
7945,2012,June,Real                                                 ,Not Adjusted,1048,1160,112,9.7
7946,2012,September,Real                                                 ,Not Adjusted,963,1058,95,9.0
7947,2012,December,Real                                                 ,Not Adjusted,927,1019,92,9.0
7948,2012,March,Red River                                            ,Not Adjusted,4703,5256,553,10.5
7949,2012,June,Red River                                            ,Not Adjusted,4712,5318,606,11.4
7950,2012,September,Red River                                            ,Not Adjusted,4676,5207,531,10.2
7951,2012,December,Red River                                            ,Not Adjusted,4629,5155,526,10.2
7952,2012,March,Reeves                                               ,Not Adjusted,4867,5210,343,6.6
7953,2012,June,Reeves                                               ,Not Adjusted,4953,5350,397,7.4
7954,2012,September,Reeves                                               ,Not Adjusted,5091,5432,341,6.3
7955,2012,December,Reeves                                               ,Not Adjusted,5112,5441,329,6.0
7956,2012,March,Refugio                                              ,Not Adjusted,3254,3458,204,5.9
7957,2012,June,Refugio                                              ,Not Adjusted,3312,3536,224,6.3
7958,2012,September,Refugio                                              ,Not Adjusted,3359,3557,198,5.6
7959,2012,December,Refugio                                              ,Not Adjusted,3288,3490,202,5.8
7960,2012,March,Roberts                                              ,Not Adjusted,443,468,25,5.3
7961,2012,June,Roberts                                              ,Not Adjusted,466,492,26,5.3
7962,2012,September,Roberts                                              ,Not Adjusted,444,467,23,4.9
7963,2012,December,Roberts                                              ,Not Adjusted,435,459,24,5.2
7964,2012,March,Robertson                                            ,Not Adjusted,6631,7218,587,8.1
7965,2012,June,Robertson                                            ,Not Adjusted,6646,7272,626,8.6
7966,2012,September,Robertson                                            ,Not Adjusted,6807,7361,554,7.5
7967,2012,December,Robertson                                            ,Not Adjusted,6808,7359,551,7.5
7968,2012,March,Rockwall                                             ,Not Adjusted,38327,40820,2493,6.1
7969,2012,June,Rockwall                                             ,Not Adjusted,38498,41304,2806,6.8
7970,2012,September,Rockwall                                             ,Not Adjusted,38801,41208,2407,5.8
7971,2012,December,Rockwall                                             ,Not Adjusted,38979,41330,2351,5.7
7972,2012,March,Runnels                                              ,Not Adjusted,4695,4969,274,5.5
7973,2012,June,Runnels                                              ,Not Adjusted,4839,5132,293,5.7
7974,2012,September,Runnels                                              ,Not Adjusted,4744,5042,298,5.9
7975,2012,December,Runnels                                              ,Not Adjusted,4827,5063,236,4.7
7976,2012,March,Rusk                                                 ,Not Adjusted,23178,24638,1460,5.9
7977,2012,June,Rusk                                                 ,Not Adjusted,22964,24665,1701,6.9
7978,2012,September,Rusk                                                 ,Not Adjusted,22961,24500,1539,6.3
7979,2012,December,Rusk                                                 ,Not Adjusted,22825,24299,1474,6.1
7980,2012,March,Sabine                                               ,Not Adjusted,2794,3265,471,14.4
7981,2012,June,Sabine                                               ,Not Adjusted,2865,3394,529,15.6
7982,2012,September,Sabine                                               ,Not Adjusted,2963,3434,471,13.7
7983,2012,December,Sabine                                               ,Not Adjusted,3005,3500,495,14.1
7984,2012,March,San Augustine                                        ,Not Adjusted,2694,3065,371,12.1
7985,2012,June,San Augustine                                        ,Not Adjusted,2666,3046,380,12.5
7986,2012,September,San Augustine                                        ,Not Adjusted,2630,2980,350,11.7
7987,2012,December,San Augustine                                        ,Not Adjusted,2588,2941,353,12.0
7988,2012,March,San Jacinto                                          ,Not Adjusted,10443,11366,923,8.1
7989,2012,June,San Jacinto                                          ,Not Adjusted,10609,11628,1019,8.8
7990,2012,September,San Jacinto                                          ,Not Adjusted,10548,11446,898,7.8
7991,2012,December,San Jacinto                                          ,Not Adjusted,10534,11438,904,7.9
7992,2012,March,San Patricio                                         ,Not Adjusted,27941,30221,2280,7.5
7993,2012,June,San Patricio                                         ,Not Adjusted,28153,30627,2474,8.1
7994,2012,September,San Patricio                                         ,Not Adjusted,28196,30352,2156,7.1
7995,2012,December,San Patricio                                         ,Not Adjusted,28024,30178,2154,7.1
7996,2012,March,San Saba                                             ,Not Adjusted,2160,2312,152,6.6
7997,2012,June,San Saba                                             ,Not Adjusted,2147,2299,152,6.6
7998,2012,September,San Saba                                             ,Not Adjusted,2148,2281,133,5.8
7999,2012,December,San Saba                                             ,Not Adjusted,2151,2273,122,5.4
8000,2012,March,Schleicher                                           ,Not Adjusted,1669,1736,67,3.9
8001,2012,June,Schleicher                                           ,Not Adjusted,1758,1841,83,4.5
8002,2012,September,Schleicher                                           ,Not Adjusted,1717,1782,65,3.6
8003,2012,December,Schleicher                                           ,Not Adjusted,1721,1782,61,3.4
8004,2012,March,Scurry                                               ,Not Adjusted,7466,7824,358,4.6
8005,2012,June,Scurry                                               ,Not Adjusted,7619,8045,426,5.3
8006,2012,September,Scurry                                               ,Not Adjusted,7913,8244,331,4.0
8007,2012,December,Scurry                                               ,Not Adjusted,8139,8459,320,3.8
8008,2012,March,Shackelford                                          ,Not Adjusted,2061,2133,72,3.4
8009,2012,June,Shackelford                                          ,Not Adjusted,2202,2293,91,4.0
8010,2012,September,Shackelford                                          ,Not Adjusted,2166,2238,72,3.2
8011,2012,December,Shackelford                                          ,Not Adjusted,2138,2204,66,3.0
8012,2012,March,Shelby                                               ,Not Adjusted,11320,12124,804,6.6
8013,2012,June,Shelby                                               ,Not Adjusted,11358,12355,997,8.1
8014,2012,September,Shelby                                               ,Not Adjusted,11155,12002,847,7.1
8015,2012,December,Shelby                                               ,Not Adjusted,10962,11843,881,7.4
8016,2012,March,Sherman                                              ,Not Adjusted,1419,1474,55,3.7
8017,2012,June,Sherman                                              ,Not Adjusted,1476,1549,73,4.7
8018,2012,September,Sherman                                              ,Not Adjusted,1447,1507,60,4.0
8019,2012,December,Sherman                                              ,Not Adjusted,1392,1452,60,4.1
8020,2012,March,Smith                                                ,Not Adjusted,94137,101033,6896,6.8
8021,2012,June,Smith                                                ,Not Adjusted,94968,102553,7585,7.4
8022,2012,September,Smith                                                ,Not Adjusted,94141,101005,6864,6.8
8023,2012,December,Smith                                                ,Not Adjusted,94653,101386,6733,6.6
8024,2012,March,Somervell                                            ,Not Adjusted,3832,4098,266,6.5
8025,2012,June,Somervell                                            ,Not Adjusted,3863,4163,300,7.2
8026,2012,September,Somervell                                            ,Not Adjusted,3887,4154,267,6.4
8027,2012,December,Somervell                                            ,Not Adjusted,3912,4176,264,6.3
8028,2012,March,Starr                                                ,Not Adjusted,22345,26187,3842,14.7
8029,2012,June,Starr                                                ,Not Adjusted,21943,25917,3974,15.3
8030,2012,September,Starr                                                ,Not Adjusted,22198,25472,3274,12.9
8031,2012,December,Starr                                                ,Not Adjusted,22482,26457,3975,15.0
8032,2012,March,Stephens                                             ,Not Adjusted,4178,4433,255,5.8
8033,2012,June,Stephens                                             ,Not Adjusted,4130,4416,286,6.5
8034,2012,September,Stephens                                             ,Not Adjusted,4176,4424,248,5.6
8035,2012,December,Stephens                                             ,Not Adjusted,4029,4255,226,5.3
8036,2012,March,Sterling                                             ,Not Adjusted,667,693,26,3.8
8037,2012,June,Sterling                                             ,Not Adjusted,715,743,28,3.8
8038,2012,September,Sterling                                             ,Not Adjusted,721,745,24,3.2
8039,2012,December,Sterling                                             ,Not Adjusted,685,710,25,3.5
8040,2012,March,Stonewall                                            ,Not Adjusted,695,728,33,4.5
8041,2012,June,Stonewall                                            ,Not Adjusted,739,774,35,4.5
8042,2012,September,Stonewall                                            ,Not Adjusted,726,759,33,4.3
8043,2012,December,Stonewall                                            ,Not Adjusted,716,743,27,3.6
8044,2012,March,Sutton                                               ,Not Adjusted,1848,1942,94,4.8
8045,2012,June,Sutton                                               ,Not Adjusted,1913,2020,107,5.3
8046,2012,September,Sutton                                               ,Not Adjusted,1970,2059,89,4.3
8047,2012,December,Sutton                                               ,Not Adjusted,1948,2041,93,4.6
8048,2012,March,Swisher                                              ,Not Adjusted,2866,3038,172,5.7
8049,2012,June,Swisher                                              ,Not Adjusted,2945,3157,212,6.7
8050,2012,September,Swisher                                              ,Not Adjusted,2878,3046,168,5.5
8051,2012,December,Swisher                                              ,Not Adjusted,2779,2946,167,5.7
8052,2012,March,Tarrant                                              ,Not Adjusted,895554,957969,62415,6.5
8053,2012,June,Tarrant                                              ,Not Adjusted,901519,969409,67890,7.0
8054,2012,September,Tarrant                                              ,Not Adjusted,906133,965754,59621,6.2
8055,2012,December,Tarrant                                              ,Not Adjusted,913449,971141,57692,5.9
8056,2012,March,Taylor                                               ,Not Adjusted,61045,64578,3533,5.5
8057,2012,June,Taylor                                               ,Not Adjusted,60111,64204,4093,6.4
8058,2012,September,Taylor                                               ,Not Adjusted,60695,64112,3417,5.3
8059,2012,December,Taylor                                               ,Not Adjusted,60871,64179,3308,5.2
8060,2012,March,Terrell                                              ,Not Adjusted,489,513,24,4.7
8061,2012,June,Terrell                                              ,Not Adjusted,549,575,26,4.5
8062,2012,September,Terrell                                              ,Not Adjusted,552,578,26,4.5
8063,2012,December,Terrell                                              ,Not Adjusted,533,561,28,5.0
8064,2012,March,Terry                                                ,Not Adjusted,5289,5667,378,6.7
8065,2012,June,Terry                                                ,Not Adjusted,5439,5849,410,7.0
8066,2012,September,Terry                                                ,Not Adjusted,5285,5626,341,6.1
8067,2012,December,Terry                                                ,Not Adjusted,5215,5556,341,6.1
8068,2012,March,Throckmorton                                         ,Not Adjusted,785,828,43,5.2
8069,2012,June,Throckmorton                                         ,Not Adjusted,804,856,52,6.1
8070,2012,September,Throckmorton                                         ,Not Adjusted,788,825,37,4.5
8071,2012,December,Throckmorton                                         ,Not Adjusted,761,800,39,4.9
8072,2012,March,Titus                                                ,Not Adjusted,12392,13330,938,7.0
8073,2012,June,Titus                                                ,Not Adjusted,12329,13414,1085,8.1
8074,2012,September,Titus                                                ,Not Adjusted,12296,13257,961,7.2
8075,2012,December,Titus                                                ,Not Adjusted,12116,13066,950,7.3
8076,2012,March,Tom Green                                            ,Not Adjusted,50456,53214,2758,5.2
8077,2012,June,Tom Green                                            ,Not Adjusted,50853,54008,3155,5.8
8078,2012,September,Tom Green                                            ,Not Adjusted,51323,54023,2700,5.0
8079,2012,December,Tom Green                                            ,Not Adjusted,51186,53814,2628,4.9
8080,2012,March,Travis                                               ,Not Adjusted,571617,604942,33325,5.5
8081,2012,June,Travis                                               ,Not Adjusted,574412,610740,36328,5.9
8082,2012,September,Travis                                               ,Not Adjusted,582047,614039,31992,5.2
8083,2012,December,Travis                                               ,Not Adjusted,588095,619125,31030,5.0
8084,2012,March,Trinity                                              ,Not Adjusted,5051,5500,449,8.2
8085,2012,June,Trinity                                              ,Not Adjusted,5156,5650,494,8.7
8086,2012,September,Trinity                                              ,Not Adjusted,5179,5613,434,7.7
8087,2012,December,Trinity                                              ,Not Adjusted,5077,5510,433,7.9
8088,2012,March,Tyler                                                ,Not Adjusted,6788,7546,758,10.0
8089,2012,June,Tyler                                                ,Not Adjusted,6852,7727,875,11.3
8090,2012,September,Tyler                                                ,Not Adjusted,6741,7533,792,10.5
8091,2012,December,Tyler                                                ,Not Adjusted,6652,7469,817,10.9
8092,2012,March,Upshur                                               ,Not Adjusted,17565,18793,1228,6.5
8093,2012,June,Upshur                                               ,Not Adjusted,17403,18767,1364,7.3
8094,2012,September,Upshur                                               ,Not Adjusted,17401,18602,1201,6.5
8095,2012,December,Upshur                                               ,Not Adjusted,17297,18500,1203,6.5
8096,2012,March,Upton                                                ,Not Adjusted,1464,1524,60,3.9
8097,2012,June,Upton                                                ,Not Adjusted,1549,1616,67,4.1
8098,2012,September,Upton                                                ,Not Adjusted,1558,1618,60,3.7
8099,2012,December,Upton                                                ,Not Adjusted,1512,1570,58,3.7
8100,2012,March,Uvalde                                               ,Not Adjusted,10933,11932,999,8.4
8101,2012,June,Uvalde                                               ,Not Adjusted,11155,12167,1012,8.3
8102,2012,September,Uvalde                                               ,Not Adjusted,11095,11977,882,7.4
8103,2012,December,Uvalde                                               ,Not Adjusted,10774,11651,877,7.5
8104,2012,March,Val Verde                                            ,Not Adjusted,18640,20158,1518,7.5
8105,2012,June,Val Verde                                            ,Not Adjusted,18474,20113,1639,8.1
8106,2012,September,Val Verde                                            ,Not Adjusted,18441,19839,1398,7.0
8107,2012,December,Val Verde                                            ,Not Adjusted,18481,19951,1470,7.4
8108,2012,March,Van Zandt                                            ,Not Adjusted,21829,23407,1578,6.7
8109,2012,June,Van Zandt                                            ,Not Adjusted,22091,23876,1785,7.5
8110,2012,September,Van Zandt                                            ,Not Adjusted,21970,23527,1557,6.6
8111,2012,December,Van Zandt                                            ,Not Adjusted,21991,23542,1551,6.6
8112,2012,March,Victoria                                             ,Not Adjusted,42211,44635,2424,5.4
8113,2012,June,Victoria                                             ,Not Adjusted,42586,45332,2746,6.1
8114,2012,September,Victoria                                             ,Not Adjusted,43245,45603,2358,5.2
8115,2012,December,Victoria                                             ,Not Adjusted,43306,45768,2462,5.4
8116,2012,March,Walker                                               ,Not Adjusted,21431,22936,1505,6.6
8117,2012,June,Walker                                               ,Not Adjusted,21577,23404,1827,7.8
8118,2012,September,Walker                                               ,Not Adjusted,21652,23183,1531,6.6
8119,2012,December,Walker                                               ,Not Adjusted,21463,22931,1468,6.4
8120,2012,March,Waller                                               ,Not Adjusted,18836,20189,1353,6.7
8121,2012,June,Waller                                               ,Not Adjusted,19036,20687,1651,8.0
8122,2012,September,Waller                                               ,Not Adjusted,19224,20574,1350,6.6
8123,2012,December,Waller                                               ,Not Adjusted,19269,20565,1296,6.3
8124,2012,March,Ward                                                 ,Not Adjusted,4854,5096,242,4.7
8125,2012,June,Ward                                                 ,Not Adjusted,5112,5402,290,5.4
8126,2012,September,Ward                                                 ,Not Adjusted,5228,5472,244,4.5
8127,2012,December,Ward                                                 ,Not Adjusted,5209,5447,238,4.4
8128,2012,March,Washington                                           ,Not Adjusted,14662,15529,867,5.6
8129,2012,June,Washington                                           ,Not Adjusted,14821,15831,1010,6.4
8130,2012,September,Washington                                           ,Not Adjusted,14871,15691,820,5.2
8131,2012,December,Washington                                           ,Not Adjusted,14711,15492,781,5.0
8132,2012,March,Webb                                                 ,Not Adjusted,101713,108533,6820,6.3
8133,2012,June,Webb                                                 ,Not Adjusted,101039,109038,7999,7.3
8134,2012,September,Webb                                                 ,Not Adjusted,102490,109050,6560,6.0
8135,2012,December,Webb                                                 ,Not Adjusted,103122,109646,6524,6.0
8136,2012,March,Wharton                                              ,Not Adjusted,19695,21158,1463,6.9
8137,2012,June,Wharton                                              ,Not Adjusted,20050,21615,1565,7.2
8138,2012,September,Wharton                                              ,Not Adjusted,20260,21591,1331,6.2
8139,2012,December,Wharton                                              ,Not Adjusted,19938,21232,1294,6.1
8140,2012,March,Wheeler                                              ,Not Adjusted,2781,2895,114,3.9
8141,2012,June,Wheeler                                              ,Not Adjusted,2768,2909,141,4.8
8142,2012,September,Wheeler                                              ,Not Adjusted,2755,2876,121,4.2
8143,2012,December,Wheeler                                              ,Not Adjusted,2753,2875,122,4.2
8144,2012,March,Wichita                                              ,Not Adjusted,55402,58837,3435,5.8
8145,2012,June,Wichita                                              ,Not Adjusted,54874,58800,3926,6.7
8146,2012,September,Wichita                                              ,Not Adjusted,54432,57841,3409,5.9
8147,2012,December,Wichita                                              ,Not Adjusted,54286,57646,3360,5.8
8148,2012,March,Wilbarger                                            ,Not Adjusted,5541,5891,350,5.9
8149,2012,June,Wilbarger                                            ,Not Adjusted,5591,6001,410,6.8
8150,2012,September,Wilbarger                                            ,Not Adjusted,5596,5926,330,5.6
8151,2012,December,Wilbarger                                            ,Not Adjusted,5526,5839,313,5.4
8152,2012,March,Willacy                                              ,Not Adjusted,6218,7403,1185,16.0
8153,2012,June,Willacy                                              ,Not Adjusted,6302,7517,1215,16.2
8154,2012,September,Willacy                                              ,Not Adjusted,6260,7366,1106,15.0
8155,2012,December,Willacy                                              ,Not Adjusted,6222,7384,1162,15.7
8156,2012,March,Williamson                                           ,Not Adjusted,220996,234627,13631,5.8
8157,2012,June,Williamson                                           ,Not Adjusted,222095,237086,14991,6.3
8158,2012,September,Williamson                                           ,Not Adjusted,224641,237806,13165,5.5
8159,2012,December,Williamson                                           ,Not Adjusted,227073,239831,12758,5.3
8160,2012,March,Wilson                                               ,Not Adjusted,20338,21492,1154,5.4
8161,2012,June,Wilson                                               ,Not Adjusted,20513,21854,1341,6.1
8162,2012,September,Wilson                                               ,Not Adjusted,20641,21763,1122,5.2
8163,2012,December,Wilson                                               ,Not Adjusted,20671,21779,1108,5.1
8164,2012,March,Winkler                                              ,Not Adjusted,3013,3186,173,5.4
8165,2012,June,Winkler                                              ,Not Adjusted,2958,3161,203,6.4
8166,2012,September,Winkler                                              ,Not Adjusted,3021,3190,169,5.3
8167,2012,December,Winkler                                              ,Not Adjusted,3032,3201,169,5.3
8168,2012,March,Wise                                                 ,Not Adjusted,26163,28028,1865,6.7
8169,2012,June,Wise                                                 ,Not Adjusted,26447,28482,2035,7.1
8170,2012,September,Wise                                                 ,Not Adjusted,26572,28265,1693,6.0
8171,2012,December,Wise                                                 ,Not Adjusted,26662,28314,1652,5.8
8172,2012,March,Wood                                                 ,Not Adjusted,15354,16639,1285,7.7
8173,2012,June,Wood                                                 ,Not Adjusted,15514,16918,1404,8.3
8174,2012,September,Wood                                                 ,Not Adjusted,15500,16771,1271,7.6
8175,2012,December,Wood                                                 ,Not Adjusted,15403,16624,1221,7.3
8176,2012,March,Yoakum                                               ,Not Adjusted,4186,4356,170,3.9
8177,2012,June,Yoakum                                               ,Not Adjusted,4248,4438,190,4.3
8178,2012,September,Yoakum                                               ,Not Adjusted,4157,4323,166,3.8
8179,2012,December,Yoakum                                               ,Not Adjusted,4123,4276,153,3.6
8180,2012,March,Young                                                ,Not Adjusted,7981,8456,475,5.6
8181,2012,June,Young                                                ,Not Adjusted,8162,8712,550,6.3
8182,2012,September,Young                                                ,Not Adjusted,8131,8594,463,5.4
8183,2012,December,Young                                                ,Not Adjusted,8121,8557,436,5.1
8184,2012,March,Zapata                                               ,Not Adjusted,6232,6647,415,6.2
8185,2012,June,Zapata                                               ,Not Adjusted,6284,6783,499,7.4
8186,2012,September,Zapata                                               ,Not Adjusted,6511,6904,393,5.7
8187,2012,December,Zapata                                               ,Not Adjusted,6683,7091,408,5.8
8188,2012,March,Zavala                                               ,Not Adjusted,3939,4534,595,13.1
8189,2012,June,Zavala                                               ,Not Adjusted,3870,4487,617,13.8
8190,2012,September,Zavala                                               ,Not Adjusted,3657,4235,578,13.6
8191,2012,December,Zavala                                               ,Not Adjusted,3522,4088,566,13.8
8192,2013,March,Texas,Not Adjusted,11921682,12730449,808767,6.4
8193,2013,March,Texas,Adjusted,11936855,12772688,835833,6.5
8194,2013,June,Texas,Not Adjusted,12013470,12901373,887903,6.9
8195,2013,June,Texas,Adjusted,12018765,12837490,818725,6.4
8196,2013,September,Texas,Not Adjusted,12088154,12895648,807494,6.3
8197,2013,September,Texas,Adjusted,12079341,12873858,794517,6.2
8198,2013,December,Texas,Not Adjusted,12176680,12878571,701891,5.5
8199,2013,December,Texas,Adjusted,12154284,12907972,753688,5.8
8200,2013,March,Anderson                                             ,Not Adjusted,20656,21936,1280,5.8
8201,2013,June,Anderson                                             ,Not Adjusted,20912,22343,1431,6.4
8202,2013,September,Anderson                                             ,Not Adjusted,20634,21920,1286,5.9
8203,2013,December,Anderson                                             ,Not Adjusted,20721,21794,1073,4.9
8204,2013,March,Andrews                                              ,Not Adjusted,8497,8839,342,3.9
8205,2013,June,Andrews                                              ,Not Adjusted,8810,9219,409,4.4
8206,2013,September,Andrews                                              ,Not Adjusted,9024,9378,354,3.8
8207,2013,December,Andrews                                              ,Not Adjusted,8871,9173,302,3.3
8208,2013,March,Angelina                                             ,Not Adjusted,35271,37725,2454,6.5
8209,2013,June,Angelina                                             ,Not Adjusted,35440,38166,2726,7.1
8210,2013,September,Angelina                                             ,Not Adjusted,35507,37989,2482,6.5
8211,2013,December,Angelina                                             ,Not Adjusted,35815,37891,2076,5.5
8212,2013,March,Aransas                                              ,Not Adjusted,9356,9999,643,6.4
8213,2013,June,Aransas                                              ,Not Adjusted,9407,10132,725,7.2
8214,2013,September,Aransas                                              ,Not Adjusted,9411,10093,682,6.8
8215,2013,December,Aransas                                              ,Not Adjusted,9450,10060,610,6.1
8216,2013,March,Archer                                               ,Not Adjusted,3961,4186,225,5.4
8217,2013,June,Archer                                               ,Not Adjusted,4041,4294,253,5.9
8218,2013,September,Archer                                               ,Not Adjusted,3994,4210,216,5.1
8219,2013,December,Archer                                               ,Not Adjusted,4005,4192,187,4.5
8220,2013,March,Armstrong                                            ,Not Adjusted,942,983,41,4.2
8221,2013,June,Armstrong                                            ,Not Adjusted,977,1024,47,4.6
8222,2013,September,Armstrong                                            ,Not Adjusted,971,1011,40,4.0
8223,2013,December,Armstrong                                            ,Not Adjusted,968,1000,32,3.2
8224,2013,March,Atascosa                                             ,Not Adjusted,18686,19917,1231,6.2
8225,2013,June,Atascosa                                             ,Not Adjusted,19039,20461,1422,6.9
8226,2013,September,Atascosa                                             ,Not Adjusted,19073,20377,1304,6.4
8227,2013,December,Atascosa                                             ,Not Adjusted,19136,20231,1095,5.4
8228,2013,March,Austin                                               ,Not Adjusted,13119,13950,831,6.0
8229,2013,June,Austin                                               ,Not Adjusted,13301,14215,914,6.4
8230,2013,September,Austin                                               ,Not Adjusted,13358,14194,836,5.9
8231,2013,December,Austin                                               ,Not Adjusted,13455,14160,705,5.0
8232,2013,March,Bailey                                               ,Not Adjusted,2695,2933,238,8.1
8233,2013,June,Bailey                                               ,Not Adjusted,2966,3217,251,7.8
8234,2013,September,Bailey                                               ,Not Adjusted,2891,3096,205,6.6
8235,2013,December,Bailey                                               ,Not Adjusted,2784,2952,168,5.7
8236,2013,March,Bandera                                              ,Not Adjusted,8385,8930,545,6.1
8237,2013,June,Bandera                                              ,Not Adjusted,8541,9140,599,6.6
8238,2013,September,Bandera                                              ,Not Adjusted,8563,9118,555,6.1
8239,2013,December,Bandera                                              ,Not Adjusted,8599,9070,471,5.2
8240,2013,March,Bastrop                                              ,Not Adjusted,33120,35458,2338,6.6
8241,2013,June,Bastrop                                              ,Not Adjusted,33635,36158,2523,7.0
8242,2013,September,Bastrop                                              ,Not Adjusted,33865,36083,2218,6.1
8243,2013,December,Bastrop                                              ,Not Adjusted,34224,36041,1817,5.0
8244,2013,March,Baylor                                               ,Not Adjusted,1561,1657,96,5.8
8245,2013,June,Baylor                                               ,Not Adjusted,1619,1716,97,5.7
8246,2013,September,Baylor                                               ,Not Adjusted,1561,1646,85,5.2
8247,2013,December,Baylor                                               ,Not Adjusted,1590,1663,73,4.4
8248,2013,March,Bee                                                  ,Not Adjusted,10339,11075,736,6.6
8249,2013,June,Bee                                                  ,Not Adjusted,10859,11700,841,7.2
8250,2013,September,Bee                                                  ,Not Adjusted,10936,11679,743,6.4
8251,2013,December,Bee                                                  ,Not Adjusted,10272,10902,630,5.8
8252,2013,March,Bell                                                 ,Not Adjusted,124941,134140,9199,6.9
8253,2013,June,Bell                                                 ,Not Adjusted,125056,135286,10230,7.6
8254,2013,September,Bell                                                 ,Not Adjusted,126469,136085,9616,7.1
8255,2013,December,Bell                                                 ,Not Adjusted,126545,134873,8328,6.2
8256,2013,March,Bexar                                                ,Not Adjusted,796572,846041,49469,5.8
8257,2013,June,Bexar                                                ,Not Adjusted,804263,859221,54958,6.4
8258,2013,September,Bexar                                                ,Not Adjusted,807130,857717,50587,5.9
8259,2013,December,Bexar                                                ,Not Adjusted,811396,854391,42995,5.0
8260,2013,March,Blanco                                               ,Not Adjusted,5151,5404,253,4.7
8261,2013,June,Blanco                                               ,Not Adjusted,5309,5604,295,5.3
8262,2013,September,Blanco                                               ,Not Adjusted,5325,5593,268,4.8
8263,2013,December,Blanco                                               ,Not Adjusted,5296,5513,217,3.9
8264,2013,March,Borden                                               ,Not Adjusted,390,405,15,3.7
8265,2013,June,Borden                                               ,Not Adjusted,408,426,18,4.2
8266,2013,September,Borden                                               ,Not Adjusted,399,415,16,3.9
8267,2013,December,Borden                                               ,Not Adjusted,410,425,15,3.5
8268,2013,March,Bosque                                               ,Not Adjusted,7414,7936,522,6.6
8269,2013,June,Bosque                                               ,Not Adjusted,7645,8235,590,7.2
8270,2013,September,Bosque                                               ,Not Adjusted,7620,8155,535,6.6
8271,2013,December,Bosque                                               ,Not Adjusted,7531,7968,437,5.5
8272,2013,March,Bowie                                                ,Not Adjusted,37632,40717,3085,7.6
8273,2013,June,Bowie                                                ,Not Adjusted,37829,41139,3310,8.0
8274,2013,September,Bowie                                                ,Not Adjusted,37121,40368,3247,8.0
8275,2013,December,Bowie                                                ,Not Adjusted,37148,39997,2849,7.1
8276,2013,March,Brazoria                                             ,Not Adjusted,152968,162835,9867,6.1
8277,2013,June,Brazoria                                             ,Not Adjusted,153658,164647,10989,6.7
8278,2013,September,Brazoria                                             ,Not Adjusted,154591,164769,10178,6.2
8279,2013,December,Brazoria                                             ,Not Adjusted,156035,165147,9112,5.5
8280,2013,March,Brazos                                               ,Not Adjusted,97626,102493,4867,4.7
8281,2013,June,Brazos                                               ,Not Adjusted,94579,100533,5954,5.9
8282,2013,September,Brazos                                               ,Not Adjusted,100130,105226,5096,4.8
8283,2013,December,Brazos                                               ,Not Adjusted,100371,104623,4252,4.1
8284,2013,March,Brewster                                             ,Not Adjusted,3929,4159,230,5.5
8285,2013,June,Brewster                                             ,Not Adjusted,3898,4160,262,6.3
8286,2013,September,Brewster                                             ,Not Adjusted,3910,4141,231,5.6
8287,2013,December,Brewster                                             ,Not Adjusted,3900,4097,197,4.8
8288,2013,March,Briscoe                                              ,Not Adjusted,563,599,36,6.0
8289,2013,June,Briscoe                                              ,Not Adjusted,613,653,40,6.1
8290,2013,September,Briscoe                                              ,Not Adjusted,602,638,36,5.6
8291,2013,December,Briscoe                                              ,Not Adjusted,600,628,28,4.5
8292,2013,March,Brooks                                               ,Not Adjusted,2581,2827,246,8.7
8293,2013,June,Brooks                                               ,Not Adjusted,2524,2828,304,10.7
8294,2013,September,Brooks                                               ,Not Adjusted,2470,2719,249,9.2
8295,2013,December,Brooks                                               ,Not Adjusted,2494,2702,208,7.7
8296,2013,March,Brown                                                ,Not Adjusted,14757,15790,1033,6.5
8297,2013,June,Brown                                                ,Not Adjusted,14991,16177,1186,7.3
8298,2013,September,Brown                                                ,Not Adjusted,14924,15949,1025,6.4
8299,2013,December,Brown                                                ,Not Adjusted,14939,15791,852,5.4
8300,2013,March,Burleson                                             ,Not Adjusted,7170,7642,472,6.2
8301,2013,June,Burleson                                             ,Not Adjusted,7024,7554,530,7.0
8302,2013,September,Burleson                                             ,Not Adjusted,7399,7879,480,6.1
8303,2013,December,Burleson                                             ,Not Adjusted,7406,7817,411,5.3
8304,2013,March,Burnet                                               ,Not Adjusted,19319,20474,1155,5.6
8305,2013,June,Burnet                                               ,Not Adjusted,19880,21141,1261,6.0
8306,2013,September,Burnet                                               ,Not Adjusted,19749,20912,1163,5.6
8307,2013,December,Burnet                                               ,Not Adjusted,19701,20659,958,4.6
8308,2013,March,Caldwell                                             ,Not Adjusted,15733,16920,1187,7.0
8309,2013,June,Caldwell                                             ,Not Adjusted,15966,17238,1272,7.4
8310,2013,September,Caldwell                                             ,Not Adjusted,16076,17176,1100,6.4
8311,2013,December,Caldwell                                             ,Not Adjusted,16250,17172,922,5.4
8312,2013,March,Calhoun                                              ,Not Adjusted,10395,11036,641,5.8
8313,2013,June,Calhoun                                              ,Not Adjusted,10027,10771,744,6.9
8314,2013,September,Calhoun                                              ,Not Adjusted,10176,10873,697,6.4
8315,2013,December,Calhoun                                              ,Not Adjusted,10147,10756,609,5.7
8316,2013,March,Callahan                                             ,Not Adjusted,5514,5853,339,5.8
8317,2013,June,Callahan                                             ,Not Adjusted,5543,5926,383,6.5
8318,2013,September,Callahan                                             ,Not Adjusted,5567,5910,343,5.8
8319,2013,December,Callahan                                             ,Not Adjusted,5614,5893,279,4.7
8320,2013,March,Cameron                                              ,Not Adjusted,148661,165416,16755,10.1
8321,2013,June,Cameron                                              ,Not Adjusted,150427,168604,18177,10.8
8322,2013,September,Cameron                                              ,Not Adjusted,150550,166928,16378,9.8
8323,2013,December,Cameron                                              ,Not Adjusted,151668,166816,15148,9.1
8324,2013,March,Camp                                                 ,Not Adjusted,5085,5488,403,7.3
8325,2013,June,Camp                                                 ,Not Adjusted,5136,5590,454,8.1
8326,2013,September,Camp                                                 ,Not Adjusted,5142,5554,412,7.4
8327,2013,December,Camp                                                 ,Not Adjusted,5091,5443,352,6.5
8328,2013,March,Carson                                               ,Not Adjusted,2964,3106,142,4.6
8329,2013,June,Carson                                               ,Not Adjusted,3065,3224,159,4.9
8330,2013,September,Carson                                               ,Not Adjusted,3048,3191,143,4.5
8331,2013,December,Carson                                               ,Not Adjusted,3042,3166,124,3.9
8332,2013,March,Cass                                                 ,Not Adjusted,11414,12585,1171,9.3
8333,2013,June,Cass                                                 ,Not Adjusted,11439,12683,1244,9.8
8334,2013,September,Cass                                                 ,Not Adjusted,11342,12524,1182,9.4
8335,2013,December,Cass                                                 ,Not Adjusted,11413,12459,1046,8.4
8336,2013,March,Castro                                               ,Not Adjusted,3487,3652,165,4.5
8337,2013,June,Castro                                               ,Not Adjusted,3758,3961,203,5.1
8338,2013,September,Castro                                               ,Not Adjusted,3650,3833,183,4.8
8339,2013,December,Castro                                               ,Not Adjusted,3584,3743,159,4.2
8340,2013,March,Chambers                                             ,Not Adjusted,16067,17340,1273,7.3
8341,2013,June,Chambers                                             ,Not Adjusted,16126,17518,1392,7.9
8342,2013,September,Chambers                                             ,Not Adjusted,16228,17521,1293,7.4
8343,2013,December,Chambers                                             ,Not Adjusted,16386,17517,1131,6.5
8344,2013,March,Cherokee                                             ,Not Adjusted,19997,21470,1473,6.9
8345,2013,June,Cherokee                                             ,Not Adjusted,20205,21826,1621,7.4
8346,2013,September,Cherokee                                             ,Not Adjusted,19978,21502,1524,7.1
8347,2013,December,Cherokee                                             ,Not Adjusted,19866,21205,1339,6.3
8348,2013,March,Childress                                            ,Not Adjusted,2738,2866,128,4.5
8349,2013,June,Childress                                            ,Not Adjusted,2863,3005,142,4.7
8350,2013,September,Childress                                            ,Not Adjusted,2824,2949,125,4.2
8351,2013,December,Childress                                            ,Not Adjusted,2796,2905,109,3.8
8352,2013,March,Clay                                                 ,Not Adjusted,4790,5069,279,5.5
8353,2013,June,Clay                                                 ,Not Adjusted,4906,5219,313,6.0
8354,2013,September,Clay                                                 ,Not Adjusted,4845,5133,288,5.6
8355,2013,December,Clay                                                 ,Not Adjusted,4850,5102,252,4.9
8356,2013,March,Cochran                                              ,Not Adjusted,1256,1356,100,7.4
8357,2013,June,Cochran                                              ,Not Adjusted,1380,1488,108,7.3
8358,2013,September,Cochran                                              ,Not Adjusted,1321,1411,90,6.4
8359,2013,December,Cochran                                              ,Not Adjusted,1292,1361,69,5.1
8360,2013,March,Coke                                                 ,Not Adjusted,1365,1429,64,4.5
8361,2013,June,Coke                                                 ,Not Adjusted,1394,1482,88,5.9
8362,2013,September,Coke                                                 ,Not Adjusted,1394,1473,79,5.4
8363,2013,December,Coke                                                 ,Not Adjusted,1378,1443,65,4.5
8364,2013,March,Coleman                                              ,Not Adjusted,2863,3104,241,7.8
8365,2013,June,Coleman                                              ,Not Adjusted,2915,3174,259,8.2
8366,2013,September,Coleman                                              ,Not Adjusted,2933,3164,231,7.3
8367,2013,December,Coleman                                              ,Not Adjusted,2935,3133,198,6.3
8368,2013,March,Collin                                               ,Not Adjusted,425909,451551,25642,5.7
8369,2013,June,Collin                                               ,Not Adjusted,430380,458326,27946,6.1
8370,2013,September,Collin                                               ,Not Adjusted,435181,460614,25433,5.5
8371,2013,December,Collin                                               ,Not Adjusted,439344,461356,22012,4.8
8372,2013,March,Collingsworth                                        ,Not Adjusted,1098,1156,58,5.0
8373,2013,June,Collingsworth                                        ,Not Adjusted,1178,1249,71,5.7
8374,2013,September,Collingsworth                                        ,Not Adjusted,1189,1254,65,5.2
8375,2013,December,Collingsworth                                        ,Not Adjusted,1161,1213,52,4.3
8376,2013,March,Colorado                                             ,Not Adjusted,9342,9942,600,6.0
8377,2013,June,Colorado                                             ,Not Adjusted,9792,10455,663,6.3
8378,2013,September,Colorado                                             ,Not Adjusted,9554,10141,587,5.8
8379,2013,December,Colorado                                             ,Not Adjusted,9522,10005,483,4.8
8380,2013,March,Comal                                                ,Not Adjusted,53821,57669,3848,6.7
8381,2013,June,Comal                                                ,Not Adjusted,54401,58305,3904,6.7
8382,2013,September,Comal                                                ,Not Adjusted,54622,58000,3378,5.8
8383,2013,December,Comal                                                ,Not Adjusted,54948,57786,2838,4.9
8384,2013,March,Comanche                                             ,Not Adjusted,5279,5605,326,5.8
8385,2013,June,Comanche                                             ,Not Adjusted,5417,5800,383,6.6
8386,2013,September,Comanche                                             ,Not Adjusted,5322,5651,329,5.8
8387,2013,December,Comanche                                             ,Not Adjusted,5275,5554,279,5.0
8388,2013,March,Concho                                               ,Not Adjusted,1345,1405,60,4.3
8389,2013,June,Concho                                               ,Not Adjusted,1481,1543,62,4.0
8390,2013,September,Concho                                               ,Not Adjusted,1401,1461,60,4.1
8391,2013,December,Concho                                               ,Not Adjusted,1355,1407,52,3.7
8392,2013,March,Cooke                                                ,Not Adjusted,19351,20385,1034,5.1
8393,2013,June,Cooke                                                ,Not Adjusted,19433,20589,1156,5.6
8394,2013,September,Cooke                                                ,Not Adjusted,19493,20516,1023,5.0
8395,2013,December,Cooke                                                ,Not Adjusted,19470,20326,856,4.2
8396,2013,March,Coryell                                              ,Not Adjusted,23204,24972,1768,7.1
8397,2013,June,Coryell                                              ,Not Adjusted,23248,25263,2015,8.0
8398,2013,September,Coryell                                              ,Not Adjusted,23506,25385,1879,7.4
8399,2013,December,Coryell                                              ,Not Adjusted,23516,25081,1565,6.2
8400,2013,March,Cottle                                               ,Not Adjusted,549,588,39,6.6
8401,2013,June,Cottle                                               ,Not Adjusted,592,641,49,7.6
8402,2013,September,Cottle                                               ,Not Adjusted,587,633,46,7.3
8403,2013,December,Cottle                                               ,Not Adjusted,596,625,29,4.6
8404,2013,March,Crane                                                ,Not Adjusted,1969,2067,98,4.7
8405,2013,June,Crane                                                ,Not Adjusted,1984,2094,110,5.3
8406,2013,September,Crane                                                ,Not Adjusted,2042,2132,90,4.2
8407,2013,December,Crane                                                ,Not Adjusted,1969,2044,75,3.7
8408,2013,March,Crockett                                             ,Not Adjusted,1746,1834,88,4.8
8409,2013,June,Crockett                                             ,Not Adjusted,1823,1937,114,5.9
8410,2013,September,Crockett                                             ,Not Adjusted,1839,1942,103,5.3
8411,2013,December,Crockett                                             ,Not Adjusted,1701,1785,84,4.7
8412,2013,March,Crosby                                               ,Not Adjusted,2495,2678,183,6.8
8413,2013,June,Crosby                                               ,Not Adjusted,2656,2841,185,6.5
8414,2013,September,Crosby                                               ,Not Adjusted,2648,2803,155,5.5
8415,2013,December,Crosby                                               ,Not Adjusted,2611,2734,123,4.5
8416,2013,March,Culberson                                            ,Not Adjusted,963,1016,53,5.2
8417,2013,June,Culberson                                            ,Not Adjusted,987,1045,58,5.6
8418,2013,September,Culberson                                            ,Not Adjusted,1004,1057,53,5.0
8419,2013,December,Culberson                                            ,Not Adjusted,951,991,40,4.0
8420,2013,March,Dallam                                               ,Not Adjusted,3655,3787,132,3.5
8421,2013,June,Dallam                                               ,Not Adjusted,3887,4041,154,3.8
8422,2013,September,Dallam                                               ,Not Adjusted,3773,3915,142,3.6
8423,2013,December,Dallam                                               ,Not Adjusted,3680,3800,120,3.2
8424,2013,March,Dallas                                               ,Not Adjusted,1135760,1218088,82328,6.8
8425,2013,June,Dallas                                               ,Not Adjusted,1147377,1235731,88354,7.1
8426,2013,September,Dallas                                               ,Not Adjusted,1160416,1242181,81765,6.6
8427,2013,December,Dallas                                               ,Not Adjusted,1171865,1242795,70930,5.7
8428,2013,March,Dawson                                               ,Not Adjusted,4604,4912,308,6.3
8429,2013,June,Dawson                                               ,Not Adjusted,4642,5017,375,7.5
8430,2013,September,Dawson                                               ,Not Adjusted,4707,5040,333,6.6
8431,2013,December,Dawson                                               ,Not Adjusted,4853,5123,270,5.3
8432,2013,March,Deaf Smith                                           ,Not Adjusted,8470,8873,403,4.5
8433,2013,June,Deaf Smith                                           ,Not Adjusted,8963,9432,469,5.0
8434,2013,September,Deaf Smith                                           ,Not Adjusted,8836,9237,401,4.3
8435,2013,December,Deaf Smith                                           ,Not Adjusted,8703,9053,350,3.9
8436,2013,March,Delta                                                ,Not Adjusted,2454,2616,162,6.2
8437,2013,June,Delta                                                ,Not Adjusted,2493,2679,186,6.9
8438,2013,September,Delta                                                ,Not Adjusted,2495,2662,167,6.3
8439,2013,December,Delta                                                ,Not Adjusted,2485,2626,141,5.4
8440,2013,March,Denton                                               ,Not Adjusted,373213,395026,21813,5.5
8441,2013,June,Denton                                               ,Not Adjusted,377127,400995,23868,6.0
8442,2013,September,Denton                                               ,Not Adjusted,381290,402802,21512,5.3
8443,2013,December,Denton                                               ,Not Adjusted,384866,403408,18542,4.6
8444,2013,March,DeWitt                                               ,Not Adjusted,9172,9609,437,4.5
8445,2013,June,DeWitt                                               ,Not Adjusted,9303,9826,523,5.3
8446,2013,September,DeWitt                                               ,Not Adjusted,9151,9624,473,4.9
8447,2013,December,DeWitt                                               ,Not Adjusted,9268,9658,390,4.0
8448,2013,March,Dickens                                              ,Not Adjusted,676,752,76,10.1
8449,2013,June,Dickens                                              ,Not Adjusted,726,804,78,9.7
8450,2013,September,Dickens                                              ,Not Adjusted,705,779,74,9.5
8451,2013,December,Dickens                                              ,Not Adjusted,692,751,59,7.9
8452,2013,March,Dimmit                                               ,Not Adjusted,6151,6486,335,5.2
8453,2013,June,Dimmit                                               ,Not Adjusted,6333,6728,395,5.9
8454,2013,September,Dimmit                                               ,Not Adjusted,6762,7079,317,4.5
8455,2013,December,Dimmit                                               ,Not Adjusted,6923,7213,290,4.0
8456,2013,March,Donley                                               ,Not Adjusted,2027,2124,97,4.6
8457,2013,June,Donley                                               ,Not Adjusted,2248,2366,118,5.0
8458,2013,September,Donley                                               ,Not Adjusted,1681,1788,107,6.0
8459,2013,December,Donley                                               ,Not Adjusted,1564,1647,83,5.0
8460,2013,March,Duval                                                ,Not Adjusted,5122,5476,354,6.5
8461,2013,June,Duval                                                ,Not Adjusted,5241,5641,400,7.1
8462,2013,September,Duval                                                ,Not Adjusted,5216,5568,352,6.3
8463,2013,December,Duval                                                ,Not Adjusted,5157,5469,312,5.7
8464,2013,March,Eastland                                             ,Not Adjusted,7777,8298,521,6.3
8465,2013,June,Eastland                                             ,Not Adjusted,7937,8549,612,7.2
8466,2013,September,Eastland                                             ,Not Adjusted,8142,8652,510,5.9
8467,2013,December,Eastland                                             ,Not Adjusted,8067,8512,445,5.2
8468,2013,March,Ector                                                ,Not Adjusted,74477,77791,3314,4.3
8469,2013,June,Ector                                                ,Not Adjusted,74581,78511,3930,5.0
8470,2013,September,Ector                                                ,Not Adjusted,75603,79037,3434,4.3
8471,2013,December,Ector                                                ,Not Adjusted,76220,79196,2976,3.8
8472,2013,March,Edwards                                              ,Not Adjusted,812,868,56,6.5
8473,2013,June,Edwards                                              ,Not Adjusted,899,959,60,6.3
8474,2013,September,Edwards                                              ,Not Adjusted,839,887,48,5.4
8475,2013,December,Edwards                                              ,Not Adjusted,842,887,45,5.1
8476,2013,March,Ellis                                                ,Not Adjusted,71695,76643,4948,6.5
8477,2013,June,Ellis                                                ,Not Adjusted,72546,77864,5318,6.8
8478,2013,September,Ellis                                                ,Not Adjusted,73338,78024,4686,6.0
8479,2013,December,Ellis                                                ,Not Adjusted,74025,78107,4082,5.2
8480,2013,March,El Paso                                              ,Not Adjusted,317826,345757,27931,8.1
8481,2013,June,El Paso                                              ,Not Adjusted,315694,346013,30319,8.8
8482,2013,September,El Paso                                              ,Not Adjusted,320421,347520,27099,7.8
8483,2013,December,El Paso                                              ,Not Adjusted,322948,346804,23856,6.9
8484,2013,March,Erath                                                ,Not Adjusted,18400,19430,1030,5.3
8485,2013,June,Erath                                                ,Not Adjusted,18696,19947,1251,6.3
8486,2013,September,Erath                                                ,Not Adjusted,19131,20211,1080,5.3
8487,2013,December,Erath                                                ,Not Adjusted,18927,19820,893,4.5
8488,2013,March,Falls                                                ,Not Adjusted,6189,6641,452,6.8
8489,2013,June,Falls                                                ,Not Adjusted,6358,6903,545,7.9
8490,2013,September,Falls                                                ,Not Adjusted,6354,6846,492,7.2
8491,2013,December,Falls                                                ,Not Adjusted,6273,6676,403,6.0
8492,2013,March,Fannin                                               ,Not Adjusted,14015,15138,1123,7.4
8493,2013,June,Fannin                                               ,Not Adjusted,14240,15387,1147,7.5
8494,2013,September,Fannin                                               ,Not Adjusted,14346,15394,1048,6.8
8495,2013,December,Fannin                                               ,Not Adjusted,14302,15195,893,5.9
8496,2013,March,Fayette                                              ,Not Adjusted,11802,12376,574,4.6
8497,2013,June,Fayette                                              ,Not Adjusted,12188,12827,639,5.0
8498,2013,September,Fayette                                              ,Not Adjusted,12209,12787,578,4.5
8499,2013,December,Fayette                                              ,Not Adjusted,12206,12672,466,3.7
8500,2013,March,Fisher                                               ,Not Adjusted,1732,1832,100,5.5
8501,2013,June,Fisher                                               ,Not Adjusted,1807,1928,121,6.3
8502,2013,September,Fisher                                               ,Not Adjusted,1793,1898,105,5.5
8503,2013,December,Fisher                                               ,Not Adjusted,1802,1886,84,4.5
8504,2013,March,Floyd                                                ,Not Adjusted,2817,3075,258,8.4
8505,2013,June,Floyd                                                ,Not Adjusted,2931,3245,314,9.7
8506,2013,September,Floyd                                                ,Not Adjusted,2828,3113,285,9.2
8507,2013,December,Floyd                                                ,Not Adjusted,2773,3015,242,8.0
8508,2013,March,Foard                                                ,Not Adjusted,548,579,31,5.4
8509,2013,June,Foard                                                ,Not Adjusted,561,594,33,5.6
8510,2013,September,Foard                                                ,Not Adjusted,550,578,28,4.8
8511,2013,December,Foard                                                ,Not Adjusted,536,559,23,4.1
8512,2013,March,Fort Bend                                            ,Not Adjusted,312230,330364,18134,5.5
8513,2013,June,Fort Bend                                            ,Not Adjusted,313457,333764,20307,6.1
8514,2013,September,Fort Bend                                            ,Not Adjusted,315495,334086,18591,5.6
8515,2013,December,Fort Bend                                            ,Not Adjusted,318608,334536,15928,4.8
8516,2013,March,Franklin                                             ,Not Adjusted,4328,4638,310,6.7
8517,2013,June,Franklin                                             ,Not Adjusted,4360,4699,339,7.2
8518,2013,September,Franklin                                             ,Not Adjusted,4452,4750,298,6.3
8519,2013,December,Franklin                                             ,Not Adjusted,4432,4688,256,5.5
8520,2013,March,Freestone                                            ,Not Adjusted,7247,7783,536,6.9
8521,2013,June,Freestone                                            ,Not Adjusted,7468,8075,607,7.5
8522,2013,September,Freestone                                            ,Not Adjusted,7327,7885,558,7.1
8523,2013,December,Freestone                                            ,Not Adjusted,7210,7663,453,5.9
8524,2013,March,Frio                                                 ,Not Adjusted,8433,8838,405,4.6
8525,2013,June,Frio                                                 ,Not Adjusted,8797,9306,509,5.5
8526,2013,September,Frio                                                 ,Not Adjusted,9080,9521,441,4.6
8527,2013,December,Frio                                                 ,Not Adjusted,9382,9764,382,3.9
8528,2013,March,Gaines                                               ,Not Adjusted,8213,8577,364,4.2
8529,2013,June,Gaines                                               ,Not Adjusted,8609,9048,439,4.9
8530,2013,September,Gaines                                               ,Not Adjusted,8686,9069,383,4.2
8531,2013,December,Gaines                                               ,Not Adjusted,8754,9063,309,3.4
8532,2013,March,Galveston                                            ,Not Adjusted,143699,154497,10798,7.0
8533,2013,June,Galveston                                            ,Not Adjusted,144424,156198,11774,7.5
8534,2013,September,Galveston                                            ,Not Adjusted,145320,156056,10736,6.9
8535,2013,December,Galveston                                            ,Not Adjusted,146702,155910,9208,5.9
8536,2013,March,Garza                                                ,Not Adjusted,2067,2161,94,4.3
8537,2013,June,Garza                                                ,Not Adjusted,2125,2243,118,5.3
8538,2013,September,Garza                                                ,Not Adjusted,2187,2288,101,4.4
8539,2013,December,Garza                                                ,Not Adjusted,2148,2236,88,3.9
8540,2013,March,Gillespie                                            ,Not Adjusted,11654,12194,540,4.4
8541,2013,June,Gillespie                                            ,Not Adjusted,12010,12627,617,4.9
8542,2013,September,Gillespie                                            ,Not Adjusted,11889,12452,563,4.5
8543,2013,December,Gillespie                                            ,Not Adjusted,12099,12554,455,3.6
8544,2013,March,Glasscock                                            ,Not Adjusted,658,683,25,3.7
8545,2013,June,Glasscock                                            ,Not Adjusted,749,781,32,4.1
8546,2013,September,Glasscock                                            ,Not Adjusted,740,766,26,3.4
8547,2013,December,Glasscock                                            ,Not Adjusted,740,763,23,3.0
8548,2013,March,Goliad                                               ,Not Adjusted,3280,3459,179,5.2
8549,2013,June,Goliad                                               ,Not Adjusted,3355,3568,213,6.0
8550,2013,September,Goliad                                               ,Not Adjusted,3387,3574,187,5.2
8551,2013,December,Goliad                                               ,Not Adjusted,3391,3538,147,4.2
8552,2013,March,Gonzales                                             ,Not Adjusted,8636,9125,489,5.4
8553,2013,June,Gonzales                                             ,Not Adjusted,9190,9743,553,5.7
8554,2013,September,Gonzales                                             ,Not Adjusted,9222,9708,486,5.0
8555,2013,December,Gonzales                                             ,Not Adjusted,9155,9571,416,4.3
8556,2013,March,Gray                                                 ,Not Adjusted,9090,9592,502,5.2
8557,2013,June,Gray                                                 ,Not Adjusted,9381,9952,571,5.7
8558,2013,September,Gray                                                 ,Not Adjusted,9366,9872,506,5.1
8559,2013,December,Gray                                                 ,Not Adjusted,9266,9691,425,4.4
8560,2013,March,Grayson                                              ,Not Adjusted,55846,59742,3896,6.5
8561,2013,June,Grayson                                              ,Not Adjusted,56674,60867,4193,6.9
8562,2013,September,Grayson                                              ,Not Adjusted,57072,60839,3767,6.2
8563,2013,December,Grayson                                              ,Not Adjusted,57257,60435,3178,5.3
8564,2013,March,Gregg                                                ,Not Adjusted,58314,61954,3640,5.9
8565,2013,June,Gregg                                                ,Not Adjusted,57703,61742,4039,6.5
8566,2013,September,Gregg                                                ,Not Adjusted,57526,61208,3682,6.0
8567,2013,December,Gregg                                                ,Not Adjusted,57638,60845,3207,5.3
8568,2013,March,Grimes                                               ,Not Adjusted,11002,11716,714,6.1
8569,2013,June,Grimes                                               ,Not Adjusted,11153,11971,818,6.8
8570,2013,September,Grimes                                               ,Not Adjusted,11189,11912,723,6.1
8571,2013,December,Grimes                                               ,Not Adjusted,11122,11727,605,5.2
8572,2013,March,Guadalupe                                            ,Not Adjusted,65540,69549,4009,5.8
8573,2013,June,Guadalupe                                            ,Not Adjusted,66263,70573,4310,6.1
8574,2013,September,Guadalupe                                            ,Not Adjusted,66459,70285,3826,5.4
8575,2013,December,Guadalupe                                            ,Not Adjusted,66762,70022,3260,4.7
8576,2013,March,Hale                                                 ,Not Adjusted,13772,15896,2124,13.4
8577,2013,June,Hale                                                 ,Not Adjusted,12455,14874,2419,16.3
8578,2013,September,Hale                                                 ,Not Adjusted,12544,14534,1990,13.7
8579,2013,December,Hale                                                 ,Not Adjusted,12328,13936,1608,11.5
8580,2013,March,Hall                                                 ,Not Adjusted,1184,1277,93,7.3
8581,2013,June,Hall                                                 ,Not Adjusted,1249,1349,100,7.4
8582,2013,September,Hall                                                 ,Not Adjusted,1208,1297,89,6.9
8583,2013,December,Hall                                                 ,Not Adjusted,1161,1243,82,6.6
8584,2013,March,Hamilton                                             ,Not Adjusted,3369,3578,209,5.8
8585,2013,June,Hamilton                                             ,Not Adjusted,3465,3715,250,6.7
8586,2013,September,Hamilton                                             ,Not Adjusted,3418,3641,223,6.1
8587,2013,December,Hamilton                                             ,Not Adjusted,3334,3518,184,5.2
8588,2013,March,Hansford                                             ,Not Adjusted,2930,3032,102,3.4
8589,2013,June,Hansford                                             ,Not Adjusted,3133,3250,117,3.6
8590,2013,September,Hansford                                             ,Not Adjusted,3028,3131,103,3.3
8591,2013,December,Hansford                                             ,Not Adjusted,3063,3147,84,2.7
8592,2013,March,Hardeman                                             ,Not Adjusted,1589,1693,104,6.1
8593,2013,June,Hardeman                                             ,Not Adjusted,1652,1756,104,5.9
8594,2013,September,Hardeman                                             ,Not Adjusted,1593,1688,95,5.6
8595,2013,December,Hardeman                                             ,Not Adjusted,1560,1648,88,5.3
8596,2013,March,Hardin                                               ,Not Adjusted,23443,25502,2059,8.1
8597,2013,June,Hardin                                               ,Not Adjusted,23212,25449,2237,8.8
8598,2013,September,Hardin                                               ,Not Adjusted,23033,25042,2009,8.0
8599,2013,December,Hardin                                               ,Not Adjusted,23243,25036,1793,7.2
8600,2013,March,Harris                                               ,Not Adjusted,2047557,2180167,132610,6.1
8601,2013,June,Harris                                               ,Not Adjusted,2055767,2201830,146063,6.6
8602,2013,September,Harris                                               ,Not Adjusted,2069548,2203544,133996,6.1
8603,2013,December,Harris                                               ,Not Adjusted,2090496,2206771,116275,5.3
8604,2013,March,Harrison                                             ,Not Adjusted,30037,32222,2185,6.8
8605,2013,June,Harrison                                             ,Not Adjusted,30040,32446,2406,7.4
8606,2013,September,Harrison                                             ,Not Adjusted,30066,32326,2260,7.0
8607,2013,December,Harrison                                             ,Not Adjusted,29982,31888,1906,6.0
8608,2013,March,Hartley                                              ,Not Adjusted,2783,2873,90,3.1
8609,2013,June,Hartley                                              ,Not Adjusted,2926,3032,106,3.5
8610,2013,September,Hartley                                              ,Not Adjusted,2832,2929,97,3.3
8611,2013,December,Hartley                                              ,Not Adjusted,2786,2863,77,2.7
8612,2013,March,Haskell                                              ,Not Adjusted,2531,2668,137,5.1
8613,2013,June,Haskell                                              ,Not Adjusted,2614,2764,150,5.4
8614,2013,September,Haskell                                              ,Not Adjusted,2582,2720,138,5.1
8615,2013,December,Haskell                                              ,Not Adjusted,2572,2677,105,3.9
8616,2013,March,Hays                                                 ,Not Adjusted,83816,88613,4797,5.4
8617,2013,June,Hays                                                 ,Not Adjusted,84797,90190,5393,6.0
8618,2013,September,Hays                                                 ,Not Adjusted,85450,90245,4795,5.3
8619,2013,December,Hays                                                 ,Not Adjusted,86450,90486,4036,4.5
8620,2013,March,Hemphill                                             ,Not Adjusted,2330,2407,77,3.2
8621,2013,June,Hemphill                                             ,Not Adjusted,2439,2524,85,3.4
8622,2013,September,Hemphill                                             ,Not Adjusted,2373,2450,77,3.1
8623,2013,December,Hemphill                                             ,Not Adjusted,2415,2478,63,2.5
8624,2013,March,Henderson                                            ,Not Adjusted,31696,34195,2499,7.3
8625,2013,June,Henderson                                            ,Not Adjusted,32147,34834,2687,7.7
8626,2013,September,Henderson                                            ,Not Adjusted,32181,34689,2508,7.2
8627,2013,December,Henderson                                            ,Not Adjusted,32269,34370,2101,6.1
8628,2013,March,Hidalgo                                              ,Not Adjusted,294928,328894,33966,10.3
8629,2013,June,Hidalgo                                              ,Not Adjusted,295677,332549,36872,11.1
8630,2013,September,Hidalgo                                              ,Not Adjusted,295655,329299,33644,10.2
8631,2013,December,Hidalgo                                              ,Not Adjusted,303063,335740,32677,9.7
8632,2013,March,Hill                                                 ,Not Adjusted,14820,15829,1009,6.4
8633,2013,June,Hill                                                 ,Not Adjusted,15052,16220,1168,7.2
8634,2013,September,Hill                                                 ,Not Adjusted,14987,15993,1006,6.3
8635,2013,December,Hill                                                 ,Not Adjusted,14830,15728,898,5.7
8636,2013,March,Hockley                                              ,Not Adjusted,11199,11804,605,5.1
8637,2013,June,Hockley                                              ,Not Adjusted,11480,12162,682,5.6
8638,2013,September,Hockley                                              ,Not Adjusted,11365,11965,600,5.0
8639,2013,December,Hockley                                              ,Not Adjusted,11256,11756,500,4.3
8640,2013,March,Hood                                                 ,Not Adjusted,22229,23658,1429,6.0
8641,2013,June,Hood                                                 ,Not Adjusted,22556,24177,1621,6.7
8642,2013,September,Hood                                                 ,Not Adjusted,22682,24158,1476,6.1
8643,2013,December,Hood                                                 ,Not Adjusted,22779,24035,1256,5.2
8644,2013,March,Hopkins                                              ,Not Adjusted,16443,17416,973,5.6
8645,2013,June,Hopkins                                              ,Not Adjusted,16246,17367,1121,6.5
8646,2013,September,Hopkins                                              ,Not Adjusted,16262,17302,1040,6.0
8647,2013,December,Hopkins                                              ,Not Adjusted,16233,17077,844,4.9
8648,2013,March,Houston                                              ,Not Adjusted,9177,9815,638,6.5
8649,2013,June,Houston                                              ,Not Adjusted,9346,10035,689,6.9
8650,2013,September,Houston                                              ,Not Adjusted,9127,9735,608,6.2
8651,2013,December,Houston                                              ,Not Adjusted,9190,9690,500,5.2
8652,2013,March,Howard                                               ,Not Adjusted,12744,13455,711,5.3
8653,2013,June,Howard                                               ,Not Adjusted,12862,13694,832,6.1
8654,2013,September,Howard                                               ,Not Adjusted,12857,13602,745,5.5
8655,2013,December,Howard                                               ,Not Adjusted,12795,13447,652,4.8
8656,2013,March,Hudspeth                                             ,Not Adjusted,1168,1264,96,7.6
8657,2013,June,Hudspeth                                             ,Not Adjusted,1218,1318,100,7.6
8658,2013,September,Hudspeth                                             ,Not Adjusted,1219,1306,87,6.7
8659,2013,December,Hudspeth                                             ,Not Adjusted,1212,1290,78,6.0
8660,2013,March,Hunt                                                 ,Not Adjusted,34737,37640,2903,7.7
8661,2013,June,Hunt                                                 ,Not Adjusted,35199,38373,3174,8.3
8662,2013,September,Hunt                                                 ,Not Adjusted,35571,38357,2786,7.3
8663,2013,December,Hunt                                                 ,Not Adjusted,35893,38273,2380,6.2
8664,2013,March,Hutchinson                                           ,Not Adjusted,8983,9601,618,6.4
8665,2013,June,Hutchinson                                           ,Not Adjusted,9154,9820,666,6.8
8666,2013,September,Hutchinson                                           ,Not Adjusted,9118,9716,598,6.2
8667,2013,December,Hutchinson                                           ,Not Adjusted,9469,9986,517,5.2
8668,2013,March,Irion                                                ,Not Adjusted,795,827,32,3.9
8669,2013,June,Irion                                                ,Not Adjusted,823,863,40,4.6
8670,2013,September,Irion                                                ,Not Adjusted,822,862,40,4.6
8671,2013,December,Irion                                                ,Not Adjusted,816,849,33,3.9
8672,2013,March,Jack                                                 ,Not Adjusted,3754,3975,221,5.6
8673,2013,June,Jack                                                 ,Not Adjusted,3790,4026,236,5.9
8674,2013,September,Jack                                                 ,Not Adjusted,3813,4021,208,5.2
8675,2013,December,Jack                                                 ,Not Adjusted,3847,4027,180,4.5
8676,2013,March,Jackson                                              ,Not Adjusted,6936,7312,376,5.1
8677,2013,June,Jackson                                              ,Not Adjusted,7118,7552,434,5.7
8678,2013,September,Jackson                                              ,Not Adjusted,7135,7506,371,4.9
8679,2013,December,Jackson                                              ,Not Adjusted,7133,7454,321,4.3
8680,2013,March,Jasper                                               ,Not Adjusted,12960,14503,1543,10.6
8681,2013,June,Jasper                                               ,Not Adjusted,12996,14648,1652,11.3
8682,2013,September,Jasper                                               ,Not Adjusted,12927,14428,1501,10.4
8683,2013,December,Jasper                                               ,Not Adjusted,13156,14521,1365,9.4
8684,2013,March,Jeff Davis                                           ,Not Adjusted,1079,1130,51,4.5
8685,2013,June,Jeff Davis                                           ,Not Adjusted,1158,1209,51,4.2
8686,2013,September,Jeff Davis                                           ,Not Adjusted,1112,1158,46,4.0
8687,2013,December,Jeff Davis                                           ,Not Adjusted,1125,1172,47,4.0
8688,2013,March,Jefferson                                            ,Not Adjusted,99867,112009,12142,10.8
8689,2013,June,Jefferson                                            ,Not Adjusted,98944,111894,12950,11.6
8690,2013,September,Jefferson                                            ,Not Adjusted,98187,110069,11882,10.8
8691,2013,December,Jefferson                                            ,Not Adjusted,99086,109912,10826,9.8
8692,2013,March,Jim Hogg                                             ,Not Adjusted,2175,2335,160,6.9
8693,2013,June,Jim Hogg                                             ,Not Adjusted,2119,2304,185,8.0
8694,2013,September,Jim Hogg                                             ,Not Adjusted,2126,2301,175,7.6
8695,2013,December,Jim Hogg                                             ,Not Adjusted,2153,2300,147,6.4
8696,2013,March,Jim Wells                                            ,Not Adjusted,18917,20123,1206,6.0
8697,2013,June,Jim Wells                                            ,Not Adjusted,18967,20353,1386,6.8
8698,2013,September,Jim Wells                                            ,Not Adjusted,18787,20048,1261,6.3
8699,2013,December,Jim Wells                                            ,Not Adjusted,18778,19866,1088,5.5
8700,2013,March,Johnson                                              ,Not Adjusted,68376,72982,4606,6.3
8701,2013,June,Johnson                                              ,Not Adjusted,69117,74179,5062,6.8
8702,2013,September,Johnson                                              ,Not Adjusted,69516,73964,4448,6.0
8703,2013,December,Johnson                                              ,Not Adjusted,69800,73670,3870,5.3
8704,2013,March,Jones                                                ,Not Adjusted,5366,5750,384,6.7
8705,2013,June,Jones                                                ,Not Adjusted,5467,5912,445,7.5
8706,2013,September,Jones                                                ,Not Adjusted,5464,5864,400,6.8
8707,2013,December,Jones                                                ,Not Adjusted,5478,5825,347,6.0
8708,2013,March,Karnes                                               ,Not Adjusted,5215,5527,312,5.6
8709,2013,June,Karnes                                               ,Not Adjusted,5282,5637,355,6.3
8710,2013,September,Karnes                                               ,Not Adjusted,5355,5654,299,5.3
8711,2013,December,Karnes                                               ,Not Adjusted,5444,5695,251,4.4
8712,2013,March,Kaufman                                              ,Not Adjusted,48363,51781,3418,6.6
8713,2013,June,Kaufman                                              ,Not Adjusted,48899,52597,3698,7.0
8714,2013,September,Kaufman                                              ,Not Adjusted,49429,52731,3302,6.3
8715,2013,December,Kaufman                                              ,Not Adjusted,49880,52757,2877,5.5
8716,2013,March,Kendall                                              ,Not Adjusted,17019,17951,932,5.2
8717,2013,June,Kendall                                              ,Not Adjusted,17366,18411,1045,5.7
8718,2013,September,Kendall                                              ,Not Adjusted,17404,18354,950,5.2
8719,2013,December,Kendall                                              ,Not Adjusted,17470,18260,790,4.3
8720,2013,March,Kenedy                                               ,Not Adjusted,258,269,11,4.1
8721,2013,June,Kenedy                                               ,Not Adjusted,294,306,12,3.9
8722,2013,September,Kenedy                                               ,Not Adjusted,291,307,16,5.2
8723,2013,December,Kenedy                                               ,Not Adjusted,298,310,12,3.9
8724,2013,March,Kent                                                 ,Not Adjusted,491,511,20,3.9
8725,2013,June,Kent                                                 ,Not Adjusted,541,564,23,4.1
8726,2013,September,Kent                                                 ,Not Adjusted,499,522,23,4.4
8727,2013,December,Kent                                                 ,Not Adjusted,496,515,19,3.7
8728,2013,March,Kerr                                                 ,Not Adjusted,19954,21122,1168,5.5
8729,2013,June,Kerr                                                 ,Not Adjusted,20616,21941,1325,6.0
8730,2013,September,Kerr                                                 ,Not Adjusted,20110,21321,1211,5.7
8731,2013,December,Kerr                                                 ,Not Adjusted,20436,21445,1009,4.7
8732,2013,March,Kimble                                               ,Not Adjusted,1978,2076,98,4.7
8733,2013,June,Kimble                                               ,Not Adjusted,2103,2225,122,5.5
8734,2013,September,Kimble                                               ,Not Adjusted,2096,2205,109,4.9
8735,2013,December,Kimble                                               ,Not Adjusted,2048,2140,92,4.3
8736,2013,March,King                                                 ,Not Adjusted,206,215,9,4.2
8737,2013,June,King                                                 ,Not Adjusted,249,259,10,3.9
8738,2013,September,King                                                 ,Not Adjusted,238,249,11,4.4
8739,2013,December,King                                                 ,Not Adjusted,223,236,13,5.5
8740,2013,March,Kinney                                               ,Not Adjusted,1086,1203,117,9.7
8741,2013,June,Kinney                                               ,Not Adjusted,1117,1238,121,9.8
8742,2013,September,Kinney                                               ,Not Adjusted,1112,1225,113,9.2
8743,2013,December,Kinney                                               ,Not Adjusted,1098,1207,109,9.0
8744,2013,March,Kleberg                                              ,Not Adjusted,14332,15321,989,6.5
8745,2013,June,Kleberg                                              ,Not Adjusted,14100,15262,1162,7.6
8746,2013,September,Kleberg                                              ,Not Adjusted,14733,15719,986,6.3
8747,2013,December,Kleberg                                              ,Not Adjusted,14529,15373,844,5.5
8748,2013,March,Knox                                                 ,Not Adjusted,1608,1698,90,5.3
8749,2013,June,Knox                                                 ,Not Adjusted,1720,1821,101,5.5
8750,2013,September,Knox                                                 ,Not Adjusted,1682,1777,95,5.3
8751,2013,December,Knox                                                 ,Not Adjusted,1664,1745,81,4.6
8752,2013,March,Lamar                                                ,Not Adjusted,20445,22302,1857,8.3
8753,2013,June,Lamar                                                ,Not Adjusted,20472,22438,1966,8.8
8754,2013,September,Lamar                                                ,Not Adjusted,20492,22238,1746,7.9
8755,2013,December,Lamar                                                ,Not Adjusted,20564,22091,1527,6.9
8756,2013,March,Lamb                                                 ,Not Adjusted,5533,5972,439,7.4
8757,2013,June,Lamb                                                 ,Not Adjusted,5855,6339,484,7.6
8758,2013,September,Lamb                                                 ,Not Adjusted,5828,6235,407,6.5
8759,2013,December,Lamb                                                 ,Not Adjusted,5658,6002,344,5.7
8760,2013,March,Lampasas                                             ,Not Adjusted,8370,9000,630,7.0
8761,2013,June,Lampasas                                             ,Not Adjusted,8439,9156,717,7.8
8762,2013,September,Lampasas                                             ,Not Adjusted,8521,9198,677,7.4
8763,2013,December,Lampasas                                             ,Not Adjusted,8520,9108,588,6.5
8764,2013,March,La Salle                                             ,Not Adjusted,3824,3982,158,4.0
8765,2013,June,La Salle                                             ,Not Adjusted,3962,4142,180,4.3
8766,2013,September,La Salle                                             ,Not Adjusted,4149,4299,150,3.5
8767,2013,December,La Salle                                             ,Not Adjusted,4174,4313,139,3.2
8768,2013,March,Lavaca                                               ,Not Adjusted,8703,9132,429,4.7
8769,2013,June,Lavaca                                               ,Not Adjusted,8879,9375,496,5.3
8770,2013,September,Lavaca                                               ,Not Adjusted,8803,9243,440,4.8
8771,2013,December,Lavaca                                               ,Not Adjusted,8810,9178,368,4.0
8772,2013,March,Lee                                                  ,Not Adjusted,8754,9226,472,5.1
8773,2013,June,Lee                                                  ,Not Adjusted,8548,9062,514,5.7
8774,2013,September,Lee                                                  ,Not Adjusted,8685,9154,469,5.1
8775,2013,December,Lee                                                  ,Not Adjusted,8314,8714,400,4.6
8776,2013,March,Leon                                                 ,Not Adjusted,6273,6761,488,7.2
8777,2013,June,Leon                                                 ,Not Adjusted,6552,7084,532,7.5
8778,2013,September,Leon                                                 ,Not Adjusted,6550,7030,480,6.8
8779,2013,December,Leon                                                 ,Not Adjusted,6748,7155,407,5.7
8780,2013,March,Liberty                                              ,Not Adjusted,27958,30692,2734,8.9
8781,2013,June,Liberty                                              ,Not Adjusted,28182,31159,2977,9.6
8782,2013,September,Liberty                                              ,Not Adjusted,28337,31109,2772,8.9
8783,2013,December,Liberty                                              ,Not Adjusted,28586,31052,2466,7.9
8784,2013,March,Limestone                                            ,Not Adjusted,8811,9385,574,6.1
8785,2013,June,Limestone                                            ,Not Adjusted,8852,9523,671,7.0
8786,2013,September,Limestone                                            ,Not Adjusted,8827,9538,711,7.5
8787,2013,December,Limestone                                            ,Not Adjusted,8821,9414,593,6.3
8788,2013,March,Lipscomb                                             ,Not Adjusted,1646,1710,64,3.7
8789,2013,June,Lipscomb                                             ,Not Adjusted,1702,1782,80,4.5
8790,2013,September,Lipscomb                                             ,Not Adjusted,1656,1726,70,4.1
8791,2013,December,Lipscomb                                             ,Not Adjusted,1649,1707,58,3.4
8792,2013,March,Live Oak                                             ,Not Adjusted,5693,5956,263,4.4
8793,2013,June,Live Oak                                             ,Not Adjusted,5810,6108,298,4.9
8794,2013,September,Live Oak                                             ,Not Adjusted,5805,6074,269,4.4
8795,2013,December,Live Oak                                             ,Not Adjusted,5865,6096,231,3.8
8796,2013,March,Llano                                                ,Not Adjusted,7535,8064,529,6.6
8797,2013,June,Llano                                                ,Not Adjusted,7776,8347,571,6.8
8798,2013,September,Llano                                                ,Not Adjusted,7549,8075,526,6.5
8799,2013,December,Llano                                                ,Not Adjusted,7500,7936,436,5.5
8800,2013,March,Loving                                               ,Not Adjusted,68,72,4,5.6
8801,2013,June,Loving                                               ,Not Adjusted,78,83,5,6.0
8802,2013,September,Loving                                               ,Not Adjusted,70,75,5,6.7
8803,2013,December,Loving                                               ,Not Adjusted,68,72,4,5.6
8804,2013,March,Lubbock                                              ,Not Adjusted,138141,145687,7546,5.2
8805,2013,June,Lubbock                                              ,Not Adjusted,139088,147758,8670,5.9
8806,2013,September,Lubbock                                              ,Not Adjusted,140857,148060,7203,4.9
8807,2013,December,Lubbock                                              ,Not Adjusted,140956,146987,6031,4.1
8808,2013,March,Lynn                                                 ,Not Adjusted,2608,2770,162,5.8
8809,2013,June,Lynn                                                 ,Not Adjusted,2753,2926,173,5.9
8810,2013,September,Lynn                                                 ,Not Adjusted,2750,2897,147,5.1
8811,2013,December,Lynn                                                 ,Not Adjusted,2717,2833,116,4.1
8812,2013,March,McCulloch                                            ,Not Adjusted,4045,4251,206,4.8
8813,2013,June,McCulloch                                            ,Not Adjusted,4072,4309,237,5.5
8814,2013,September,McCulloch                                            ,Not Adjusted,4046,4298,252,5.9
8815,2013,December,McCulloch                                            ,Not Adjusted,3956,4159,203,4.9
8816,2013,March,McLennan                                             ,Not Adjusted,104303,111258,6955,6.3
8817,2013,June,McLennan                                             ,Not Adjusted,105314,113273,7959,7.0
8818,2013,September,McLennan                                             ,Not Adjusted,105744,112697,6953,6.2
8819,2013,December,McLennan                                             ,Not Adjusted,104932,110771,5839,5.3
8820,2013,March,McMullen                                             ,Not Adjusted,821,841,20,2.4
8821,2013,June,McMullen                                             ,Not Adjusted,883,907,24,2.6
8822,2013,September,McMullen                                             ,Not Adjusted,862,890,28,3.1
8823,2013,December,McMullen                                             ,Not Adjusted,928,947,19,2.0
8824,2013,March,Madison                                              ,Not Adjusted,4435,4751,316,6.7
8825,2013,June,Madison                                              ,Not Adjusted,4568,4922,354,7.2
8826,2013,September,Madison                                              ,Not Adjusted,4557,4858,301,6.2
8827,2013,December,Madison                                              ,Not Adjusted,4517,4777,260,5.4
8828,2013,March,Marion                                               ,Not Adjusted,4058,4430,372,8.4
8829,2013,June,Marion                                               ,Not Adjusted,4192,4581,389,8.5
8830,2013,September,Marion                                               ,Not Adjusted,4188,4555,367,8.1
8831,2013,December,Marion                                               ,Not Adjusted,4215,4544,329,7.2
8832,2013,March,Martin                                               ,Not Adjusted,2359,2465,106,4.3
8833,2013,June,Martin                                               ,Not Adjusted,2470,2596,126,4.9
8834,2013,September,Martin                                               ,Not Adjusted,2475,2589,114,4.4
8835,2013,December,Martin                                               ,Not Adjusted,2471,2562,91,3.6
8836,2013,March,Mason                                                ,Not Adjusted,1800,1900,100,5.3
8837,2013,June,Mason                                                ,Not Adjusted,1894,2025,131,6.5
8838,2013,September,Mason                                                ,Not Adjusted,1837,1944,107,5.5
8839,2013,December,Mason                                                ,Not Adjusted,1831,1922,91,4.7
8840,2013,March,Matagorda                                            ,Not Adjusted,14975,16593,1618,9.8
8841,2013,June,Matagorda                                            ,Not Adjusted,15222,16995,1773,10.4
8842,2013,September,Matagorda                                            ,Not Adjusted,15041,16688,1647,9.9
8843,2013,December,Matagorda                                            ,Not Adjusted,15511,17000,1489,8.8
8844,2013,March,Maverick                                             ,Not Adjusted,20661,23821,3160,13.3
8845,2013,June,Maverick                                             ,Not Adjusted,20636,23696,3060,12.9
8846,2013,September,Maverick                                             ,Not Adjusted,20497,23070,2573,11.2
8847,2013,December,Maverick                                             ,Not Adjusted,21177,23947,2770,11.6
8848,2013,March,Medina                                               ,Not Adjusted,18789,20028,1239,6.2
8849,2013,June,Medina                                               ,Not Adjusted,19164,20534,1370,6.7
8850,2013,September,Medina                                               ,Not Adjusted,19188,20420,1232,6.0
8851,2013,December,Medina                                               ,Not Adjusted,19237,20305,1068,5.3
8852,2013,March,Menard                                               ,Not Adjusted,866,919,53,5.8
8853,2013,June,Menard                                               ,Not Adjusted,875,935,60,6.4
8854,2013,September,Menard                                               ,Not Adjusted,857,911,54,5.9
8855,2013,December,Menard                                               ,Not Adjusted,869,915,46,5.0
8856,2013,March,Midland                                              ,Not Adjusted,81141,84185,3044,3.6
8857,2013,June,Midland                                              ,Not Adjusted,82653,86251,3598,4.2
8858,2013,September,Midland                                              ,Not Adjusted,83495,86775,3280,3.8
8859,2013,December,Midland                                              ,Not Adjusted,84097,86827,2730,3.1
8860,2013,March,Milam                                                ,Not Adjusted,9215,10047,832,8.3
8861,2013,June,Milam                                                ,Not Adjusted,9457,10304,847,8.2
8862,2013,September,Milam                                                ,Not Adjusted,9327,10110,783,7.7
8863,2013,December,Milam                                                ,Not Adjusted,9331,9996,665,6.7
8864,2013,March,Mills                                                ,Not Adjusted,1926,2035,109,5.4
8865,2013,June,Mills                                                ,Not Adjusted,2038,2162,124,5.7
8866,2013,September,Mills                                                ,Not Adjusted,2000,2119,119,5.6
8867,2013,December,Mills                                                ,Not Adjusted,1940,2038,98,4.8
8868,2013,March,Mitchell                                             ,Not Adjusted,2676,2836,160,5.6
8869,2013,June,Mitchell                                             ,Not Adjusted,2762,2944,182,6.2
8870,2013,September,Mitchell                                             ,Not Adjusted,2741,2896,155,5.4
8871,2013,December,Mitchell                                             ,Not Adjusted,2716,2843,127,4.5
8872,2013,March,Montague                                             ,Not Adjusted,9713,10209,496,4.9
8873,2013,June,Montague                                             ,Not Adjusted,9870,10436,566,5.4
8874,2013,September,Montague                                             ,Not Adjusted,9970,10489,519,4.9
8875,2013,December,Montague                                             ,Not Adjusted,9880,10329,449,4.3
8876,2013,March,Montgomery                                           ,Not Adjusted,230777,244075,13298,5.4
8877,2013,June,Montgomery                                           ,Not Adjusted,231892,246709,14817,6.0
8878,2013,September,Montgomery                                           ,Not Adjusted,233425,246922,13497,5.5
8879,2013,December,Montgomery                                           ,Not Adjusted,235766,247294,11528,4.7
8880,2013,March,Moore                                                ,Not Adjusted,10646,11117,471,4.2
8881,2013,June,Moore                                                ,Not Adjusted,10996,11562,566,4.9
8882,2013,September,Moore                                                ,Not Adjusted,10991,11489,498,4.3
8883,2013,December,Moore                                                ,Not Adjusted,11013,11427,414,3.6
8884,2013,March,Morris                                               ,Not Adjusted,5223,5792,569,9.8
8885,2013,June,Morris                                               ,Not Adjusted,5388,5977,589,9.9
8886,2013,September,Morris                                               ,Not Adjusted,5335,5907,572,9.7
8887,2013,December,Morris                                               ,Not Adjusted,5180,5669,489,8.6
8888,2013,March,Motley                                               ,Not Adjusted,443,470,27,5.7
8889,2013,June,Motley                                               ,Not Adjusted,493,529,36,6.8
8890,2013,September,Motley                                               ,Not Adjusted,489,518,29,5.6
8891,2013,December,Motley                                               ,Not Adjusted,466,489,23,4.7
8892,2013,March,Nacogdoches                                          ,Not Adjusted,27133,29011,1878,6.5
8893,2013,June,Nacogdoches                                          ,Not Adjusted,27353,29580,2227,7.5
8894,2013,September,Nacogdoches                                          ,Not Adjusted,27362,29279,1917,6.5
8895,2013,December,Nacogdoches                                          ,Not Adjusted,27353,28972,1619,5.6
8896,2013,March,Navarro                                              ,Not Adjusted,21030,22747,1717,7.5
8897,2013,June,Navarro                                              ,Not Adjusted,21056,22746,1690,7.4
8898,2013,September,Navarro                                              ,Not Adjusted,22317,23762,1445,6.1
8899,2013,December,Navarro                                              ,Not Adjusted,22858,24097,1239,5.1
8900,2013,March,Newton                                               ,Not Adjusted,5027,5662,635,11.2
8901,2013,June,Newton                                               ,Not Adjusted,5005,5646,641,11.4
8902,2013,September,Newton                                               ,Not Adjusted,4960,5555,595,10.7
8903,2013,December,Newton                                               ,Not Adjusted,4996,5546,550,9.9
8904,2013,March,Nolan                                                ,Not Adjusted,6519,6934,415,6.0
8905,2013,June,Nolan                                                ,Not Adjusted,6542,6992,450,6.4
8906,2013,September,Nolan                                                ,Not Adjusted,6535,6919,384,5.5
8907,2013,December,Nolan                                                ,Not Adjusted,6605,6930,325,4.7
8908,2013,March,Nueces                                               ,Not Adjusted,157921,168235,10314,6.1
8909,2013,June,Nueces                                               ,Not Adjusted,157763,169158,11395,6.7
8910,2013,September,Nueces                                               ,Not Adjusted,157867,168278,10411,6.2
8911,2013,December,Nueces                                               ,Not Adjusted,158568,167647,9079,5.4
8912,2013,March,Ochiltree                                            ,Not Adjusted,5059,5256,197,3.7
8913,2013,June,Ochiltree                                            ,Not Adjusted,5326,5562,236,4.2
8914,2013,September,Ochiltree                                            ,Not Adjusted,5231,5438,207,3.8
8915,2013,December,Ochiltree                                            ,Not Adjusted,5265,5441,176,3.2
8916,2013,March,Oldham                                               ,Not Adjusted,893,934,41,4.4
8917,2013,June,Oldham                                               ,Not Adjusted,931,976,45,4.6
8918,2013,September,Oldham                                               ,Not Adjusted,923,964,41,4.3
8919,2013,December,Oldham                                               ,Not Adjusted,919,956,37,3.9
8920,2013,March,Orange                                               ,Not Adjusted,34284,38300,4016,10.5
8921,2013,June,Orange                                               ,Not Adjusted,33921,38127,4206,11.0
8922,2013,September,Orange                                               ,Not Adjusted,33676,37571,3895,10.4
8923,2013,December,Orange                                               ,Not Adjusted,34004,37594,3590,9.5
8924,2013,March,Palo Pinto                                           ,Not Adjusted,12328,13217,889,6.7
8925,2013,June,Palo Pinto                                           ,Not Adjusted,12699,13647,948,6.9
8926,2013,September,Palo Pinto                                           ,Not Adjusted,12654,13562,908,6.7
8927,2013,December,Palo Pinto                                           ,Not Adjusted,12348,13127,779,5.9
8928,2013,March,Panola                                               ,Not Adjusted,11702,12497,795,6.4
8929,2013,June,Panola                                               ,Not Adjusted,11860,12727,867,6.8
8930,2013,September,Panola                                               ,Not Adjusted,12138,12913,775,6.0
8931,2013,December,Panola                                               ,Not Adjusted,11994,12674,680,5.4
8932,2013,March,Parker                                               ,Not Adjusted,54717,58007,3290,5.7
8933,2013,June,Parker                                               ,Not Adjusted,55419,59021,3602,6.1
8934,2013,September,Parker                                               ,Not Adjusted,55725,58970,3245,5.5
8935,2013,December,Parker                                               ,Not Adjusted,55945,58783,2838,4.8
8936,2013,March,Parmer                                               ,Not Adjusted,4651,4837,186,3.8
8937,2013,June,Parmer                                               ,Not Adjusted,4985,5213,228,4.4
8938,2013,September,Parmer                                               ,Not Adjusted,5000,5207,207,4.0
8939,2013,December,Parmer                                               ,Not Adjusted,4884,5054,170,3.4
8940,2013,March,Pecos                                                ,Not Adjusted,6251,6614,363,5.5
8941,2013,June,Pecos                                                ,Not Adjusted,6345,6735,390,5.8
8942,2013,September,Pecos                                                ,Not Adjusted,6350,6743,393,5.8
8943,2013,December,Pecos                                                ,Not Adjusted,6350,6656,306,4.6
8944,2013,March,Polk                                                 ,Not Adjusted,15924,17308,1384,8.0
8945,2013,June,Polk                                                 ,Not Adjusted,16163,17607,1444,8.2
8946,2013,September,Polk                                                 ,Not Adjusted,15915,17270,1355,7.8
8947,2013,December,Polk                                                 ,Not Adjusted,15975,17140,1165,6.8
8948,2013,March,Potter                                               ,Not Adjusted,54046,57029,2983,5.2
8949,2013,June,Potter                                               ,Not Adjusted,54440,57689,3249,5.6
8950,2013,September,Potter                                               ,Not Adjusted,54478,57373,2895,5.0
8951,2013,December,Potter                                               ,Not Adjusted,54804,57226,2422,4.2
8952,2013,March,Presidio                                             ,Not Adjusted,3294,3751,457,12.2
8953,2013,June,Presidio                                             ,Not Adjusted,3368,3884,516,13.3
8954,2013,September,Presidio                                             ,Not Adjusted,3220,3716,496,13.3
8955,2013,December,Presidio                                             ,Not Adjusted,3112,3566,454,12.7
8956,2013,March,Rains                                                ,Not Adjusted,5025,5348,323,6.0
8957,2013,June,Rains                                                ,Not Adjusted,4930,5289,359,6.8
8958,2013,September,Rains                                                ,Not Adjusted,4998,5329,331,6.2
8959,2013,December,Rains                                                ,Not Adjusted,5014,5295,281,5.3
8960,2013,March,Randall                                              ,Not Adjusted,64838,67732,2894,4.3
8961,2013,June,Randall                                              ,Not Adjusted,65471,68880,3409,4.9
8962,2013,September,Randall                                              ,Not Adjusted,65425,68450,3025,4.4
8963,2013,December,Randall                                              ,Not Adjusted,65708,68235,2527,3.7
8964,2013,March,Reagan                                               ,Not Adjusted,1825,1902,77,4.0
8965,2013,June,Reagan                                               ,Not Adjusted,1848,1938,90,4.6
8966,2013,September,Reagan                                               ,Not Adjusted,1838,1916,78,4.1
8967,2013,December,Reagan                                               ,Not Adjusted,1937,2007,70,3.5
8968,2013,March,Real                                                 ,Not Adjusted,933,1017,84,8.3
8969,2013,June,Real                                                 ,Not Adjusted,1092,1186,94,7.9
8970,2013,September,Real                                                 ,Not Adjusted,951,1038,87,8.4
8971,2013,December,Real                                                 ,Not Adjusted,939,1014,75,7.4
8972,2013,March,Red River                                            ,Not Adjusted,4627,5168,541,10.5
8973,2013,June,Red River                                            ,Not Adjusted,4640,5190,550,10.6
8974,2013,September,Red River                                            ,Not Adjusted,4609,5120,511,10.0
8975,2013,December,Red River                                            ,Not Adjusted,4597,5045,448,8.9
8976,2013,March,Reeves                                               ,Not Adjusted,5204,5524,320,5.8
8977,2013,June,Reeves                                               ,Not Adjusted,5319,5695,376,6.6
8978,2013,September,Reeves                                               ,Not Adjusted,5321,5646,325,5.8
8979,2013,December,Reeves                                               ,Not Adjusted,5448,5717,269,4.7
8980,2013,March,Refugio                                              ,Not Adjusted,3314,3512,198,5.6
8981,2013,June,Refugio                                              ,Not Adjusted,3418,3644,226,6.2
8982,2013,September,Refugio                                              ,Not Adjusted,3363,3554,191,5.4
8983,2013,December,Refugio                                              ,Not Adjusted,3357,3512,155,4.4
8984,2013,March,Roberts                                              ,Not Adjusted,423,443,20,4.5
8985,2013,June,Roberts                                              ,Not Adjusted,451,473,22,4.7
8986,2013,September,Roberts                                              ,Not Adjusted,433,452,19,4.2
8987,2013,December,Roberts                                              ,Not Adjusted,414,429,15,3.5
8988,2013,March,Robertson                                            ,Not Adjusted,6711,7240,529,7.3
8989,2013,June,Robertson                                            ,Not Adjusted,6617,7189,572,8.0
8990,2013,September,Robertson                                            ,Not Adjusted,6952,7438,486,6.5
8991,2013,December,Robertson                                            ,Not Adjusted,6945,7368,423,5.7
8992,2013,March,Rockwall                                             ,Not Adjusted,39216,41696,2480,5.9
8993,2013,June,Rockwall                                             ,Not Adjusted,39637,42366,2729,6.4
8994,2013,September,Rockwall                                             ,Not Adjusted,40083,42525,2442,5.7
8995,2013,December,Rockwall                                             ,Not Adjusted,40475,42542,2067,4.9
8996,2013,March,Runnels                                              ,Not Adjusted,4669,4923,254,5.2
8997,2013,June,Runnels                                              ,Not Adjusted,4814,5114,300,5.9
8998,2013,September,Runnels                                              ,Not Adjusted,4662,4961,299,6.0
8999,2013,December,Runnels                                              ,Not Adjusted,4720,4928,208,4.2
9000,2013,March,Rusk                                                 ,Not Adjusted,22892,24397,1505,6.2
9001,2013,June,Rusk                                                 ,Not Adjusted,22765,24412,1647,6.7
9002,2013,September,Rusk                                                 ,Not Adjusted,22683,24248,1565,6.5
9003,2013,December,Rusk                                                 ,Not Adjusted,22712,24025,1313,5.5
9004,2013,March,Sabine                                               ,Not Adjusted,3049,3500,451,12.9
9005,2013,June,Sabine                                               ,Not Adjusted,3110,3604,494,13.7
9006,2013,September,Sabine                                               ,Not Adjusted,3112,3565,453,12.7
9007,2013,December,Sabine                                               ,Not Adjusted,3071,3506,435,12.4
9008,2013,March,San Augustine                                        ,Not Adjusted,2555,2905,350,12.0
9009,2013,June,San Augustine                                        ,Not Adjusted,2642,3005,363,12.1
9010,2013,September,San Augustine                                        ,Not Adjusted,2591,2942,351,11.9
9011,2013,December,San Augustine                                        ,Not Adjusted,2551,2858,307,10.7
9012,2013,March,San Jacinto                                          ,Not Adjusted,10444,11324,880,7.8
9013,2013,June,San Jacinto                                          ,Not Adjusted,10606,11583,977,8.4
9014,2013,September,San Jacinto                                          ,Not Adjusted,10556,11430,874,7.6
9015,2013,December,San Jacinto                                          ,Not Adjusted,10654,11383,729,6.4
9016,2013,March,San Patricio                                         ,Not Adjusted,28404,30605,2201,7.2
9017,2013,June,San Patricio                                         ,Not Adjusted,28488,30875,2387,7.7
9018,2013,September,San Patricio                                         ,Not Adjusted,28465,30711,2246,7.3
9019,2013,December,San Patricio                                         ,Not Adjusted,28543,30534,1991,6.5
9020,2013,March,San Saba                                             ,Not Adjusted,2113,2243,130,5.8
9021,2013,June,San Saba                                             ,Not Adjusted,2178,2333,155,6.6
9022,2013,September,San Saba                                             ,Not Adjusted,2136,2265,129,5.7
9023,2013,December,San Saba                                             ,Not Adjusted,2138,2239,101,4.5
9024,2013,March,Schleicher                                           ,Not Adjusted,1703,1759,56,3.2
9025,2013,June,Schleicher                                           ,Not Adjusted,1799,1875,76,4.1
9026,2013,September,Schleicher                                           ,Not Adjusted,1747,1816,69,3.8
9027,2013,December,Schleicher                                           ,Not Adjusted,1717,1776,59,3.3
9028,2013,March,Scurry                                               ,Not Adjusted,8129,8469,340,4.0
9029,2013,June,Scurry                                               ,Not Adjusted,8215,8650,435,5.0
9030,2013,September,Scurry                                               ,Not Adjusted,8312,8664,352,4.1
9031,2013,December,Scurry                                               ,Not Adjusted,8122,8421,299,3.6
9032,2013,March,Shackelford                                          ,Not Adjusted,2127,2199,72,3.3
9033,2013,June,Shackelford                                          ,Not Adjusted,2223,2310,87,3.8
9034,2013,September,Shackelford                                          ,Not Adjusted,2244,2325,81,3.5
9035,2013,December,Shackelford                                          ,Not Adjusted,2294,2361,67,2.8
9036,2013,March,Shelby                                               ,Not Adjusted,10611,11442,831,7.3
9037,2013,June,Shelby                                               ,Not Adjusted,10971,11902,931,7.8
9038,2013,September,Shelby                                               ,Not Adjusted,10799,11712,913,7.8
9039,2013,December,Shelby                                               ,Not Adjusted,10480,11254,774,6.9
9040,2013,March,Sherman                                              ,Not Adjusted,1341,1399,58,4.1
9041,2013,June,Sherman                                              ,Not Adjusted,1459,1528,69,4.5
9042,2013,September,Sherman                                              ,Not Adjusted,1467,1528,61,4.0
9043,2013,December,Sherman                                              ,Not Adjusted,1424,1476,52,3.5
9044,2013,March,Smith                                                ,Not Adjusted,94315,100810,6495,6.4
9045,2013,June,Smith                                                ,Not Adjusted,95138,102258,7120,7.0
9046,2013,September,Smith                                                ,Not Adjusted,94840,101837,6997,6.9
9047,2013,December,Smith                                                ,Not Adjusted,95456,101266,5810,5.7
9048,2013,March,Somervell                                            ,Not Adjusted,3849,4090,241,5.9
9049,2013,June,Somervell                                            ,Not Adjusted,3891,4178,287,6.9
9050,2013,September,Somervell                                            ,Not Adjusted,3914,4163,249,6.0
9051,2013,December,Somervell                                            ,Not Adjusted,3933,4140,207,5.0
9052,2013,March,Starr                                                ,Not Adjusted,22490,26550,4060,15.3
9053,2013,June,Starr                                                ,Not Adjusted,22424,26540,4116,15.5
9054,2013,September,Starr                                                ,Not Adjusted,22150,25768,3618,14.0
9055,2013,December,Starr                                                ,Not Adjusted,22253,26232,3979,15.2
9056,2013,March,Stephens                                             ,Not Adjusted,3975,4197,222,5.3
9057,2013,June,Stephens                                             ,Not Adjusted,4002,4235,233,5.5
9058,2013,September,Stephens                                             ,Not Adjusted,3968,4183,215,5.1
9059,2013,December,Stephens                                             ,Not Adjusted,4008,4193,185,4.4
9060,2013,March,Sterling                                             ,Not Adjusted,678,707,29,4.1
9061,2013,June,Sterling                                             ,Not Adjusted,751,786,35,4.5
9062,2013,September,Sterling                                             ,Not Adjusted,752,780,28,3.6
9063,2013,December,Sterling                                             ,Not Adjusted,735,759,24,3.2
9064,2013,March,Stonewall                                            ,Not Adjusted,651,684,33,4.8
9065,2013,June,Stonewall                                            ,Not Adjusted,701,739,38,5.1
9066,2013,September,Stonewall                                            ,Not Adjusted,666,702,36,5.1
9067,2013,December,Stonewall                                            ,Not Adjusted,655,683,28,4.1
9068,2013,March,Sutton                                               ,Not Adjusted,1950,2047,97,4.7
9069,2013,June,Sutton                                               ,Not Adjusted,1978,2084,106,5.1
9070,2013,September,Sutton                                               ,Not Adjusted,1971,2065,94,4.6
9071,2013,December,Sutton                                               ,Not Adjusted,1959,2038,79,3.9
9072,2013,March,Swisher                                              ,Not Adjusted,2683,2929,246,8.4
9073,2013,June,Swisher                                              ,Not Adjusted,2754,3046,292,9.6
9074,2013,September,Swisher                                              ,Not Adjusted,2718,2982,264,8.9
9075,2013,December,Swisher                                              ,Not Adjusted,2694,2899,205,7.1
9076,2013,March,Tarrant                                              ,Not Adjusted,912451,972436,59985,6.2
9077,2013,June,Tarrant                                              ,Not Adjusted,920401,985645,65244,6.6
9078,2013,September,Tarrant                                              ,Not Adjusted,926209,985169,58960,6.0
9079,2013,December,Tarrant                                              ,Not Adjusted,930570,981907,51337,5.2
9080,2013,March,Taylor                                               ,Not Adjusted,60808,64183,3375,5.3
9081,2013,June,Taylor                                               ,Not Adjusted,60805,64707,3902,6.0
9082,2013,September,Taylor                                               ,Not Adjusted,61064,64485,3421,5.3
9083,2013,December,Taylor                                               ,Not Adjusted,61576,64473,2897,4.5
9084,2013,March,Terrell                                              ,Not Adjusted,493,521,28,5.4
9085,2013,June,Terrell                                              ,Not Adjusted,519,543,24,4.4
9086,2013,September,Terrell                                              ,Not Adjusted,511,535,24,4.5
9087,2013,December,Terrell                                              ,Not Adjusted,460,482,22,4.6
9088,2013,March,Terry                                                ,Not Adjusted,4974,5326,352,6.6
9089,2013,June,Terry                                                ,Not Adjusted,5306,5682,376,6.6
9090,2013,September,Terry                                                ,Not Adjusted,5263,5585,322,5.8
9091,2013,December,Terry                                                ,Not Adjusted,5373,5634,261,4.6
9092,2013,March,Throckmorton                                         ,Not Adjusted,731,770,39,5.1
9093,2013,June,Throckmorton                                         ,Not Adjusted,768,810,42,5.2
9094,2013,September,Throckmorton                                         ,Not Adjusted,764,805,41,5.1
9095,2013,December,Throckmorton                                         ,Not Adjusted,772,807,35,4.3
9096,2013,March,Titus                                                ,Not Adjusted,12054,13010,956,7.3
9097,2013,June,Titus                                                ,Not Adjusted,12027,13117,1090,8.3
9098,2013,September,Titus                                                ,Not Adjusted,12140,13136,996,7.6
9099,2013,December,Titus                                                ,Not Adjusted,12214,13064,850,6.5
9100,2013,March,Tom Green                                            ,Not Adjusted,51244,54000,2756,5.1
9101,2013,June,Tom Green                                            ,Not Adjusted,51316,54557,3241,5.9
9102,2013,September,Tom Green                                            ,Not Adjusted,51641,54443,2802,5.1
9103,2013,December,Tom Green                                            ,Not Adjusted,51390,53764,2374,4.4
9104,2013,March,Travis                                               ,Not Adjusted,589205,621399,32194,5.2
9105,2013,June,Travis                                               ,Not Adjusted,595598,630364,34766,5.5
9106,2013,September,Travis                                               ,Not Adjusted,600449,632836,32387,5.1
9107,2013,December,Travis                                               ,Not Adjusted,607802,634771,26969,4.2
9108,2013,March,Trinity                                              ,Not Adjusted,5057,5477,420,7.7
9109,2013,June,Trinity                                              ,Not Adjusted,5193,5664,471,8.3
9110,2013,September,Trinity                                              ,Not Adjusted,5230,5643,413,7.3
9111,2013,December,Trinity                                              ,Not Adjusted,5102,5449,347,6.4
9112,2013,March,Tyler                                                ,Not Adjusted,6792,7572,780,10.3
9113,2013,June,Tyler                                                ,Not Adjusted,6886,7741,855,11.0
9114,2013,September,Tyler                                                ,Not Adjusted,6804,7572,768,10.1
9115,2013,December,Tyler                                                ,Not Adjusted,6849,7559,710,9.4
9116,2013,March,Upshur                                               ,Not Adjusted,17422,18613,1191,6.4
9117,2013,June,Upshur                                               ,Not Adjusted,17326,18638,1312,7.0
9118,2013,September,Upshur                                               ,Not Adjusted,17264,18444,1180,6.4
9119,2013,December,Upshur                                               ,Not Adjusted,17285,18300,1015,5.5
9120,2013,March,Upton                                                ,Not Adjusted,1551,1617,66,4.1
9121,2013,June,Upton                                                ,Not Adjusted,1665,1746,81,4.6
9122,2013,September,Upton                                                ,Not Adjusted,1662,1738,76,4.4
9123,2013,December,Upton                                                ,Not Adjusted,1707,1770,63,3.6
9124,2013,March,Uvalde                                               ,Not Adjusted,10895,11795,900,7.6
9125,2013,June,Uvalde                                               ,Not Adjusted,11382,12280,898,7.3
9126,2013,September,Uvalde                                               ,Not Adjusted,11207,11987,780,6.5
9127,2013,December,Uvalde                                               ,Not Adjusted,11033,11748,715,6.1
9128,2013,March,Val Verde                                            ,Not Adjusted,18214,19692,1478,7.5
9129,2013,June,Val Verde                                            ,Not Adjusted,18273,19824,1551,7.8
9130,2013,September,Val Verde                                            ,Not Adjusted,18179,19516,1337,6.9
9131,2013,December,Val Verde                                            ,Not Adjusted,18159,19345,1186,6.1
9132,2013,March,Van Zandt                                            ,Not Adjusted,22028,23571,1543,6.5
9133,2013,June,Van Zandt                                            ,Not Adjusted,22464,24179,1715,7.1
9134,2013,September,Van Zandt                                            ,Not Adjusted,22313,23921,1608,6.7
9135,2013,December,Van Zandt                                            ,Not Adjusted,22240,23630,1390,5.9
9136,2013,March,Victoria                                             ,Not Adjusted,42612,45053,2441,5.4
9137,2013,June,Victoria                                             ,Not Adjusted,43279,46046,2767,6.0
9138,2013,September,Victoria                                             ,Not Adjusted,43779,46202,2423,5.2
9139,2013,December,Victoria                                             ,Not Adjusted,43885,45952,2067,4.5
9140,2013,March,Walker                                               ,Not Adjusted,21585,23059,1474,6.4
9141,2013,June,Walker                                               ,Not Adjusted,21590,23378,1788,7.6
9142,2013,September,Walker                                               ,Not Adjusted,21733,23253,1520,6.5
9143,2013,December,Walker                                               ,Not Adjusted,21430,22736,1306,5.7
9144,2013,March,Waller                                               ,Not Adjusted,19249,20600,1351,6.6
9145,2013,June,Waller                                               ,Not Adjusted,19469,21063,1594,7.6
9146,2013,September,Waller                                               ,Not Adjusted,19558,20855,1297,6.2
9147,2013,December,Waller                                               ,Not Adjusted,19706,20810,1104,5.3
9148,2013,March,Ward                                                 ,Not Adjusted,5085,5343,258,4.8
9149,2013,June,Ward                                                 ,Not Adjusted,5275,5569,294,5.3
9150,2013,September,Ward                                                 ,Not Adjusted,5372,5634,262,4.7
9151,2013,December,Ward                                                 ,Not Adjusted,5398,5628,230,4.1
9152,2013,March,Washington                                           ,Not Adjusted,14712,15583,871,5.6
9153,2013,June,Washington                                           ,Not Adjusted,14951,15960,1009,6.3
9154,2013,September,Washington                                           ,Not Adjusted,14967,15828,861,5.4
9155,2013,December,Washington                                           ,Not Adjusted,14884,15609,725,4.6
9156,2013,March,Webb                                                 ,Not Adjusted,102687,109445,6758,6.2
9157,2013,June,Webb                                                 ,Not Adjusted,102818,110564,7746,7.0
9158,2013,September,Webb                                                 ,Not Adjusted,103597,110221,6624,6.0
9159,2013,December,Webb                                                 ,Not Adjusted,104444,110294,5850,5.3
9160,2013,March,Wharton                                              ,Not Adjusted,19856,21144,1288,6.1
9161,2013,June,Wharton                                              ,Not Adjusted,20337,21768,1431,6.6
9162,2013,September,Wharton                                              ,Not Adjusted,20300,21577,1277,5.9
9163,2013,December,Wharton                                              ,Not Adjusted,20419,21521,1102,5.1
9164,2013,March,Wheeler                                              ,Not Adjusted,2752,2880,128,4.4
9165,2013,June,Wheeler                                              ,Not Adjusted,3073,3223,150,4.7
9166,2013,September,Wheeler                                              ,Not Adjusted,3258,3402,144,4.2
9167,2013,December,Wheeler                                              ,Not Adjusted,3044,3162,118,3.7
9168,2013,March,Wichita                                              ,Not Adjusted,53757,57260,3503,6.1
9169,2013,June,Wichita                                              ,Not Adjusted,54028,57776,3748,6.5
9170,2013,September,Wichita                                              ,Not Adjusted,53566,56874,3308,5.8
9171,2013,December,Wichita                                              ,Not Adjusted,53950,56820,2870,5.1
9172,2013,March,Wilbarger                                            ,Not Adjusted,5486,5813,327,5.6
9173,2013,June,Wilbarger                                            ,Not Adjusted,5616,6015,399,6.6
9174,2013,September,Wilbarger                                            ,Not Adjusted,5313,5653,340,6.0
9175,2013,December,Wilbarger                                            ,Not Adjusted,5331,5612,281,5.0
9176,2013,March,Willacy                                              ,Not Adjusted,6363,7557,1194,15.8
9177,2013,June,Willacy                                              ,Not Adjusted,6415,7683,1268,16.5
9178,2013,September,Willacy                                              ,Not Adjusted,6134,7291,1157,15.9
9179,2013,December,Willacy                                              ,Not Adjusted,6152,7181,1029,14.3
9180,2013,March,Williamson                                           ,Not Adjusted,230261,243409,13148,5.4
9181,2013,June,Williamson                                           ,Not Adjusted,232751,246956,14205,5.8
9182,2013,September,Williamson                                           ,Not Adjusted,234534,247759,13225,5.3
9183,2013,December,Williamson                                           ,Not Adjusted,237267,248484,11217,4.5
9184,2013,March,Wilson                                               ,Not Adjusted,20770,21928,1158,5.3
9185,2013,June,Wilson                                               ,Not Adjusted,21068,22399,1331,5.9
9186,2013,September,Wilson                                               ,Not Adjusted,21124,22320,1196,5.4
9187,2013,December,Wilson                                               ,Not Adjusted,21214,22196,982,4.4
9188,2013,March,Winkler                                              ,Not Adjusted,3086,3253,167,5.1
9189,2013,June,Winkler                                              ,Not Adjusted,3082,3277,195,6.0
9190,2013,September,Winkler                                              ,Not Adjusted,3210,3388,178,5.3
9191,2013,December,Winkler                                              ,Not Adjusted,3187,3349,162,4.8
9192,2013,March,Wise                                                 ,Not Adjusted,26323,28106,1783,6.3
9193,2013,June,Wise                                                 ,Not Adjusted,26730,28646,1916,6.7
9194,2013,September,Wise                                                 ,Not Adjusted,26860,28555,1695,5.9
9195,2013,December,Wise                                                 ,Not Adjusted,26948,28401,1453,5.1
9196,2013,March,Wood                                                 ,Not Adjusted,15399,16635,1236,7.4
9197,2013,June,Wood                                                 ,Not Adjusted,15662,16964,1302,7.7
9198,2013,September,Wood                                                 ,Not Adjusted,15505,16732,1227,7.3
9199,2013,December,Wood                                                 ,Not Adjusted,15468,16523,1055,6.4
9200,2013,March,Yoakum                                               ,Not Adjusted,4007,4169,162,3.9
9201,2013,June,Yoakum                                               ,Not Adjusted,4061,4244,183,4.3
9202,2013,September,Yoakum                                               ,Not Adjusted,4046,4210,164,3.9
9203,2013,December,Yoakum                                               ,Not Adjusted,4119,4260,141,3.3
9204,2013,March,Young                                                ,Not Adjusted,8085,8526,441,5.2
9205,2013,June,Young                                                ,Not Adjusted,8184,8675,491,5.7
9206,2013,September,Young                                                ,Not Adjusted,8104,8545,441,5.2
9207,2013,December,Young                                                ,Not Adjusted,8074,8461,387,4.6
9208,2013,March,Zapata                                               ,Not Adjusted,6655,7078,423,6.0
9209,2013,June,Zapata                                               ,Not Adjusted,6618,7121,503,7.1
9210,2013,September,Zapata                                               ,Not Adjusted,6566,6990,424,6.1
9211,2013,December,Zapata                                               ,Not Adjusted,6451,6865,414,6.0
9212,2013,March,Zavala                                               ,Not Adjusted,3445,4015,570,14.2
9213,2013,June,Zavala                                               ,Not Adjusted,3520,4138,618,14.9
9214,2013,September,Zavala                                               ,Not Adjusted,3295,3874,579,14.9
9215,2013,December,Zavala                                               ,Not Adjusted,3483,4018,535,13.3
9216,2014,March,Texas,Not Adjusted,12268902,12982531,713629,5.5
9217,2014,March,Texas,Adjusted,12254958,12962485,707527,5.5
9218,2014,June,Texas,Not Adjusted,12328447,13046149,717702,5.5
9219,2014,June,Texas,Adjusted,12325395,13005331,679936,5.2
9220,2014,September,Texas,Not Adjusted,12375704,13029382,653678,5.0
9221,2014,September,Texas,Adjusted,12398563,13050337,651774,5.0
9222,2014,December,Texas,Not Adjusted,12454520,13007327,552807,4.2
9223,2014,December,Texas,Adjusted,12446054,13051833,605779,4.6
9224,2014,March,Anderson                                             ,Not Adjusted,20826,21900,1074,4.9
9225,2014,June,Anderson                                             ,Not Adjusted,20755,21869,1114,5.1
9226,2014,September,Anderson                                             ,Not Adjusted,20609,21600,991,4.6
9227,2014,December,Anderson                                             ,Not Adjusted,20589,21391,802,3.7
9228,2014,March,Andrews                                              ,Not Adjusted,9053,9353,300,3.2
9229,2014,June,Andrews                                              ,Not Adjusted,9195,9513,318,3.3
9230,2014,September,Andrews                                              ,Not Adjusted,9387,9666,279,2.9
9231,2014,December,Andrews                                              ,Not Adjusted,9312,9541,229,2.4
9232,2014,March,Angelina                                             ,Not Adjusted,35755,37826,2071,5.5
9233,2014,June,Angelina                                             ,Not Adjusted,35732,37868,2136,5.6
9234,2014,September,Angelina                                             ,Not Adjusted,35699,37620,1921,5.1
9235,2014,December,Angelina                                             ,Not Adjusted,35545,37214,1669,4.5
9236,2014,March,Aransas                                              ,Not Adjusted,9649,10240,591,5.8
9237,2014,June,Aransas                                              ,Not Adjusted,9624,10217,593,5.8
9238,2014,September,Aransas                                              ,Not Adjusted,9666,10218,552,5.4
9239,2014,December,Aransas                                              ,Not Adjusted,9604,10117,513,5.1
9240,2014,March,Archer                                               ,Not Adjusted,4066,4264,198,4.6
9241,2014,June,Archer                                               ,Not Adjusted,4078,4287,209,4.9
9242,2014,September,Archer                                               ,Not Adjusted,4040,4228,188,4.4
9243,2014,December,Archer                                               ,Not Adjusted,3984,4143,159,3.8
9244,2014,March,Armstrong                                            ,Not Adjusted,971,1003,32,3.2
9245,2014,June,Armstrong                                            ,Not Adjusted,983,1019,36,3.5
9246,2014,September,Armstrong                                            ,Not Adjusted,966,997,31,3.1
9247,2014,December,Armstrong                                            ,Not Adjusted,953,978,25,2.6
9248,2014,March,Atascosa                                             ,Not Adjusted,19213,20278,1065,5.3
9249,2014,June,Atascosa                                             ,Not Adjusted,19430,20548,1118,5.4
9250,2014,September,Atascosa                                             ,Not Adjusted,19386,20395,1009,4.9
9251,2014,December,Atascosa                                             ,Not Adjusted,19388,20179,791,3.9
9252,2014,March,Austin                                               ,Not Adjusted,13364,14094,730,5.2
9253,2014,June,Austin                                               ,Not Adjusted,13450,14179,729,5.1
9254,2014,September,Austin                                               ,Not Adjusted,13499,14166,667,4.7
9255,2014,December,Austin                                               ,Not Adjusted,13525,14092,567,4.0
9256,2014,March,Bailey                                               ,Not Adjusted,2852,3042,190,6.2
9257,2014,June,Bailey                                               ,Not Adjusted,2942,3114,172,5.5
9258,2014,September,Bailey                                               ,Not Adjusted,2766,2898,132,4.6
9259,2014,December,Bailey                                               ,Not Adjusted,2663,2775,112,4.0
9260,2014,March,Bandera                                              ,Not Adjusted,8620,9091,471,5.2
9261,2014,June,Bandera                                              ,Not Adjusted,8715,9175,460,5.0
9262,2014,September,Bandera                                              ,Not Adjusted,8708,9137,429,4.7
9263,2014,December,Bandera                                              ,Not Adjusted,8703,9048,345,3.8
9264,2014,March,Bastrop                                              ,Not Adjusted,34716,36698,1982,5.4
9265,2014,June,Bastrop                                              ,Not Adjusted,34898,36888,1990,5.4
9266,2014,September,Bastrop                                              ,Not Adjusted,34946,36732,1786,4.9
9267,2014,December,Bastrop                                              ,Not Adjusted,35134,36588,1454,4.0
9268,2014,March,Baylor                                               ,Not Adjusted,1550,1625,75,4.6
9269,2014,June,Baylor                                               ,Not Adjusted,1588,1664,76,4.6
9270,2014,September,Baylor                                               ,Not Adjusted,1603,1669,66,4.0
9271,2014,December,Baylor                                               ,Not Adjusted,1588,1646,58,3.5
9272,2014,March,Bee                                                  ,Not Adjusted,10308,10958,650,5.9
9273,2014,June,Bee                                                  ,Not Adjusted,10269,10967,698,6.4
9274,2014,September,Bee                                                  ,Not Adjusted,10048,10668,620,5.8
9275,2014,December,Bee                                                  ,Not Adjusted,9885,10413,528,5.1
9276,2014,March,Bell                                                 ,Not Adjusted,126535,134832,8297,6.2
9277,2014,June,Bell                                                 ,Not Adjusted,126616,135010,8394,6.2
9278,2014,September,Bell                                                 ,Not Adjusted,126354,134202,7848,5.8
9279,2014,December,Bell                                                 ,Not Adjusted,127223,133881,6658,5.0
9280,2014,March,Bexar                                                ,Not Adjusted,818870,862358,43488,5.0
9281,2014,June,Bexar                                                ,Not Adjusted,825964,869676,43712,5.0
9282,2014,September,Bexar                                                ,Not Adjusted,826092,866184,40092,4.6
9283,2014,December,Bexar                                                ,Not Adjusted,831696,864644,32948,3.8
9284,2014,March,Blanco                                               ,Not Adjusted,5379,5596,217,3.9
9285,2014,June,Blanco                                               ,Not Adjusted,5479,5702,223,3.9
9286,2014,September,Blanco                                               ,Not Adjusted,5478,5686,208,3.7
9287,2014,December,Blanco                                               ,Not Adjusted,5542,5719,177,3.1
9288,2014,March,Borden                                               ,Not Adjusted,411,425,14,3.3
9289,2014,June,Borden                                               ,Not Adjusted,415,428,13,3.0
9290,2014,September,Borden                                               ,Not Adjusted,412,426,14,3.3
9291,2014,December,Borden                                               ,Not Adjusted,389,399,10,2.5
9292,2014,March,Bosque                                               ,Not Adjusted,7697,8154,457,5.6
9293,2014,June,Bosque                                               ,Not Adjusted,7750,8223,473,5.8
9294,2014,September,Bosque                                               ,Not Adjusted,7708,8123,415,5.1
9295,2014,December,Bosque                                               ,Not Adjusted,7685,8019,334,4.2
9296,2014,March,Bowie                                                ,Not Adjusted,37145,39884,2739,6.9
9297,2014,June,Bowie                                                ,Not Adjusted,37159,39795,2636,6.6
9298,2014,September,Bowie                                                ,Not Adjusted,37234,39601,2367,6.0
9299,2014,December,Bowie                                                ,Not Adjusted,37436,39478,2042,5.2
9300,2014,March,Brazoria                                             ,Not Adjusted,157001,166035,9034,5.4
9301,2014,June,Brazoria                                             ,Not Adjusted,157540,166604,9064,5.4
9302,2014,September,Brazoria                                             ,Not Adjusted,158529,166884,8355,5.0
9303,2014,December,Brazoria                                             ,Not Adjusted,159924,167165,7241,4.3
9304,2014,March,Brazos                                               ,Not Adjusted,100449,104730,4281,4.1
9305,2014,June,Brazos                                               ,Not Adjusted,97585,102407,4822,4.7
9306,2014,September,Brazos                                               ,Not Adjusted,101028,105130,4102,3.9
9307,2014,December,Brazos                                               ,Not Adjusted,101828,105054,3226,3.1
9308,2014,March,Brewster                                             ,Not Adjusted,3986,4190,204,4.9
9309,2014,June,Brewster                                             ,Not Adjusted,3938,4150,212,5.1
9310,2014,September,Brewster                                             ,Not Adjusted,3762,3946,184,4.7
9311,2014,December,Brewster                                             ,Not Adjusted,3738,3889,151,3.9
9312,2014,March,Briscoe                                              ,Not Adjusted,612,640,28,4.4
9313,2014,June,Briscoe                                              ,Not Adjusted,646,673,27,4.0
9314,2014,September,Briscoe                                              ,Not Adjusted,612,638,26,4.1
9315,2014,December,Briscoe                                              ,Not Adjusted,577,599,22,3.7
9316,2014,March,Brooks                                               ,Not Adjusted,2497,2720,223,8.2
9317,2014,June,Brooks                                               ,Not Adjusted,2483,2731,248,9.1
9318,2014,September,Brooks                                               ,Not Adjusted,2501,2696,195,7.2
9319,2014,December,Brooks                                               ,Not Adjusted,2476,2650,174,6.6
9320,2014,March,Brown                                                ,Not Adjusted,15132,15993,861,5.4
9321,2014,June,Brown                                                ,Not Adjusted,15047,15935,888,5.6
9322,2014,September,Brown                                                ,Not Adjusted,14981,15777,796,5.0
9323,2014,December,Brown                                                ,Not Adjusted,14901,15546,645,4.1
9324,2014,March,Burleson                                             ,Not Adjusted,7249,7649,400,5.2
9325,2014,June,Burleson                                             ,Not Adjusted,7077,7471,394,5.3
9326,2014,September,Burleson                                             ,Not Adjusted,7296,7642,346,4.5
9327,2014,December,Burleson                                             ,Not Adjusted,7307,7589,282,3.7
9328,2014,March,Burnet                                               ,Not Adjusted,20319,21300,981,4.6
9329,2014,June,Burnet                                               ,Not Adjusted,20812,21797,985,4.5
9330,2014,September,Burnet                                               ,Not Adjusted,20640,21575,935,4.3
9331,2014,December,Burnet                                               ,Not Adjusted,20456,21236,780,3.7
9332,2014,March,Caldwell                                             ,Not Adjusted,16244,17224,980,5.7
9333,2014,June,Caldwell                                             ,Not Adjusted,16326,17357,1031,5.9
9334,2014,September,Caldwell                                             ,Not Adjusted,16352,17244,892,5.2
9335,2014,December,Caldwell                                             ,Not Adjusted,16450,17179,729,4.2
9336,2014,March,Calhoun                                              ,Not Adjusted,10409,10988,579,5.3
9337,2014,June,Calhoun                                              ,Not Adjusted,10378,10953,575,5.2
9338,2014,September,Calhoun                                              ,Not Adjusted,10607,11122,515,4.6
9339,2014,December,Calhoun                                              ,Not Adjusted,10978,11394,416,3.7
9340,2014,March,Callahan                                             ,Not Adjusted,5554,5841,287,4.9
9341,2014,June,Callahan                                             ,Not Adjusted,5565,5847,282,4.8
9342,2014,September,Callahan                                             ,Not Adjusted,5557,5815,258,4.4
9343,2014,December,Callahan                                             ,Not Adjusted,5542,5755,213,3.7
9344,2014,March,Cameron                                              ,Not Adjusted,152748,167761,15013,8.9
9345,2014,June,Cameron                                              ,Not Adjusted,153227,168043,14816,8.8
9346,2014,September,Cameron                                              ,Not Adjusted,151639,164700,13061,7.9
9347,2014,December,Cameron                                              ,Not Adjusted,151635,163616,11981,7.3
9348,2014,March,Camp                                                 ,Not Adjusted,4897,5237,340,6.5
9349,2014,June,Camp                                                 ,Not Adjusted,4870,5210,340,6.5
9350,2014,September,Camp                                                 ,Not Adjusted,4933,5243,310,5.9
9351,2014,December,Camp                                                 ,Not Adjusted,4834,5107,273,5.3
9352,2014,March,Carson                                               ,Not Adjusted,3041,3158,117,3.7
9353,2014,June,Carson                                               ,Not Adjusted,3075,3193,118,3.7
9354,2014,September,Carson                                               ,Not Adjusted,3027,3127,100,3.2
9355,2014,December,Carson                                               ,Not Adjusted,2993,3077,84,2.7
9356,2014,March,Cass                                                 ,Not Adjusted,11401,12405,1004,8.1
9357,2014,June,Cass                                                 ,Not Adjusted,11429,12436,1007,8.1
9358,2014,September,Cass                                                 ,Not Adjusted,11263,12183,920,7.6
9359,2014,December,Cass                                                 ,Not Adjusted,11166,11961,795,6.6
9360,2014,March,Castro                                               ,Not Adjusted,3662,3818,156,4.1
9361,2014,June,Castro                                               ,Not Adjusted,3750,3919,169,4.3
9362,2014,September,Castro                                               ,Not Adjusted,3660,3813,153,4.0
9363,2014,December,Castro                                               ,Not Adjusted,3501,3622,121,3.3
9364,2014,March,Chambers                                             ,Not Adjusted,16681,17769,1088,6.1
9365,2014,June,Chambers                                             ,Not Adjusted,16731,17861,1130,6.3
9366,2014,September,Chambers                                             ,Not Adjusted,16848,17852,1004,5.6
9367,2014,December,Chambers                                             ,Not Adjusted,17004,17873,869,4.9
9368,2014,March,Cherokee                                             ,Not Adjusted,19989,21291,1302,6.1
9369,2014,June,Cherokee                                             ,Not Adjusted,20083,21394,1311,6.1
9370,2014,September,Cherokee                                             ,Not Adjusted,19843,21073,1230,5.8
9371,2014,December,Cherokee                                             ,Not Adjusted,19696,20710,1014,4.9
9372,2014,March,Childress                                            ,Not Adjusted,2755,2859,104,3.6
9373,2014,June,Childress                                            ,Not Adjusted,2812,2929,117,4.0
9374,2014,September,Childress                                            ,Not Adjusted,2746,2853,107,3.8
9375,2014,December,Childress                                            ,Not Adjusted,2705,2790,85,3.0
9376,2014,March,Clay                                                 ,Not Adjusted,4812,5067,255,5.0
9377,2014,June,Clay                                                 ,Not Adjusted,4833,5083,250,4.9
9378,2014,September,Clay                                                 ,Not Adjusted,4776,5010,234,4.7
9379,2014,December,Clay                                                 ,Not Adjusted,4699,4880,181,3.7
9380,2014,March,Cochran                                              ,Not Adjusted,1308,1394,86,6.2
9381,2014,June,Cochran                                              ,Not Adjusted,1383,1466,83,5.7
9382,2014,September,Cochran                                              ,Not Adjusted,1354,1420,66,4.6
9383,2014,December,Cochran                                              ,Not Adjusted,1259,1311,52,4.0
9384,2014,March,Coke                                                 ,Not Adjusted,1383,1450,67,4.6
9385,2014,June,Coke                                                 ,Not Adjusted,1425,1488,63,4.2
9386,2014,September,Coke                                                 ,Not Adjusted,1343,1404,61,4.3
9387,2014,December,Coke                                                 ,Not Adjusted,1346,1400,54,3.9
9388,2014,March,Coleman                                              ,Not Adjusted,2938,3135,197,6.3
9389,2014,June,Coleman                                              ,Not Adjusted,2969,3179,210,6.6
9390,2014,September,Coleman                                              ,Not Adjusted,2945,3140,195,6.2
9391,2014,December,Coleman                                              ,Not Adjusted,2896,3051,155,5.1
9392,2014,March,Collin                                               ,Not Adjusted,446928,470436,23508,5.0
9393,2014,June,Collin                                               ,Not Adjusted,450645,473961,23316,4.9
9394,2014,September,Collin                                               ,Not Adjusted,454224,475540,21316,4.5
9395,2014,December,Collin                                               ,Not Adjusted,458909,476522,17613,3.7
9396,2014,March,Collingsworth                                        ,Not Adjusted,1214,1272,58,4.6
9397,2014,June,Collingsworth                                        ,Not Adjusted,1240,1296,56,4.3
9398,2014,September,Collingsworth                                        ,Not Adjusted,1203,1254,51,4.1
9399,2014,December,Collingsworth                                        ,Not Adjusted,1178,1216,38,3.1
9400,2014,March,Colorado                                             ,Not Adjusted,9762,10267,505,4.9
9401,2014,June,Colorado                                             ,Not Adjusted,10153,10649,496,4.7
9402,2014,September,Colorado                                             ,Not Adjusted,9673,10127,454,4.5
9403,2014,December,Colorado                                             ,Not Adjusted,9619,9976,357,3.6
9404,2014,March,Comal                                                ,Not Adjusted,56639,59606,2967,5.0
9405,2014,June,Comal                                                ,Not Adjusted,57128,60073,2945,4.9
9406,2014,September,Comal                                                ,Not Adjusted,57202,59893,2691,4.5
9407,2014,December,Comal                                                ,Not Adjusted,57498,59715,2217,3.7
9408,2014,March,Comanche                                             ,Not Adjusted,5235,5513,278,5.0
9409,2014,June,Comanche                                             ,Not Adjusted,5407,5694,287,5.0
9410,2014,September,Comanche                                             ,Not Adjusted,5224,5496,272,4.9
9411,2014,December,Comanche                                             ,Not Adjusted,5121,5340,219,4.1
9412,2014,March,Concho                                               ,Not Adjusted,1393,1440,47,3.3
9413,2014,June,Concho                                               ,Not Adjusted,1417,1461,44,3.0
9414,2014,September,Concho                                               ,Not Adjusted,1359,1402,43,3.1
9415,2014,December,Concho                                               ,Not Adjusted,1290,1326,36,2.7
9416,2014,March,Cooke                                                ,Not Adjusted,19559,20447,888,4.3
9417,2014,June,Cooke                                                ,Not Adjusted,19853,20723,870,4.2
9418,2014,September,Cooke                                                ,Not Adjusted,19765,20525,760,3.7
9419,2014,December,Cooke                                                ,Not Adjusted,19928,20542,614,3.0
9420,2014,March,Coryell                                              ,Not Adjusted,23158,24729,1571,6.4
9421,2014,June,Coryell                                              ,Not Adjusted,23181,24778,1597,6.4
9422,2014,September,Coryell                                              ,Not Adjusted,23127,24573,1446,5.9
9423,2014,December,Coryell                                              ,Not Adjusted,23270,24481,1211,4.9
9424,2014,March,Cottle                                               ,Not Adjusted,582,616,34,5.5
9425,2014,June,Cottle                                               ,Not Adjusted,577,614,37,6.0
9426,2014,September,Cottle                                               ,Not Adjusted,552,584,32,5.5
9427,2014,December,Cottle                                               ,Not Adjusted,526,570,44,7.7
9428,2014,March,Crane                                                ,Not Adjusted,1983,2062,79,3.8
9429,2014,June,Crane                                                ,Not Adjusted,1887,1984,97,4.9
9430,2014,September,Crane                                                ,Not Adjusted,1895,1977,82,4.1
9431,2014,December,Crane                                                ,Not Adjusted,1846,1917,71,3.7
9432,2014,March,Crockett                                             ,Not Adjusted,1757,1842,85,4.6
9433,2014,June,Crockett                                             ,Not Adjusted,1901,1976,75,3.8
9434,2014,September,Crockett                                             ,Not Adjusted,1938,2011,73,3.6
9435,2014,December,Crockett                                             ,Not Adjusted,1894,1952,58,3.0
9436,2014,March,Crosby                                               ,Not Adjusted,2575,2715,140,5.2
9437,2014,June,Crosby                                               ,Not Adjusted,2615,2754,139,5.0
9438,2014,September,Crosby                                               ,Not Adjusted,2570,2698,128,4.7
9439,2014,December,Crosby                                               ,Not Adjusted,2487,2592,105,4.1
9440,2014,March,Culberson                                            ,Not Adjusted,931,974,43,4.4
9441,2014,June,Culberson                                            ,Not Adjusted,1008,1053,45,4.3
9442,2014,September,Culberson                                            ,Not Adjusted,1017,1060,43,4.1
9443,2014,December,Culberson                                            ,Not Adjusted,963,1002,39,3.9
9444,2014,March,Dallam                                               ,Not Adjusted,3787,3909,122,3.1
9445,2014,June,Dallam                                               ,Not Adjusted,3908,4039,131,3.2
9446,2014,September,Dallam                                               ,Not Adjusted,3799,3909,110,2.8
9447,2014,December,Dallam                                               ,Not Adjusted,3656,3747,91,2.4
9448,2014,March,Dallas                                               ,Not Adjusted,1168431,1241062,72631,5.9
9449,2014,June,Dallas                                               ,Not Adjusted,1177923,1250257,72334,5.8
9450,2014,September,Dallas                                               ,Not Adjusted,1187818,1254952,67134,5.3
9451,2014,December,Dallas                                               ,Not Adjusted,1199980,1256036,56056,4.5
9452,2014,March,Dawson                                               ,Not Adjusted,4695,4964,269,5.4
9453,2014,June,Dawson                                               ,Not Adjusted,4616,4881,265,5.4
9454,2014,September,Dawson                                               ,Not Adjusted,4643,4865,222,4.6
9455,2014,December,Dawson                                               ,Not Adjusted,4737,4914,177,3.6
9456,2014,March,Deaf Smith                                           ,Not Adjusted,8749,9106,357,3.9
9457,2014,June,Deaf Smith                                           ,Not Adjusted,8951,9323,372,4.0
9458,2014,September,Deaf Smith                                           ,Not Adjusted,8806,9128,322,3.5
9459,2014,December,Deaf Smith                                           ,Not Adjusted,8548,8815,267,3.0
9460,2014,March,Delta                                                ,Not Adjusted,2519,2685,166,6.2
9461,2014,June,Delta                                                ,Not Adjusted,2508,2678,170,6.3
9462,2014,September,Delta                                                ,Not Adjusted,2486,2658,172,6.5
9463,2014,December,Delta                                                ,Not Adjusted,2454,2591,137,5.3
9464,2014,March,Denton                                               ,Not Adjusted,390878,410944,20066,4.9
9465,2014,June,Denton                                               ,Not Adjusted,394163,414045,19882,4.8
9466,2014,September,Denton                                               ,Not Adjusted,397174,415263,18089,4.4
9467,2014,December,Denton                                               ,Not Adjusted,401367,416359,14992,3.6
9468,2014,March,DeWitt                                               ,Not Adjusted,9434,9836,402,4.1
9469,2014,June,DeWitt                                               ,Not Adjusted,9738,10163,425,4.2
9470,2014,September,DeWitt                                               ,Not Adjusted,9678,10055,377,3.7
9471,2014,December,DeWitt                                               ,Not Adjusted,9735,10045,310,3.1
9472,2014,March,Dickens                                              ,Not Adjusted,686,744,58,7.8
9473,2014,June,Dickens                                              ,Not Adjusted,721,767,46,6.0
9474,2014,September,Dickens                                              ,Not Adjusted,702,745,43,5.8
9475,2014,December,Dickens                                              ,Not Adjusted,673,706,33,4.7
9476,2014,March,Dimmit                                               ,Not Adjusted,6914,7219,305,4.2
9477,2014,June,Dimmit                                               ,Not Adjusted,7286,7614,328,4.3
9478,2014,September,Dimmit                                               ,Not Adjusted,7676,7952,276,3.5
9479,2014,December,Dimmit                                               ,Not Adjusted,7834,8078,244,3.0
9480,2014,March,Donley                                               ,Not Adjusted,1561,1638,77,4.7
9481,2014,June,Donley                                               ,Not Adjusted,1545,1638,93,5.7
9482,2014,September,Donley                                               ,Not Adjusted,1530,1608,78,4.9
9483,2014,December,Donley                                               ,Not Adjusted,1517,1577,60,3.8
9484,2014,March,Duval                                                ,Not Adjusted,5203,5533,330,6.0
9485,2014,June,Duval                                                ,Not Adjusted,5283,5615,332,5.9
9486,2014,September,Duval                                                ,Not Adjusted,5223,5526,303,5.5
9487,2014,December,Duval                                                ,Not Adjusted,5150,5416,266,4.9
9488,2014,March,Eastland                                             ,Not Adjusted,7955,8379,424,5.1
9489,2014,June,Eastland                                             ,Not Adjusted,7894,8344,450,5.4
9490,2014,September,Eastland                                             ,Not Adjusted,7914,8316,402,4.8
9491,2014,December,Eastland                                             ,Not Adjusted,8049,8375,326,3.9
9492,2014,March,Ector                                                ,Not Adjusted,77790,80803,3013,3.7
9493,2014,June,Ector                                                ,Not Adjusted,78807,81948,3141,3.8
9494,2014,September,Ector                                                ,Not Adjusted,80901,83648,2747,3.3
9495,2014,December,Ector                                                ,Not Adjusted,81673,84098,2425,2.9
9496,2014,March,Edwards                                              ,Not Adjusted,819,861,42,4.9
9497,2014,June,Edwards                                              ,Not Adjusted,857,895,38,4.2
9498,2014,September,Edwards                                              ,Not Adjusted,826,862,36,4.2
9499,2014,December,Edwards                                              ,Not Adjusted,799,829,30,3.6
9500,2014,March,Ellis                                                ,Not Adjusted,74272,78491,4219,5.4
9501,2014,June,Ellis                                                ,Not Adjusted,74914,79185,4271,5.4
9502,2014,September,Ellis                                                ,Not Adjusted,75494,79301,3807,4.8
9503,2014,December,Ellis                                                ,Not Adjusted,76181,79284,3103,3.9
9504,2014,March,El Paso                                              ,Not Adjusted,323819,347407,23588,6.8
9505,2014,June,El Paso                                              ,Not Adjusted,320527,344394,23867,6.9
9506,2014,September,El Paso                                              ,Not Adjusted,320118,341967,21849,6.4
9507,2014,December,El Paso                                              ,Not Adjusted,322109,340185,18076,5.3
9508,2014,March,Erath                                                ,Not Adjusted,19328,20216,888,4.4
9509,2014,June,Erath                                                ,Not Adjusted,19383,20376,993,4.9
9510,2014,September,Erath                                                ,Not Adjusted,19188,20024,836,4.2
9511,2014,December,Erath                                                ,Not Adjusted,18950,19621,671,3.4
9512,2014,March,Falls                                                ,Not Adjusted,6133,6509,376,5.8
9513,2014,June,Falls                                                ,Not Adjusted,6220,6613,393,5.9
9514,2014,September,Falls                                                ,Not Adjusted,6187,6563,376,5.7
9515,2014,December,Falls                                                ,Not Adjusted,6165,6453,288,4.5
9516,2014,March,Fannin                                               ,Not Adjusted,14435,15306,871,5.7
9517,2014,June,Fannin                                               ,Not Adjusted,14529,15390,861,5.6
9518,2014,September,Fannin                                               ,Not Adjusted,14457,15259,802,5.3
9519,2014,December,Fannin                                               ,Not Adjusted,14351,15021,670,4.5
9520,2014,March,Fayette                                              ,Not Adjusted,12505,12961,456,3.5
9521,2014,June,Fayette                                              ,Not Adjusted,12734,13219,485,3.7
9522,2014,September,Fayette                                              ,Not Adjusted,12607,13069,462,3.5
9523,2014,December,Fayette                                              ,Not Adjusted,12470,12856,386,3.0
9524,2014,March,Fisher                                               ,Not Adjusted,1791,1881,90,4.8
9525,2014,June,Fisher                                               ,Not Adjusted,1789,1881,92,4.9
9526,2014,September,Fisher                                               ,Not Adjusted,1774,1858,84,4.5
9527,2014,December,Fisher                                               ,Not Adjusted,1725,1788,63,3.5
9528,2014,March,Floyd                                                ,Not Adjusted,2807,3061,254,8.3
9529,2014,June,Floyd                                                ,Not Adjusted,2811,3031,220,7.3
9530,2014,September,Floyd                                                ,Not Adjusted,2675,2870,195,6.8
9531,2014,December,Floyd                                                ,Not Adjusted,2545,2707,162,6.0
9532,2014,March,Foard                                                ,Not Adjusted,555,582,27,4.6
9533,2014,June,Foard                                                ,Not Adjusted,567,596,29,4.9
9534,2014,September,Foard                                                ,Not Adjusted,562,584,22,3.8
9535,2014,December,Foard                                                ,Not Adjusted,528,549,21,3.8
9536,2014,March,Fort Bend                                            ,Not Adjusted,328736,345246,16510,4.8
9537,2014,June,Fort Bend                                            ,Not Adjusted,329757,346720,16963,4.9
9538,2014,September,Fort Bend                                            ,Not Adjusted,332099,347721,15622,4.5
9539,2014,December,Fort Bend                                            ,Not Adjusted,335042,348185,13143,3.8
9540,2014,March,Franklin                                             ,Not Adjusted,4439,4690,251,5.4
9541,2014,June,Franklin                                             ,Not Adjusted,4477,4737,260,5.5
9542,2014,September,Franklin                                             ,Not Adjusted,4429,4679,250,5.3
9543,2014,December,Franklin                                             ,Not Adjusted,4331,4521,190,4.2
9544,2014,March,Freestone                                            ,Not Adjusted,7389,7847,458,5.8
9545,2014,June,Freestone                                            ,Not Adjusted,7403,7887,484,6.1
9546,2014,September,Freestone                                            ,Not Adjusted,7491,7924,433,5.5
9547,2014,December,Freestone                                            ,Not Adjusted,7307,7668,361,4.7
9548,2014,March,Frio                                                 ,Not Adjusted,9781,10152,371,3.7
9549,2014,June,Frio                                                 ,Not Adjusted,9957,10374,417,4.0
9550,2014,September,Frio                                                 ,Not Adjusted,10163,10522,359,3.4
9551,2014,December,Frio                                                 ,Not Adjusted,9993,10309,316,3.1
9552,2014,March,Gaines                                               ,Not Adjusted,8863,9182,319,3.5
9553,2014,June,Gaines                                               ,Not Adjusted,9167,9515,348,3.7
9554,2014,September,Gaines                                               ,Not Adjusted,9138,9434,296,3.1
9555,2014,December,Gaines                                               ,Not Adjusted,8964,9210,246,2.7
9556,2014,March,Galveston                                            ,Not Adjusted,147610,156935,9325,5.9
9557,2014,June,Galveston                                            ,Not Adjusted,148127,157724,9597,6.1
9558,2014,September,Galveston                                            ,Not Adjusted,149106,157893,8787,5.6
9559,2014,December,Galveston                                            ,Not Adjusted,150319,157994,7675,4.9
9560,2014,March,Garza                                                ,Not Adjusted,2153,2244,91,4.1
9561,2014,June,Garza                                                ,Not Adjusted,2201,2288,87,3.8
9562,2014,September,Garza                                                ,Not Adjusted,2170,2249,79,3.5
9563,2014,December,Garza                                                ,Not Adjusted,2110,2173,63,2.9
9564,2014,March,Gillespie                                            ,Not Adjusted,11943,12409,466,3.8
9565,2014,June,Gillespie                                            ,Not Adjusted,12091,12565,474,3.8
9566,2014,September,Gillespie                                            ,Not Adjusted,12051,12505,454,3.6
9567,2014,December,Gillespie                                            ,Not Adjusted,12289,12652,363,2.9
9568,2014,March,Glasscock                                            ,Not Adjusted,780,803,23,2.9
9569,2014,June,Glasscock                                            ,Not Adjusted,836,861,25,2.9
9570,2014,September,Glasscock                                            ,Not Adjusted,818,840,22,2.6
9571,2014,December,Glasscock                                            ,Not Adjusted,808,825,17,2.1
9572,2014,March,Goliad                                               ,Not Adjusted,3397,3544,147,4.1
9573,2014,June,Goliad                                               ,Not Adjusted,3419,3582,163,4.6
9574,2014,September,Goliad                                               ,Not Adjusted,3448,3595,147,4.1
9575,2014,December,Goliad                                               ,Not Adjusted,3440,3557,117,3.3
9576,2014,March,Gonzales                                             ,Not Adjusted,9415,9822,407,4.1
9577,2014,June,Gonzales                                             ,Not Adjusted,9705,10123,418,4.1
9578,2014,September,Gonzales                                             ,Not Adjusted,9596,9973,377,3.8
9579,2014,December,Gonzales                                             ,Not Adjusted,9444,9750,306,3.1
9580,2014,March,Gray                                                 ,Not Adjusted,9307,9733,426,4.4
9581,2014,June,Gray                                                 ,Not Adjusted,9455,9873,418,4.2
9582,2014,September,Gray                                                 ,Not Adjusted,9471,9859,388,3.9
9583,2014,December,Gray                                                 ,Not Adjusted,9366,9676,310,3.2
9584,2014,March,Grayson                                              ,Not Adjusted,57513,60702,3189,5.3
9585,2014,June,Grayson                                              ,Not Adjusted,57505,60641,3136,5.2
9586,2014,September,Grayson                                              ,Not Adjusted,57160,60045,2885,4.8
9587,2014,December,Grayson                                              ,Not Adjusted,57073,59475,2402,4.0
9588,2014,March,Gregg                                                ,Not Adjusted,57465,60696,3231,5.3
9589,2014,June,Gregg                                                ,Not Adjusted,58181,61362,3181,5.2
9590,2014,September,Gregg                                                ,Not Adjusted,58552,61427,2875,4.7
9591,2014,December,Gregg                                                ,Not Adjusted,58405,60812,2407,4.0
9592,2014,March,Grimes                                               ,Not Adjusted,11166,11790,624,5.3
9593,2014,June,Grimes                                               ,Not Adjusted,11246,11874,628,5.3
9594,2014,September,Grimes                                               ,Not Adjusted,11298,11831,533,4.5
9595,2014,December,Grimes                                               ,Not Adjusted,11193,11648,455,3.9
9596,2014,March,Guadalupe                                            ,Not Adjusted,67916,71215,3299,4.6
9597,2014,June,Guadalupe                                            ,Not Adjusted,68543,71880,3337,4.6
9598,2014,September,Guadalupe                                            ,Not Adjusted,68480,71577,3097,4.3
9599,2014,December,Guadalupe                                            ,Not Adjusted,68901,71422,2521,3.5
9600,2014,March,Hale                                                 ,Not Adjusted,12230,13830,1600,11.6
9601,2014,June,Hale                                                 ,Not Adjusted,12325,13729,1404,10.2
9602,2014,September,Hale                                                 ,Not Adjusted,12338,13429,1091,8.1
9603,2014,December,Hale                                                 ,Not Adjusted,12010,12884,874,6.8
9604,2014,March,Hall                                                 ,Not Adjusted,1178,1268,90,7.1
9605,2014,June,Hall                                                 ,Not Adjusted,1222,1310,88,6.7
9606,2014,September,Hall                                                 ,Not Adjusted,1192,1269,77,6.1
9607,2014,December,Hall                                                 ,Not Adjusted,1156,1210,54,4.5
9608,2014,March,Hamilton                                             ,Not Adjusted,3396,3570,174,4.9
9609,2014,June,Hamilton                                             ,Not Adjusted,3446,3631,185,5.1
9610,2014,September,Hamilton                                             ,Not Adjusted,3401,3565,164,4.6
9611,2014,December,Hamilton                                             ,Not Adjusted,3344,3477,133,3.8
9612,2014,March,Hansford                                             ,Not Adjusted,3090,3175,85,2.7
9613,2014,June,Hansford                                             ,Not Adjusted,3275,3367,92,2.7
9614,2014,September,Hansford                                             ,Not Adjusted,3153,3239,86,2.7
9615,2014,December,Hansford                                             ,Not Adjusted,3110,3175,65,2.0
9616,2014,March,Hardeman                                             ,Not Adjusted,1553,1639,86,5.2
9617,2014,June,Hardeman                                             ,Not Adjusted,1590,1682,92,5.5
9618,2014,September,Hardeman                                             ,Not Adjusted,1589,1666,77,4.6
9619,2014,December,Hardeman                                             ,Not Adjusted,1524,1597,73,4.6
9620,2014,March,Hardin                                               ,Not Adjusted,23529,25263,1734,6.9
9621,2014,June,Hardin                                               ,Not Adjusted,23745,25419,1674,6.6
9622,2014,September,Hardin                                               ,Not Adjusted,23845,25414,1569,6.2
9623,2014,December,Hardin                                               ,Not Adjusted,24026,25350,1324,5.2
9624,2014,March,Harris                                               ,Not Adjusted,2101913,2220098,118185,5.3
9625,2014,June,Harris                                               ,Not Adjusted,2108305,2228298,119993,5.4
9626,2014,September,Harris                                               ,Not Adjusted,2124158,2234391,110233,4.9
9627,2014,December,Harris                                               ,Not Adjusted,2142332,2235865,93533,4.2
9628,2014,March,Harrison                                             ,Not Adjusted,30430,32340,1910,5.9
9629,2014,June,Harrison                                             ,Not Adjusted,30379,32295,1916,5.9
9630,2014,September,Harrison                                             ,Not Adjusted,30449,32180,1731,5.4
9631,2014,December,Harrison                                             ,Not Adjusted,30700,32131,1431,4.5
9632,2014,March,Hartley                                              ,Not Adjusted,2851,2925,74,2.5
9633,2014,June,Hartley                                              ,Not Adjusted,2907,2988,81,2.7
9634,2014,September,Hartley                                              ,Not Adjusted,2831,2905,74,2.5
9635,2014,December,Hartley                                              ,Not Adjusted,2764,2824,60,2.1
9636,2014,March,Haskell                                              ,Not Adjusted,2573,2691,118,4.4
9637,2014,June,Haskell                                              ,Not Adjusted,2611,2731,120,4.4
9638,2014,September,Haskell                                              ,Not Adjusted,2598,2705,107,4.0
9639,2014,December,Haskell                                              ,Not Adjusted,2534,2620,86,3.3
9640,2014,March,Hays                                                 ,Not Adjusted,89459,93645,4186,4.5
9641,2014,June,Hays                                                 ,Not Adjusted,89814,94264,4450,4.7
9642,2014,September,Hays                                                 ,Not Adjusted,90047,94056,4009,4.3
9643,2014,December,Hays                                                 ,Not Adjusted,90784,94102,3318,3.5
9644,2014,March,Hemphill                                             ,Not Adjusted,2449,2510,61,2.4
9645,2014,June,Hemphill                                             ,Not Adjusted,2526,2594,68,2.6
9646,2014,September,Hemphill                                             ,Not Adjusted,2522,2582,60,2.3
9647,2014,December,Hemphill                                             ,Not Adjusted,2383,2433,50,2.1
9648,2014,March,Henderson                                            ,Not Adjusted,32648,34773,2125,6.1
9649,2014,June,Henderson                                            ,Not Adjusted,33055,35142,2087,5.9
9650,2014,September,Henderson                                            ,Not Adjusted,32950,34836,1886,5.4
9651,2014,December,Henderson                                            ,Not Adjusted,32581,34181,1600,4.7
9652,2014,March,Hidalgo                                              ,Not Adjusted,302357,333912,31555,9.5
9653,2014,June,Hidalgo                                              ,Not Adjusted,302397,333657,31260,9.4
9654,2014,September,Hidalgo                                              ,Not Adjusted,301366,328513,27147,8.3
9655,2014,December,Hidalgo                                              ,Not Adjusted,305969,331976,26007,7.8
9656,2014,March,Hill                                                 ,Not Adjusted,15023,15930,907,5.7
9657,2014,June,Hill                                                 ,Not Adjusted,15009,15951,942,5.9
9658,2014,September,Hill                                                 ,Not Adjusted,15101,15893,792,5.0
9659,2014,December,Hill                                                 ,Not Adjusted,14983,15641,658,4.2
9660,2014,March,Hockley                                              ,Not Adjusted,11514,12015,501,4.2
9661,2014,June,Hockley                                              ,Not Adjusted,11636,12163,527,4.3
9662,2014,September,Hockley                                              ,Not Adjusted,11564,12020,456,3.8
9663,2014,December,Hockley                                              ,Not Adjusted,11700,12062,362,3.0
9664,2014,March,Hood                                                 ,Not Adjusted,22892,24168,1276,5.3
9665,2014,June,Hood                                                 ,Not Adjusted,23088,24381,1293,5.3
9666,2014,September,Hood                                                 ,Not Adjusted,23111,24285,1174,4.8
9667,2014,December,Hood                                                 ,Not Adjusted,23213,24225,1012,4.2
9668,2014,March,Hopkins                                              ,Not Adjusted,16720,17597,877,5.0
9669,2014,June,Hopkins                                              ,Not Adjusted,16521,17403,882,5.1
9670,2014,September,Hopkins                                              ,Not Adjusted,16958,17782,824,4.6
9671,2014,December,Hopkins                                              ,Not Adjusted,16522,17187,665,3.9
9672,2014,March,Houston                                              ,Not Adjusted,9096,9619,523,5.4
9673,2014,June,Houston                                              ,Not Adjusted,9398,9929,531,5.3
9674,2014,September,Houston                                              ,Not Adjusted,9328,9805,477,4.9
9675,2014,December,Houston                                              ,Not Adjusted,9358,9768,410,4.2
9676,2014,March,Howard                                               ,Not Adjusted,12947,13602,655,4.8
9677,2014,June,Howard                                               ,Not Adjusted,12988,13634,646,4.7
9678,2014,September,Howard                                               ,Not Adjusted,13040,13624,584,4.3
9679,2014,December,Howard                                               ,Not Adjusted,13006,13477,471,3.5
9680,2014,March,Hudspeth                                             ,Not Adjusted,1180,1269,89,7.0
9681,2014,June,Hudspeth                                             ,Not Adjusted,1189,1275,86,6.7
9682,2014,September,Hudspeth                                             ,Not Adjusted,1167,1244,77,6.2
9683,2014,December,Hudspeth                                             ,Not Adjusted,1139,1204,65,5.4
9684,2014,March,Hunt                                                 ,Not Adjusted,35850,38296,2446,6.4
9685,2014,June,Hunt                                                 ,Not Adjusted,36174,38606,2432,6.3
9686,2014,September,Hunt                                                 ,Not Adjusted,36441,38774,2333,6.0
9687,2014,December,Hunt                                                 ,Not Adjusted,36732,38675,1943,5.0
9688,2014,March,Hutchinson                                           ,Not Adjusted,9703,10198,495,4.9
9689,2014,June,Hutchinson                                           ,Not Adjusted,10145,10645,500,4.7
9690,2014,September,Hutchinson                                           ,Not Adjusted,10072,10506,434,4.1
9691,2014,December,Hutchinson                                           ,Not Adjusted,10398,10777,379,3.5
9692,2014,March,Irion                                                ,Not Adjusted,801,834,33,4.0
9693,2014,June,Irion                                                ,Not Adjusted,808,840,32,3.8
9694,2014,September,Irion                                                ,Not Adjusted,807,834,27,3.2
9695,2014,December,Irion                                                ,Not Adjusted,789,819,30,3.7
9696,2014,March,Jack                                                 ,Not Adjusted,4067,4242,175,4.1
9697,2014,June,Jack                                                 ,Not Adjusted,4230,4411,181,4.1
9698,2014,September,Jack                                                 ,Not Adjusted,4191,4348,157,3.6
9699,2014,December,Jack                                                 ,Not Adjusted,4129,4255,126,3.0
9700,2014,March,Jackson                                              ,Not Adjusted,7237,7568,331,4.4
9701,2014,June,Jackson                                              ,Not Adjusted,7439,7771,332,4.3
9702,2014,September,Jackson                                              ,Not Adjusted,7508,7797,289,3.7
9703,2014,December,Jackson                                              ,Not Adjusted,7219,7463,244,3.3
9704,2014,March,Jasper                                               ,Not Adjusted,13362,14653,1291,8.8
9705,2014,June,Jasper                                               ,Not Adjusted,13346,14566,1220,8.4
9706,2014,September,Jasper                                               ,Not Adjusted,13298,14440,1142,7.9
9707,2014,December,Jasper                                               ,Not Adjusted,13271,14278,1007,7.1
9708,2014,March,Jeff Davis                                           ,Not Adjusted,1148,1196,48,4.0
9709,2014,June,Jeff Davis                                           ,Not Adjusted,1152,1194,42,3.5
9710,2014,September,Jeff Davis                                           ,Not Adjusted,1105,1143,38,3.3
9711,2014,December,Jeff Davis                                           ,Not Adjusted,1022,1058,36,3.4
9712,2014,March,Jefferson                                            ,Not Adjusted,99858,109914,10056,9.1
9713,2014,June,Jefferson                                            ,Not Adjusted,100778,110038,9260,8.4
9714,2014,September,Jefferson                                            ,Not Adjusted,101216,109971,8755,8.0
9715,2014,December,Jefferson                                            ,Not Adjusted,101937,109724,7787,7.1
9716,2014,March,Jim Hogg                                             ,Not Adjusted,2064,2216,152,6.9
9717,2014,June,Jim Hogg                                             ,Not Adjusted,2103,2245,142,6.3
9718,2014,September,Jim Hogg                                             ,Not Adjusted,2084,2208,124,5.6
9719,2014,December,Jim Hogg                                             ,Not Adjusted,1909,2011,102,5.1
9720,2014,March,Jim Wells                                            ,Not Adjusted,18875,19994,1119,5.6
9721,2014,June,Jim Wells                                            ,Not Adjusted,19004,20179,1175,5.8
9722,2014,September,Jim Wells                                            ,Not Adjusted,19133,20136,1003,5.0
9723,2014,December,Jim Wells                                            ,Not Adjusted,19165,20018,853,4.3
9724,2014,March,Johnson                                              ,Not Adjusted,70095,74163,4068,5.5
9725,2014,June,Johnson                                              ,Not Adjusted,70638,74815,4177,5.6
9726,2014,September,Johnson                                              ,Not Adjusted,70683,74339,3656,4.9
9727,2014,December,Johnson                                              ,Not Adjusted,71262,74286,3024,4.1
9728,2014,March,Jones                                                ,Not Adjusted,5478,5826,348,6.0
9729,2014,June,Jones                                                ,Not Adjusted,5519,5863,344,5.9
9730,2014,September,Jones                                                ,Not Adjusted,5463,5772,309,5.4
9731,2014,December,Jones                                                ,Not Adjusted,5408,5660,252,4.5
9732,2014,March,Karnes                                               ,Not Adjusted,5753,5999,246,4.1
9733,2014,June,Karnes                                               ,Not Adjusted,5947,6192,245,4.0
9734,2014,September,Karnes                                               ,Not Adjusted,6166,6390,224,3.5
9735,2014,December,Karnes                                               ,Not Adjusted,6341,6528,187,2.9
9736,2014,March,Kaufman                                              ,Not Adjusted,50224,53259,3035,5.7
9737,2014,June,Kaufman                                              ,Not Adjusted,50656,53668,3012,5.6
9738,2014,September,Kaufman                                              ,Not Adjusted,51026,53729,2703,5.0
9739,2014,December,Kaufman                                              ,Not Adjusted,51547,53803,2256,4.2
9740,2014,March,Kendall                                              ,Not Adjusted,17782,18598,816,4.4
9741,2014,June,Kendall                                              ,Not Adjusted,17986,18809,823,4.4
9742,2014,September,Kendall                                              ,Not Adjusted,17962,18697,735,3.9
9743,2014,December,Kendall                                              ,Not Adjusted,17930,18544,614,3.3
9744,2014,March,Kenedy                                               ,Not Adjusted,345,361,16,4.4
9745,2014,June,Kenedy                                               ,Not Adjusted,330,340,10,2.9
9746,2014,September,Kenedy                                               ,Not Adjusted,325,334,9,2.7
9747,2014,December,Kenedy                                               ,Not Adjusted,321,328,7,2.1
9748,2014,March,Kent                                                 ,Not Adjusted,486,508,22,4.3
9749,2014,June,Kent                                                 ,Not Adjusted,519,538,19,3.5
9750,2014,September,Kent                                                 ,Not Adjusted,483,500,17,3.4
9751,2014,December,Kent                                                 ,Not Adjusted,471,482,11,2.3
9752,2014,March,Kerr                                                 ,Not Adjusted,20283,21286,1003,4.7
9753,2014,June,Kerr                                                 ,Not Adjusted,20859,21872,1013,4.6
9754,2014,September,Kerr                                                 ,Not Adjusted,20407,21349,942,4.4
9755,2014,December,Kerr                                                 ,Not Adjusted,20378,21145,767,3.6
9756,2014,March,Kimble                                               ,Not Adjusted,2040,2130,90,4.2
9757,2014,June,Kimble                                               ,Not Adjusted,2128,2216,88,4.0
9758,2014,September,Kimble                                               ,Not Adjusted,2004,2087,83,4.0
9759,2014,December,Kimble                                               ,Not Adjusted,1941,2003,62,3.1
9760,2014,March,King                                                 ,Not Adjusted,209,220,11,5.0
9761,2014,June,King                                                 ,Not Adjusted,229,239,10,4.2
9762,2014,September,King                                                 ,Not Adjusted,225,233,8,3.4
9763,2014,December,King                                                 ,Not Adjusted,203,212,9,4.2
9764,2014,March,Kinney                                               ,Not Adjusted,1126,1220,94,7.7
9765,2014,June,Kinney                                               ,Not Adjusted,1176,1259,83,6.6
9766,2014,September,Kinney                                               ,Not Adjusted,1152,1245,93,7.5
9767,2014,December,Kinney                                               ,Not Adjusted,1084,1157,73,6.3
9768,2014,March,Kleberg                                              ,Not Adjusted,14699,15575,876,5.6
9769,2014,June,Kleberg                                              ,Not Adjusted,14166,15126,960,6.3
9770,2014,September,Kleberg                                              ,Not Adjusted,14315,15135,820,5.4
9771,2014,December,Kleberg                                              ,Not Adjusted,14180,14857,677,4.6
9772,2014,March,Knox                                                 ,Not Adjusted,1680,1766,86,4.9
9773,2014,June,Knox                                                 ,Not Adjusted,1705,1784,79,4.4
9774,2014,September,Knox                                                 ,Not Adjusted,1651,1725,74,4.3
9775,2014,December,Knox                                                 ,Not Adjusted,1618,1670,52,3.1
9776,2014,March,Lamar                                                ,Not Adjusted,20817,22303,1486,6.7
9777,2014,June,Lamar                                                ,Not Adjusted,20690,22123,1433,6.5
9778,2014,September,Lamar                                                ,Not Adjusted,20746,22052,1306,5.9
9779,2014,December,Lamar                                                ,Not Adjusted,20804,21902,1098,5.0
9780,2014,March,Lamb                                                 ,Not Adjusted,5798,6143,345,5.6
9781,2014,June,Lamb                                                 ,Not Adjusted,5918,6264,346,5.5
9782,2014,September,Lamb                                                 ,Not Adjusted,5523,5842,319,5.5
9783,2014,December,Lamb                                                 ,Not Adjusted,5339,5606,267,4.8
9784,2014,March,Lampasas                                             ,Not Adjusted,8433,8984,551,6.1
9785,2014,June,Lampasas                                             ,Not Adjusted,8457,9004,547,6.1
9786,2014,September,Lampasas                                             ,Not Adjusted,8431,8911,480,5.4
9787,2014,December,Lampasas                                             ,Not Adjusted,8444,8834,390,4.4
9788,2014,March,La Salle                                             ,Not Adjusted,4289,4440,151,3.4
9789,2014,June,La Salle                                             ,Not Adjusted,4364,4524,160,3.5
9790,2014,September,La Salle                                             ,Not Adjusted,4562,4703,141,3.0
9791,2014,December,La Salle                                             ,Not Adjusted,4505,4638,133,2.9
9792,2014,March,Lavaca                                               ,Not Adjusted,8499,8873,374,4.2
9793,2014,June,Lavaca                                               ,Not Adjusted,8763,9151,388,4.2
9794,2014,September,Lavaca                                               ,Not Adjusted,8576,8930,354,4.0
9795,2014,December,Lavaca                                               ,Not Adjusted,8491,8777,286,3.3
9796,2014,March,Lee                                                  ,Not Adjusted,8513,8919,406,4.6
9797,2014,June,Lee                                                  ,Not Adjusted,8984,9386,402,4.3
9798,2014,September,Lee                                                  ,Not Adjusted,9169,9532,363,3.8
9799,2014,December,Lee                                                  ,Not Adjusted,9214,9512,298,3.1
9800,2014,March,Leon                                                 ,Not Adjusted,6723,7114,391,5.5
9801,2014,June,Leon                                                 ,Not Adjusted,6843,7256,413,5.7
9802,2014,September,Leon                                                 ,Not Adjusted,6998,7397,399,5.4
9803,2014,December,Leon                                                 ,Not Adjusted,6839,7165,326,4.5
9804,2014,March,Liberty                                              ,Not Adjusted,28541,30959,2418,7.8
9805,2014,June,Liberty                                              ,Not Adjusted,28668,31072,2404,7.7
9806,2014,September,Liberty                                              ,Not Adjusted,28829,30957,2128,6.9
9807,2014,December,Liberty                                              ,Not Adjusted,29004,30881,1877,6.1
9808,2014,March,Limestone                                            ,Not Adjusted,8680,9266,586,6.3
9809,2014,June,Limestone                                            ,Not Adjusted,8726,9313,587,6.3
9810,2014,September,Limestone                                            ,Not Adjusted,8616,9130,514,5.6
9811,2014,December,Limestone                                            ,Not Adjusted,8549,8967,418,4.7
9812,2014,March,Lipscomb                                             ,Not Adjusted,1688,1746,58,3.3
9813,2014,June,Lipscomb                                             ,Not Adjusted,1721,1782,61,3.4
9814,2014,September,Lipscomb                                             ,Not Adjusted,1684,1749,65,3.7
9815,2014,December,Lipscomb                                             ,Not Adjusted,1694,1747,53,3.0
9816,2014,March,Live Oak                                             ,Not Adjusted,5883,6113,230,3.8
9817,2014,June,Live Oak                                             ,Not Adjusted,6021,6255,234,3.7
9818,2014,September,Live Oak                                             ,Not Adjusted,6030,6245,215,3.4
9819,2014,December,Live Oak                                             ,Not Adjusted,5593,5785,192,3.3
9820,2014,March,Llano                                                ,Not Adjusted,7661,8112,451,5.6
9821,2014,June,Llano                                                ,Not Adjusted,7824,8264,440,5.3
9822,2014,September,Llano                                                ,Not Adjusted,7623,8048,425,5.3
9823,2014,December,Llano                                                ,Not Adjusted,7514,7859,345,4.4
9824,2014,March,Loving                                               ,Not Adjusted,65,69,4,5.8
9825,2014,June,Loving                                               ,Not Adjusted,79,83,4,4.8
9826,2014,September,Loving                                               ,Not Adjusted,77,81,4,4.9
9827,2014,December,Loving                                               ,Not Adjusted,82,86,4,4.7
9828,2014,March,Lubbock                                              ,Not Adjusted,141624,147687,6063,4.1
9829,2014,June,Lubbock                                              ,Not Adjusted,140838,147620,6782,4.6
9830,2014,September,Lubbock                                              ,Not Adjusted,141575,147265,5690,3.9
9831,2014,December,Lubbock                                              ,Not Adjusted,142101,146697,4596,3.1
9832,2014,March,Lynn                                                 ,Not Adjusted,2738,2869,131,4.6
9833,2014,June,Lynn                                                 ,Not Adjusted,2774,2922,148,5.1
9834,2014,September,Lynn                                                 ,Not Adjusted,2734,2863,129,4.5
9835,2014,December,Lynn                                                 ,Not Adjusted,2661,2756,95,3.4
9836,2014,March,McCulloch                                            ,Not Adjusted,3878,4068,190,4.7
9837,2014,June,McCulloch                                            ,Not Adjusted,3920,4106,186,4.5
9838,2014,September,McCulloch                                            ,Not Adjusted,4011,4178,167,4.0
9839,2014,December,McCulloch                                            ,Not Adjusted,3970,4099,129,3.1
9840,2014,March,McLennan                                             ,Not Adjusted,106017,112024,6007,5.4
9841,2014,June,McLennan                                             ,Not Adjusted,106890,113381,6491,5.7
9842,2014,September,McLennan                                             ,Not Adjusted,107166,112868,5702,5.1
9843,2014,December,McLennan                                             ,Not Adjusted,107969,112490,4521,4.0
9844,2014,March,McMullen                                             ,Not Adjusted,1062,1082,20,1.8
9845,2014,June,McMullen                                             ,Not Adjusted,1058,1077,19,1.8
9846,2014,September,McMullen                                             ,Not Adjusted,1023,1046,23,2.2
9847,2014,December,McMullen                                             ,Not Adjusted,998,1020,22,2.2
9848,2014,March,Madison                                              ,Not Adjusted,4826,5085,259,5.1
9849,2014,June,Madison                                              ,Not Adjusted,4848,5122,274,5.3
9850,2014,September,Madison                                              ,Not Adjusted,4837,5072,235,4.6
9851,2014,December,Madison                                              ,Not Adjusted,4691,4900,209,4.3
9852,2014,March,Marion                                               ,Not Adjusted,4177,4488,311,6.9
9853,2014,June,Marion                                               ,Not Adjusted,4166,4475,309,6.9
9854,2014,September,Marion                                               ,Not Adjusted,4176,4446,270,6.1
9855,2014,December,Marion                                               ,Not Adjusted,4178,4433,255,5.8
9856,2014,March,Martin                                               ,Not Adjusted,2540,2636,96,3.6
9857,2014,June,Martin                                               ,Not Adjusted,2611,2712,101,3.7
9858,2014,September,Martin                                               ,Not Adjusted,2633,2724,91,3.3
9859,2014,December,Martin                                               ,Not Adjusted,2606,2677,71,2.7
9860,2014,March,Mason                                                ,Not Adjusted,1823,1919,96,5.0
9861,2014,June,Mason                                                ,Not Adjusted,1862,1955,93,4.8
9862,2014,September,Mason                                                ,Not Adjusted,1784,1866,82,4.4
9863,2014,December,Mason                                                ,Not Adjusted,1751,1821,70,3.8
9864,2014,March,Matagorda                                            ,Not Adjusted,15877,17238,1361,7.9
9865,2014,June,Matagorda                                            ,Not Adjusted,15313,16751,1438,8.6
9866,2014,September,Matagorda                                            ,Not Adjusted,15281,16542,1261,7.6
9867,2014,December,Matagorda                                            ,Not Adjusted,15252,16403,1151,7.0
9868,2014,March,Maverick                                             ,Not Adjusted,21078,24188,3110,12.9
9869,2014,June,Maverick                                             ,Not Adjusted,20740,23311,2571,11.0
9870,2014,September,Maverick                                             ,Not Adjusted,20627,22787,2160,9.5
9871,2014,December,Maverick                                             ,Not Adjusted,21049,23245,2196,9.4
9872,2014,March,Medina                                               ,Not Adjusted,19252,20344,1092,5.4
9873,2014,June,Medina                                               ,Not Adjusted,19482,20556,1074,5.2
9874,2014,September,Medina                                               ,Not Adjusted,19417,20379,962,4.7
9875,2014,December,Medina                                               ,Not Adjusted,19410,20212,802,4.0
9876,2014,March,Menard                                               ,Not Adjusted,849,895,46,5.1
9877,2014,June,Menard                                               ,Not Adjusted,861,905,44,4.9
9878,2014,September,Menard                                               ,Not Adjusted,831,872,41,4.7
9879,2014,December,Menard                                               ,Not Adjusted,811,849,38,4.5
9880,2014,March,Midland                                              ,Not Adjusted,85933,88692,2759,3.1
9881,2014,June,Midland                                              ,Not Adjusted,87720,90601,2881,3.2
9882,2014,September,Midland                                              ,Not Adjusted,89686,92324,2638,2.9
9883,2014,December,Midland                                              ,Not Adjusted,90440,92591,2151,2.3
9884,2014,March,Milam                                                ,Not Adjusted,9602,10253,651,6.3
9885,2014,June,Milam                                                ,Not Adjusted,9665,10337,672,6.5
9886,2014,September,Milam                                                ,Not Adjusted,9620,10279,659,6.4
9887,2014,December,Milam                                                ,Not Adjusted,9465,10016,551,5.5
9888,2014,March,Mills                                                ,Not Adjusted,1950,2048,98,4.8
9889,2014,June,Mills                                                ,Not Adjusted,1999,2096,97,4.6
9890,2014,September,Mills                                                ,Not Adjusted,1950,2034,84,4.1
9891,2014,December,Mills                                                ,Not Adjusted,1923,1991,68,3.4
9892,2014,March,Mitchell                                             ,Not Adjusted,2762,2889,127,4.4
9893,2014,June,Mitchell                                             ,Not Adjusted,2789,2930,141,4.8
9894,2014,September,Mitchell                                             ,Not Adjusted,2789,2914,125,4.3
9895,2014,December,Mitchell                                             ,Not Adjusted,2786,2887,101,3.5
9896,2014,March,Montague                                             ,Not Adjusted,9753,10196,443,4.3
9897,2014,June,Montague                                             ,Not Adjusted,9940,10362,422,4.1
9898,2014,September,Montague                                             ,Not Adjusted,9699,10085,386,3.8
9899,2014,December,Montague                                             ,Not Adjusted,9621,9950,329,3.3
9900,2014,March,Montgomery                                           ,Not Adjusted,240664,252650,11986,4.7
9901,2014,June,Montgomery                                           ,Not Adjusted,241452,253569,12117,4.8
9902,2014,September,Montgomery                                           ,Not Adjusted,243245,254346,11101,4.4
9903,2014,December,Montgomery                                           ,Not Adjusted,245159,254419,9260,3.6
9904,2014,March,Moore                                                ,Not Adjusted,10926,11328,402,3.5
9905,2014,June,Moore                                                ,Not Adjusted,10891,11333,442,3.9
9906,2014,September,Moore                                                ,Not Adjusted,10917,11312,395,3.5
9907,2014,December,Moore                                                ,Not Adjusted,10605,10918,313,2.9
9908,2014,March,Morris                                               ,Not Adjusted,5288,5750,462,8.0
9909,2014,June,Morris                                               ,Not Adjusted,5196,5668,472,8.3
9910,2014,September,Morris                                               ,Not Adjusted,5133,5560,427,7.7
9911,2014,December,Morris                                               ,Not Adjusted,5113,5496,383,7.0
9912,2014,March,Motley                                               ,Not Adjusted,465,488,23,4.7
9913,2014,June,Motley                                               ,Not Adjusted,499,523,24,4.6
9914,2014,September,Motley                                               ,Not Adjusted,479,498,19,3.8
9915,2014,December,Motley                                               ,Not Adjusted,459,477,18,3.8
9916,2014,March,Nacogdoches                                          ,Not Adjusted,27101,28715,1614,5.6
9917,2014,June,Nacogdoches                                          ,Not Adjusted,26905,28670,1765,6.2
9918,2014,September,Nacogdoches                                          ,Not Adjusted,27115,28593,1478,5.2
9919,2014,December,Nacogdoches                                          ,Not Adjusted,27045,28228,1183,4.2
9920,2014,March,Navarro                                              ,Not Adjusted,21569,22952,1383,6.0
9921,2014,June,Navarro                                              ,Not Adjusted,21727,23065,1338,5.8
9922,2014,September,Navarro                                              ,Not Adjusted,22021,23175,1154,5.0
9923,2014,December,Navarro                                              ,Not Adjusted,21939,22861,922,4.0
9924,2014,March,Newton                                               ,Not Adjusted,5044,5553,509,9.2
9925,2014,June,Newton                                               ,Not Adjusted,5099,5582,483,8.7
9926,2014,September,Newton                                               ,Not Adjusted,5109,5552,443,8.0
9927,2014,December,Newton                                               ,Not Adjusted,5129,5536,407,7.4
9928,2014,March,Nolan                                                ,Not Adjusted,6779,7113,334,4.7
9929,2014,June,Nolan                                                ,Not Adjusted,6744,7076,332,4.7
9930,2014,September,Nolan                                                ,Not Adjusted,6768,7059,291,4.1
9931,2014,December,Nolan                                                ,Not Adjusted,6672,6923,251,3.6
9932,2014,March,Nueces                                               ,Not Adjusted,159932,168990,9058,5.4
9933,2014,June,Nueces                                               ,Not Adjusted,159161,168405,9244,5.5
9934,2014,September,Nueces                                               ,Not Adjusted,159911,168337,8426,5.0
9935,2014,December,Nueces                                               ,Not Adjusted,159602,167115,7513,4.5
9936,2014,March,Ochiltree                                            ,Not Adjusted,5336,5509,173,3.1
9937,2014,June,Ochiltree                                            ,Not Adjusted,5522,5704,182,3.2
9938,2014,September,Ochiltree                                            ,Not Adjusted,5468,5635,167,3.0
9939,2014,December,Ochiltree                                            ,Not Adjusted,5252,5385,133,2.5
9940,2014,March,Oldham                                               ,Not Adjusted,907,945,38,4.0
9941,2014,June,Oldham                                               ,Not Adjusted,920,956,36,3.8
9942,2014,September,Oldham                                               ,Not Adjusted,901,933,32,3.4
9943,2014,December,Oldham                                               ,Not Adjusted,887,913,26,2.8
9944,2014,March,Orange                                               ,Not Adjusted,34464,37796,3332,8.8
9945,2014,June,Orange                                               ,Not Adjusted,34765,37835,3070,8.1
9946,2014,September,Orange                                               ,Not Adjusted,34942,37870,2928,7.7
9947,2014,December,Orange                                               ,Not Adjusted,35218,37768,2550,6.8
9948,2014,March,Palo Pinto                                           ,Not Adjusted,12612,13384,772,5.8
9949,2014,June,Palo Pinto                                           ,Not Adjusted,12777,13506,729,5.4
9950,2014,September,Palo Pinto                                           ,Not Adjusted,12764,13417,653,4.9
9951,2014,December,Palo Pinto                                           ,Not Adjusted,12460,13030,570,4.4
9952,2014,March,Panola                                               ,Not Adjusted,12241,12905,664,5.1
9953,2014,June,Panola                                               ,Not Adjusted,12081,12760,679,5.3
9954,2014,September,Panola                                               ,Not Adjusted,12019,12625,606,4.8
9955,2014,December,Panola                                               ,Not Adjusted,11279,11785,506,4.3
9956,2014,March,Parker                                               ,Not Adjusted,55993,58920,2927,5.0
9957,2014,June,Parker                                               ,Not Adjusted,56454,59410,2956,5.0
9958,2014,September,Parker                                               ,Not Adjusted,56482,59137,2655,4.5
9959,2014,December,Parker                                               ,Not Adjusted,56846,59053,2207,3.7
9960,2014,March,Parmer                                               ,Not Adjusted,4977,5147,170,3.3
9961,2014,June,Parmer                                               ,Not Adjusted,5073,5253,180,3.4
9962,2014,September,Parmer                                               ,Not Adjusted,4969,5124,155,3.0
9963,2014,December,Parmer                                               ,Not Adjusted,4805,4923,118,2.4
9964,2014,March,Pecos                                                ,Not Adjusted,6545,6847,302,4.4
9965,2014,June,Pecos                                                ,Not Adjusted,6571,6894,323,4.7
9966,2014,September,Pecos                                                ,Not Adjusted,6541,6818,277,4.1
9967,2014,December,Pecos                                                ,Not Adjusted,6597,6835,238,3.5
9968,2014,March,Polk                                                 ,Not Adjusted,16069,17263,1194,6.9
9969,2014,June,Polk                                                 ,Not Adjusted,16231,17401,1170,6.7
9970,2014,September,Polk                                                 ,Not Adjusted,16077,17139,1062,6.2
9971,2014,December,Polk                                                 ,Not Adjusted,16044,17021,977,5.7
9972,2014,March,Potter                                               ,Not Adjusted,54419,56837,2418,4.3
9973,2014,June,Potter                                               ,Not Adjusted,54527,57018,2491,4.4
9974,2014,September,Potter                                               ,Not Adjusted,54173,56393,2220,3.9
9975,2014,December,Potter                                               ,Not Adjusted,54551,56373,1822,3.2
9976,2014,March,Presidio                                             ,Not Adjusted,3056,3496,440,12.6
9977,2014,June,Presidio                                             ,Not Adjusted,3034,3467,433,12.5
9978,2014,September,Presidio                                             ,Not Adjusted,2919,3306,387,11.7
9979,2014,December,Presidio                                             ,Not Adjusted,2872,3191,319,10.0
9980,2014,March,Rains                                                ,Not Adjusted,5164,5442,278,5.1
9981,2014,June,Rains                                                ,Not Adjusted,5105,5379,274,5.1
9982,2014,September,Rains                                                ,Not Adjusted,5147,5422,275,5.1
9983,2014,December,Rains                                                ,Not Adjusted,5065,5321,256,4.8
9984,2014,March,Randall                                              ,Not Adjusted,66295,68828,2533,3.7
9985,2014,June,Randall                                              ,Not Adjusted,66499,69114,2615,3.8
9986,2014,September,Randall                                              ,Not Adjusted,65892,68238,2346,3.4
9987,2014,December,Randall                                              ,Not Adjusted,66296,68198,1902,2.8
9988,2014,March,Reagan                                               ,Not Adjusted,1927,1997,70,3.5
9989,2014,June,Reagan                                               ,Not Adjusted,2011,2088,77,3.7
9990,2014,September,Reagan                                               ,Not Adjusted,2070,2133,63,3.0
9991,2014,December,Reagan                                               ,Not Adjusted,2023,2077,54,2.6
9992,2014,March,Real                                                 ,Not Adjusted,979,1053,74,7.0
9993,2014,June,Real                                                 ,Not Adjusted,1104,1177,73,6.2
9994,2014,September,Real                                                 ,Not Adjusted,980,1043,63,6.0
9995,2014,December,Real                                                 ,Not Adjusted,930,980,50,5.1
9996,2014,March,Red River                                            ,Not Adjusted,4571,5001,430,8.6
9997,2014,June,Red River                                            ,Not Adjusted,4516,4919,403,8.2
9998,2014,September,Red River                                            ,Not Adjusted,4532,4890,358,7.3
9999,2014,December,Red River                                            ,Not Adjusted,4595,4899,304,6.2
10000,2014,March,Reeves                                               ,Not Adjusted,5458,5711,253,4.4
10001,2014,June,Reeves                                               ,Not Adjusted,5580,5840,260,4.5
10002,2014,September,Reeves                                               ,Not Adjusted,5521,5741,220,3.8
10003,2014,December,Reeves                                               ,Not Adjusted,5524,5707,183,3.2
10004,2014,March,Refugio                                              ,Not Adjusted,3499,3658,159,4.3
10005,2014,June,Refugio                                              ,Not Adjusted,3471,3637,166,4.6
10006,2014,September,Refugio                                              ,Not Adjusted,3414,3569,155,4.3
10007,2014,December,Refugio                                              ,Not Adjusted,3380,3513,133,3.8
10008,2014,March,Roberts                                              ,Not Adjusted,435,453,18,4.0
10009,2014,June,Roberts                                              ,Not Adjusted,444,462,18,3.9
10010,2014,September,Roberts                                              ,Not Adjusted,440,455,15,3.3
10011,2014,December,Roberts                                              ,Not Adjusted,414,428,14,3.3
10012,2014,March,Robertson                                            ,Not Adjusted,6784,7195,411,5.7
10013,2014,June,Robertson                                            ,Not Adjusted,6641,7058,417,5.9
10014,2014,September,Robertson                                            ,Not Adjusted,6822,7203,381,5.3
10015,2014,December,Robertson                                            ,Not Adjusted,6807,7120,313,4.4
10016,2014,March,Rockwall                                             ,Not Adjusted,40940,43079,2139,5.0
10017,2014,June,Rockwall                                             ,Not Adjusted,41279,43428,2149,4.9
10018,2014,September,Rockwall                                             ,Not Adjusted,41621,43555,1934,4.4
10019,2014,December,Rockwall                                             ,Not Adjusted,42030,43634,1604,3.7
10020,2014,March,Runnels                                              ,Not Adjusted,4799,5013,214,4.3
10021,2014,June,Runnels                                              ,Not Adjusted,4957,5205,248,4.8
10022,2014,September,Runnels                                              ,Not Adjusted,4691,4913,222,4.5
10023,2014,December,Runnels                                              ,Not Adjusted,4592,4757,165,3.5
10024,2014,March,Rusk                                                 ,Not Adjusted,22742,24054,1312,5.5
10025,2014,June,Rusk                                                 ,Not Adjusted,23050,24358,1308,5.4
10026,2014,September,Rusk                                                 ,Not Adjusted,23170,24319,1149,4.7
10027,2014,December,Rusk                                                 ,Not Adjusted,23043,23992,949,4.0
10028,2014,March,Sabine                                               ,Not Adjusted,3152,3551,399,11.2
10029,2014,June,Sabine                                               ,Not Adjusted,3195,3575,380,10.6
10030,2014,September,Sabine                                               ,Not Adjusted,3206,3557,351,9.9
10031,2014,December,Sabine                                               ,Not Adjusted,3083,3439,356,10.4
10032,2014,March,San Augustine                                        ,Not Adjusted,2536,2823,287,10.2
10033,2014,June,San Augustine                                        ,Not Adjusted,2567,2832,265,9.4
10034,2014,September,San Augustine                                        ,Not Adjusted,2555,2836,281,9.9
10035,2014,December,San Augustine                                        ,Not Adjusted,2503,2745,242,8.8
10036,2014,March,San Jacinto                                          ,Not Adjusted,10750,11457,707,6.2
10037,2014,June,San Jacinto                                          ,Not Adjusted,10742,11457,715,6.2
10038,2014,September,San Jacinto                                          ,Not Adjusted,10707,11352,645,5.7
10039,2014,December,San Jacinto                                          ,Not Adjusted,10721,11263,542,4.8
10040,2014,March,San Patricio                                         ,Not Adjusted,28837,30792,1955,6.3
10041,2014,June,San Patricio                                         ,Not Adjusted,28743,30780,2037,6.6
10042,2014,September,San Patricio                                         ,Not Adjusted,28808,30583,1775,5.8
10043,2014,December,San Patricio                                         ,Not Adjusted,28688,30537,1849,6.1
10044,2014,March,San Saba                                             ,Not Adjusted,2114,2214,100,4.5
10045,2014,June,San Saba                                             ,Not Adjusted,2134,2238,104,4.6
10046,2014,September,San Saba                                             ,Not Adjusted,2127,2214,87,3.9
10047,2014,December,San Saba                                             ,Not Adjusted,2160,2231,71,3.2
10048,2014,March,Schleicher                                           ,Not Adjusted,1727,1779,52,2.9
10049,2014,June,Schleicher                                           ,Not Adjusted,1750,1806,56,3.1
10050,2014,September,Schleicher                                           ,Not Adjusted,1738,1792,54,3.0
10051,2014,December,Schleicher                                           ,Not Adjusted,1698,1744,46,2.6
10052,2014,March,Scurry                                               ,Not Adjusted,8142,8447,305,3.6
10053,2014,June,Scurry                                               ,Not Adjusted,8309,8640,331,3.8
10054,2014,September,Scurry                                               ,Not Adjusted,8370,8649,279,3.2
10055,2014,December,Scurry                                               ,Not Adjusted,8367,8590,223,2.6
10056,2014,March,Shackelford                                          ,Not Adjusted,2325,2397,72,3.0
10057,2014,June,Shackelford                                          ,Not Adjusted,2344,2418,74,3.1
10058,2014,September,Shackelford                                          ,Not Adjusted,2289,2349,60,2.6
10059,2014,December,Shackelford                                          ,Not Adjusted,2233,2287,54,2.4
10060,2014,March,Shelby                                               ,Not Adjusted,10905,11654,749,6.4
10061,2014,June,Shelby                                               ,Not Adjusted,10980,11706,726,6.2
10062,2014,September,Shelby                                               ,Not Adjusted,10987,11649,662,5.7
10063,2014,December,Shelby                                               ,Not Adjusted,10837,11380,543,4.8
10064,2014,March,Sherman                                              ,Not Adjusted,1443,1491,48,3.2
10065,2014,June,Sherman                                              ,Not Adjusted,1497,1549,52,3.4
10066,2014,September,Sherman                                              ,Not Adjusted,1436,1486,50,3.4
10067,2014,December,Sherman                                              ,Not Adjusted,1403,1440,37,2.6
10068,2014,March,Smith                                                ,Not Adjusted,95738,101484,5746,5.7
10069,2014,June,Smith                                                ,Not Adjusted,96603,102241,5638,5.5
10070,2014,September,Smith                                                ,Not Adjusted,96655,101952,5297,5.2
10071,2014,December,Smith                                                ,Not Adjusted,98048,102383,4335,4.2
10072,2014,March,Somervell                                            ,Not Adjusted,3895,4089,194,4.7
10073,2014,June,Somervell                                            ,Not Adjusted,3924,4162,238,5.7
10074,2014,September,Somervell                                            ,Not Adjusted,3930,4140,210,5.1
10075,2014,December,Somervell                                            ,Not Adjusted,3960,4163,203,4.9
10076,2014,March,Starr                                                ,Not Adjusted,22572,26567,3995,15.0
10077,2014,June,Starr                                                ,Not Adjusted,22273,25930,3657,14.1
10078,2014,September,Starr                                                ,Not Adjusted,22390,25479,3089,12.1
10079,2014,December,Starr                                                ,Not Adjusted,22359,25699,3340,13.0
10080,2014,March,Stephens                                             ,Not Adjusted,4118,4321,203,4.7
10081,2014,June,Stephens                                             ,Not Adjusted,4110,4313,203,4.7
10082,2014,September,Stephens                                             ,Not Adjusted,4106,4289,183,4.3
10083,2014,December,Stephens                                             ,Not Adjusted,4097,4256,159,3.7
10084,2014,March,Sterling                                             ,Not Adjusted,784,812,28,3.4
10085,2014,June,Sterling                                             ,Not Adjusted,824,848,24,2.8
10086,2014,September,Sterling                                             ,Not Adjusted,791,814,23,2.8
10087,2014,December,Sterling                                             ,Not Adjusted,752,770,18,2.3
10088,2014,March,Stonewall                                            ,Not Adjusted,668,698,30,4.3
10089,2014,June,Stonewall                                            ,Not Adjusted,699,725,26,3.6
10090,2014,September,Stonewall                                            ,Not Adjusted,673,699,26,3.7
10091,2014,December,Stonewall                                            ,Not Adjusted,641,666,25,3.8
10092,2014,March,Sutton                                               ,Not Adjusted,1976,2053,77,3.8
10093,2014,June,Sutton                                               ,Not Adjusted,1988,2064,76,3.7
10094,2014,September,Sutton                                               ,Not Adjusted,1929,1998,69,3.5
10095,2014,December,Sutton                                               ,Not Adjusted,1811,1870,59,3.2
10096,2014,March,Swisher                                              ,Not Adjusted,2709,2911,202,6.9
10097,2014,June,Swisher                                              ,Not Adjusted,2734,2922,188,6.4
10098,2014,September,Swisher                                              ,Not Adjusted,2731,2897,166,5.7
10099,2014,December,Swisher                                              ,Not Adjusted,2637,2764,127,4.6
10100,2014,March,Tarrant                                              ,Not Adjusted,933949,987408,53459,5.4
10101,2014,June,Tarrant                                              ,Not Adjusted,940519,994037,53518,5.4
10102,2014,September,Tarrant                                              ,Not Adjusted,941887,990970,49083,5.0
10103,2014,December,Tarrant                                              ,Not Adjusted,950970,992112,41142,4.1
10104,2014,March,Taylor                                               ,Not Adjusted,61532,64459,2927,4.5
10105,2014,June,Taylor                                               ,Not Adjusted,61584,64588,3004,4.7
10106,2014,September,Taylor                                               ,Not Adjusted,61391,64078,2687,4.2
10107,2014,December,Taylor                                               ,Not Adjusted,61493,63657,2164,3.4
10108,2014,March,Terrell                                              ,Not Adjusted,440,467,27,5.8
10109,2014,June,Terrell                                              ,Not Adjusted,458,478,20,4.2
10110,2014,September,Terrell                                              ,Not Adjusted,448,468,20,4.3
10111,2014,December,Terrell                                              ,Not Adjusted,442,458,16,3.5
10112,2014,March,Terry                                                ,Not Adjusted,5277,5536,259,4.7
10113,2014,June,Terry                                                ,Not Adjusted,5430,5703,273,4.8
10114,2014,September,Terry                                                ,Not Adjusted,5327,5562,235,4.2
10115,2014,December,Terry                                                ,Not Adjusted,5362,5550,188,3.4
10116,2014,March,Throckmorton                                         ,Not Adjusted,800,838,38,4.5
10117,2014,June,Throckmorton                                         ,Not Adjusted,820,855,35,4.1
10118,2014,September,Throckmorton                                         ,Not Adjusted,800,831,31,3.7
10119,2014,December,Throckmorton                                         ,Not Adjusted,778,801,23,2.9
10120,2014,March,Titus                                                ,Not Adjusted,12207,13089,882,6.7
10121,2014,June,Titus                                                ,Not Adjusted,12101,13017,916,7.0
10122,2014,September,Titus                                                ,Not Adjusted,12067,12858,791,6.2
10123,2014,December,Titus                                                ,Not Adjusted,11914,12586,672,5.3
10124,2014,March,Tom Green                                            ,Not Adjusted,52436,54835,2399,4.4
10125,2014,June,Tom Green                                            ,Not Adjusted,52272,54672,2400,4.4
10126,2014,September,Tom Green                                            ,Not Adjusted,52730,54880,2150,3.9
10127,2014,December,Tom Green                                            ,Not Adjusted,52626,54400,1774,3.3
10128,2014,March,Travis                                               ,Not Adjusted,614099,642260,28161,4.4
10129,2014,June,Travis                                               ,Not Adjusted,616306,644190,27884,4.3
10130,2014,September,Travis                                               ,Not Adjusted,618436,645117,26681,4.1
10131,2014,December,Travis                                               ,Not Adjusted,623642,645566,21924,3.4
10132,2014,March,Trinity                                              ,Not Adjusted,5160,5510,350,6.4
10133,2014,June,Trinity                                              ,Not Adjusted,5256,5609,353,6.3
10134,2014,September,Trinity                                              ,Not Adjusted,5257,5582,325,5.8
10135,2014,December,Trinity                                              ,Not Adjusted,5090,5377,287,5.3
10136,2014,March,Tyler                                                ,Not Adjusted,7029,7692,663,8.6
10137,2014,June,Tyler                                                ,Not Adjusted,7014,7644,630,8.2
10138,2014,September,Tyler                                                ,Not Adjusted,6976,7569,593,7.8
10139,2014,December,Tyler                                                ,Not Adjusted,6784,7292,508,7.0
10140,2014,March,Upshur                                               ,Not Adjusted,17414,18455,1041,5.6
10141,2014,June,Upshur                                               ,Not Adjusted,17650,18687,1037,5.5
10142,2014,September,Upshur                                               ,Not Adjusted,17742,18668,926,5.0
10143,2014,December,Upshur                                               ,Not Adjusted,17644,18414,770,4.2
10144,2014,March,Upton                                                ,Not Adjusted,1772,1835,63,3.4
10145,2014,June,Upton                                                ,Not Adjusted,1801,1869,68,3.6
10146,2014,September,Upton                                                ,Not Adjusted,1826,1886,60,3.2
10147,2014,December,Upton                                                ,Not Adjusted,1855,1903,48,2.5
10148,2014,March,Uvalde                                               ,Not Adjusted,11005,11753,748,6.4
10149,2014,June,Uvalde                                               ,Not Adjusted,11158,11861,703,5.9
10150,2014,September,Uvalde                                               ,Not Adjusted,11076,11717,641,5.5
10151,2014,December,Uvalde                                               ,Not Adjusted,10895,11448,553,4.8
10152,2014,March,Val Verde                                            ,Not Adjusted,18405,19617,1212,6.2
10153,2014,June,Val Verde                                            ,Not Adjusted,18330,19500,1170,6.0
10154,2014,September,Val Verde                                            ,Not Adjusted,18184,19257,1073,5.6
10155,2014,December,Val Verde                                            ,Not Adjusted,18070,19014,944,5.0
10156,2014,March,Van Zandt                                            ,Not Adjusted,22408,23805,1397,5.9
10157,2014,June,Van Zandt                                            ,Not Adjusted,22835,24202,1367,5.6
10158,2014,September,Van Zandt                                            ,Not Adjusted,22576,23800,1224,5.1
10159,2014,December,Van Zandt                                            ,Not Adjusted,22597,23598,1001,4.2
10160,2014,March,Victoria                                             ,Not Adjusted,43946,46024,2078,4.5
10161,2014,June,Victoria                                             ,Not Adjusted,44123,46271,2148,4.6
10162,2014,September,Victoria                                             ,Not Adjusted,44605,46495,1890,4.1
10163,2014,December,Victoria                                             ,Not Adjusted,44741,46272,1531,3.3
10164,2014,March,Walker                                               ,Not Adjusted,21759,23079,1320,5.7
10165,2014,June,Walker                                               ,Not Adjusted,21934,23355,1421,6.1
10166,2014,September,Walker                                               ,Not Adjusted,22042,23268,1226,5.3
10167,2014,December,Walker                                               ,Not Adjusted,21983,23013,1030,4.5
10168,2014,March,Waller                                               ,Not Adjusted,20082,21203,1121,5.3
10169,2014,June,Waller                                               ,Not Adjusted,20195,21475,1280,6.0
10170,2014,September,Waller                                               ,Not Adjusted,20276,21338,1062,5.0
10171,2014,December,Waller                                               ,Not Adjusted,20356,21208,852,4.0
10172,2014,March,Ward                                                 ,Not Adjusted,5625,5843,218,3.7
10173,2014,June,Ward                                                 ,Not Adjusted,5695,5927,232,3.9
10174,2014,September,Ward                                                 ,Not Adjusted,5751,5971,220,3.7
10175,2014,December,Ward                                                 ,Not Adjusted,5889,6074,185,3.0
10176,2014,March,Washington                                           ,Not Adjusted,15111,15908,797,5.0
10177,2014,June,Washington                                           ,Not Adjusted,15063,15883,820,5.2
10178,2014,September,Washington                                           ,Not Adjusted,14923,15629,706,4.5
10179,2014,December,Washington                                           ,Not Adjusted,14781,15340,559,3.6
10180,2014,March,Webb                                                 ,Not Adjusted,104588,110688,6100,5.5
10181,2014,June,Webb                                                 ,Not Adjusted,104657,111021,6364,5.7
10182,2014,September,Webb                                                 ,Not Adjusted,105771,111222,5451,4.9
10183,2014,December,Webb                                                 ,Not Adjusted,107431,111959,4528,4.0
10184,2014,March,Wharton                                              ,Not Adjusted,20480,21574,1094,5.1
10185,2014,June,Wharton                                              ,Not Adjusted,20602,21705,1103,5.1
10186,2014,September,Wharton                                              ,Not Adjusted,20554,21544,990,4.6
10187,2014,December,Wharton                                              ,Not Adjusted,20444,21243,799,3.8
10188,2014,March,Wheeler                                              ,Not Adjusted,2976,3091,115,3.7
10189,2014,June,Wheeler                                              ,Not Adjusted,3021,3148,127,4.0
10190,2014,September,Wheeler                                              ,Not Adjusted,3079,3186,107,3.4
10191,2014,December,Wheeler                                              ,Not Adjusted,2811,2895,84,2.9
10192,2014,March,Wichita                                              ,Not Adjusted,53937,56821,2884,5.1
10193,2014,June,Wichita                                              ,Not Adjusted,53795,56899,3104,5.5
10194,2014,September,Wichita                                              ,Not Adjusted,53576,56307,2731,4.9
10195,2014,December,Wichita                                              ,Not Adjusted,53332,55560,2228,4.0
10196,2014,March,Wilbarger                                            ,Not Adjusted,5170,5437,267,4.9
10197,2014,June,Wilbarger                                            ,Not Adjusted,5101,5386,285,5.3
10198,2014,September,Wilbarger                                            ,Not Adjusted,4932,5186,254,4.9
10199,2014,December,Wilbarger                                            ,Not Adjusted,4863,5077,214,4.2
10200,2014,March,Willacy                                              ,Not Adjusted,6452,7480,1028,13.7
10201,2014,June,Willacy                                              ,Not Adjusted,6244,7194,950,13.2
10202,2014,September,Willacy                                              ,Not Adjusted,6242,7032,790,11.2
10203,2014,December,Willacy                                              ,Not Adjusted,6144,6858,714,10.4
10204,2014,March,Williamson                                           ,Not Adjusted,242700,254615,11915,4.7
10205,2014,June,Williamson                                           ,Not Adjusted,243616,255487,11871,4.6
10206,2014,September,Williamson                                           ,Not Adjusted,244171,255384,11213,4.4
10207,2014,December,Williamson                                           ,Not Adjusted,246423,255618,9195,3.6
10208,2014,March,Wilson                                               ,Not Adjusted,21435,22436,1001,4.5
10209,2014,June,Wilson                                               ,Not Adjusted,21650,22668,1018,4.5
10210,2014,September,Wilson                                               ,Not Adjusted,21626,22541,915,4.1
10211,2014,December,Wilson                                               ,Not Adjusted,21700,22477,777,3.5
10212,2014,March,Winkler                                              ,Not Adjusted,3117,3273,156,4.8
10213,2014,June,Winkler                                              ,Not Adjusted,3174,3327,153,4.6
10214,2014,September,Winkler                                              ,Not Adjusted,3141,3288,147,4.5
10215,2014,December,Winkler                                              ,Not Adjusted,3141,3258,117,3.6
10216,2014,March,Wise                                                 ,Not Adjusted,26908,28487,1579,5.5
10217,2014,June,Wise                                                 ,Not Adjusted,27153,28688,1535,5.4
10218,2014,September,Wise                                                 ,Not Adjusted,27141,28466,1325,4.7
10219,2014,December,Wise                                                 ,Not Adjusted,27267,28382,1115,3.9
10220,2014,March,Wood                                                 ,Not Adjusted,15647,16726,1079,6.5
10221,2014,June,Wood                                                 ,Not Adjusted,15871,16928,1057,6.2
10222,2014,September,Wood                                                 ,Not Adjusted,15701,16701,1000,6.0
10223,2014,December,Wood                                                 ,Not Adjusted,15812,16648,836,5.0
10224,2014,March,Yoakum                                               ,Not Adjusted,4150,4291,141,3.3
10225,2014,June,Yoakum                                               ,Not Adjusted,4202,4344,142,3.3
10226,2014,September,Yoakum                                               ,Not Adjusted,4199,4325,126,2.9
10227,2014,December,Yoakum                                               ,Not Adjusted,4139,4244,105,2.5
10228,2014,March,Young                                                ,Not Adjusted,8211,8584,373,4.3
10229,2014,June,Young                                                ,Not Adjusted,8387,8764,377,4.3
10230,2014,September,Young                                                ,Not Adjusted,8347,8697,350,4.0
10231,2014,December,Young                                                ,Not Adjusted,8306,8596,290,3.4
10232,2014,March,Zapata                                               ,Not Adjusted,6594,6981,387,5.5
10233,2014,June,Zapata                                               ,Not Adjusted,6595,7007,412,5.9
10234,2014,September,Zapata                                               ,Not Adjusted,6536,6876,340,4.9
10235,2014,December,Zapata                                               ,Not Adjusted,6518,6816,298,4.4
10236,2014,March,Zavala                                               ,Not Adjusted,3488,4017,529,13.2
10237,2014,June,Zavala                                               ,Not Adjusted,3355,3864,509,13.2
10238,2014,September,Zavala                                               ,Not Adjusted,3258,3723,465,12.5
10239,2014,December,Zavala                                               ,Not Adjusted,3437,3787,350,9.2
10240,2015,March,Texas,Not Adjusted,12446732,13017214,570482,4.4
10241,2015,March,Texas,Adjusted,12461125,13044962,583837,4.5
10242,2015,June,Texas,Not Adjusted,12494852,13116908,622056,4.7
10243,2015,June,Texas,Adjusted,12493882,13072586,578704,4.4
10244,2015,September,Texas,Not Adjusted,12484848,13073700,588852,4.5
10245,2015,September,Texas,Adjusted,12523886,13111812,587926,4.5
10246,2015,December,Texas,Not Adjusted,12612362,13168839,556477,4.2
10247,2015,December,Texas,Adjusted,12603859,13194306,590447,4.5
10248,2015,March,Anderson                                             ,Not Adjusted,21489,22346,857,3.8
10249,2015,June,Anderson                                             ,Not Adjusted,22143,23105,962,4.2
10250,2015,September,Anderson                                             ,Not Adjusted,22043,22918,875,3.8
10251,2015,December,Anderson                                             ,Not Adjusted,22261,23187,926,4.0
10252,2015,March,Andrews                                              ,Not Adjusted,9137,9431,294,3.1
10253,2015,June,Andrews                                              ,Not Adjusted,9071,9423,352,3.7
10254,2015,September,Andrews                                              ,Not Adjusted,8789,9128,339,3.7
10255,2015,December,Andrews                                              ,Not Adjusted,8623,8966,343,3.8
10256,2015,March,Angelina                                             ,Not Adjusted,35415,37245,1830,4.9
10257,2015,June,Angelina                                             ,Not Adjusted,35668,37980,2312,6.1
10258,2015,September,Angelina                                             ,Not Adjusted,34982,37094,2112,5.7
10259,2015,December,Angelina                                             ,Not Adjusted,34826,36946,2120,5.7
10260,2015,March,Aransas                                              ,Not Adjusted,9591,10085,494,4.9
10261,2015,June,Aransas                                              ,Not Adjusted,9604,10120,516,5.1
10262,2015,September,Aransas                                              ,Not Adjusted,9524,10040,516,5.1
10263,2015,December,Aransas                                              ,Not Adjusted,9486,10017,531,5.3
10264,2015,March,Archer                                               ,Not Adjusted,3963,4138,175,4.2
10265,2015,June,Archer                                               ,Not Adjusted,3975,4181,206,4.9
10266,2015,September,Archer                                               ,Not Adjusted,3906,4093,187,4.6
10267,2015,December,Archer                                               ,Not Adjusted,3921,4092,171,4.2
10268,2015,March,Armstrong                                            ,Not Adjusted,964,988,24,2.4
10269,2015,June,Armstrong                                            ,Not Adjusted,959,986,27,2.7
10270,2015,September,Armstrong                                            ,Not Adjusted,942,968,26,2.7
10271,2015,December,Armstrong                                            ,Not Adjusted,945,969,24,2.5
10272,2015,March,Atascosa                                             ,Not Adjusted,19450,20360,910,4.5
10273,2015,June,Atascosa                                             ,Not Adjusted,19613,20656,1043,5.0
10274,2015,September,Atascosa                                             ,Not Adjusted,19587,20596,1009,4.9
10275,2015,December,Atascosa                                             ,Not Adjusted,19748,20767,1019,4.9
10276,2015,March,Austin                                               ,Not Adjusted,13449,14016,567,4.0
10277,2015,June,Austin                                               ,Not Adjusted,13434,14140,706,5.0
10278,2015,September,Austin                                               ,Not Adjusted,13332,14015,683,4.9
10279,2015,December,Austin                                               ,Not Adjusted,13388,14032,644,4.6
10280,2015,March,Bailey                                               ,Not Adjusted,2792,2919,127,4.4
10281,2015,June,Bailey                                               ,Not Adjusted,2816,2966,150,5.1
10282,2015,September,Bailey                                               ,Not Adjusted,2621,2729,108,4.0
10283,2015,December,Bailey                                               ,Not Adjusted,2558,2655,97,3.7
10284,2015,March,Bandera                                              ,Not Adjusted,8756,9115,359,3.9
10285,2015,June,Bandera                                              ,Not Adjusted,8843,9232,389,4.2
10286,2015,September,Bandera                                              ,Not Adjusted,8828,9199,371,4.0
10287,2015,December,Bandera                                              ,Not Adjusted,8894,9239,345,3.7
10288,2015,March,Bastrop                                              ,Not Adjusted,35732,37161,1429,3.8
10289,2015,June,Bastrop                                              ,Not Adjusted,36185,37849,1664,4.4
10290,2015,September,Bastrop                                              ,Not Adjusted,36214,37643,1429,3.8
10291,2015,December,Bastrop                                              ,Not Adjusted,36716,38023,1307,3.4
10292,2015,March,Baylor                                               ,Not Adjusted,1553,1611,58,3.6
10293,2015,June,Baylor                                               ,Not Adjusted,1609,1674,65,3.9
10294,2015,September,Baylor                                               ,Not Adjusted,1572,1630,58,3.6
10295,2015,December,Baylor                                               ,Not Adjusted,1602,1650,48,2.9
10296,2015,March,Bee                                                  ,Not Adjusted,9874,10462,588,5.6
10297,2015,June,Bee                                                  ,Not Adjusted,9735,10457,722,6.9
10298,2015,September,Bee                                                  ,Not Adjusted,9703,10364,661,6.4
10299,2015,December,Bee                                                  ,Not Adjusted,9699,10334,635,6.1
10300,2015,March,Bell                                                 ,Not Adjusted,128332,134683,6351,4.7
10301,2015,June,Bell                                                 ,Not Adjusted,128880,135595,6715,5.0
10302,2015,September,Bell                                                 ,Not Adjusted,130223,136581,6358,4.7
10303,2015,December,Bell                                                 ,Not Adjusted,133550,139276,5726,4.1
10304,2015,March,Bexar                                                ,Not Adjusted,836821,869873,33052,3.8
10305,2015,June,Bexar                                                ,Not Adjusted,843763,879996,36233,4.1
10306,2015,September,Bexar                                                ,Not Adjusted,847530,881174,33644,3.8
10307,2015,December,Bexar                                                ,Not Adjusted,858202,888810,30608,3.4
10308,2015,March,Blanco                                               ,Not Adjusted,5539,5716,177,3.1
10309,2015,June,Blanco                                               ,Not Adjusted,5632,5827,195,3.3
10310,2015,September,Blanco                                               ,Not Adjusted,5545,5727,182,3.2
10311,2015,December,Blanco                                               ,Not Adjusted,5631,5791,160,2.8
10312,2015,March,Borden                                               ,Not Adjusted,406,416,10,2.4
10313,2015,June,Borden                                               ,Not Adjusted,418,431,13,3.0
10314,2015,September,Borden                                               ,Not Adjusted,398,411,13,3.2
10315,2015,December,Borden                                               ,Not Adjusted,394,405,11,2.7
10316,2015,March,Bosque                                               ,Not Adjusted,7688,8034,346,4.3
10317,2015,June,Bosque                                               ,Not Adjusted,7748,8145,397,4.9
10318,2015,September,Bosque                                               ,Not Adjusted,7676,8047,371,4.6
10319,2015,December,Bosque                                               ,Not Adjusted,7679,8031,352,4.4
10320,2015,March,Bowie                                                ,Not Adjusted,37015,38937,1922,4.9
10321,2015,June,Bowie                                                ,Not Adjusted,37448,39398,1950,4.9
10322,2015,September,Bowie                                                ,Not Adjusted,37431,39293,1862,4.7
10323,2015,December,Bowie                                                ,Not Adjusted,37751,39428,1677,4.3
10324,2015,March,Brazoria                                             ,Not Adjusted,159426,166709,7283,4.4
10325,2015,June,Brazoria                                             ,Not Adjusted,159084,166986,7902,4.7
10326,2015,September,Brazoria                                             ,Not Adjusted,158744,166711,7967,4.8
10327,2015,December,Brazoria                                             ,Not Adjusted,160099,167752,7653,4.6
10328,2015,March,Brazos                                               ,Not Adjusted,106995,110388,3393,3.1
10329,2015,June,Brazos                                               ,Not Adjusted,101444,105653,4209,4.0
10330,2015,September,Brazos                                               ,Not Adjusted,105680,109264,3584,3.3
10331,2015,December,Brazos                                               ,Not Adjusted,106212,109456,3244,3.0
10332,2015,March,Brewster                                             ,Not Adjusted,3789,3951,162,4.1
10333,2015,June,Brewster                                             ,Not Adjusted,3751,3920,169,4.3
10334,2015,September,Brewster                                             ,Not Adjusted,3811,3955,144,3.6
10335,2015,December,Brewster                                             ,Not Adjusted,3741,3881,140,3.6
10336,2015,March,Briscoe                                              ,Not Adjusted,603,627,24,3.8
10337,2015,June,Briscoe                                              ,Not Adjusted,589,614,25,4.1
10338,2015,September,Briscoe                                              ,Not Adjusted,554,576,22,3.8
10339,2015,December,Briscoe                                              ,Not Adjusted,531,552,21,3.8
10340,2015,March,Brooks                                               ,Not Adjusted,2460,2675,215,8.0
10341,2015,June,Brooks                                               ,Not Adjusted,2346,2635,289,11.0
10342,2015,September,Brooks                                               ,Not Adjusted,2261,2554,293,11.5
10343,2015,December,Brooks                                               ,Not Adjusted,2266,2532,266,10.5
10344,2015,March,Brown                                                ,Not Adjusted,15136,15823,687,4.3
10345,2015,June,Brown                                                ,Not Adjusted,15306,16047,741,4.6
10346,2015,September,Brown                                                ,Not Adjusted,15346,16041,695,4.3
10347,2015,December,Brown                                                ,Not Adjusted,15383,16005,622,3.9
10348,2015,March,Burleson                                             ,Not Adjusted,7575,7887,312,4.0
10349,2015,June,Burleson                                             ,Not Adjusted,7215,7604,389,5.1
10350,2015,September,Burleson                                             ,Not Adjusted,7458,7801,343,4.4
10351,2015,December,Burleson                                             ,Not Adjusted,7469,7804,335,4.3
10352,2015,March,Burnet                                               ,Not Adjusted,20301,21086,785,3.7
10353,2015,June,Burnet                                               ,Not Adjusted,20762,21576,814,3.8
10354,2015,September,Burnet                                               ,Not Adjusted,20299,21063,764,3.6
10355,2015,December,Burnet                                               ,Not Adjusted,20343,21033,690,3.3
10356,2015,March,Caldwell                                             ,Not Adjusted,16500,17230,730,4.2
10357,2015,June,Caldwell                                             ,Not Adjusted,16709,17541,832,4.7
10358,2015,September,Caldwell                                             ,Not Adjusted,16731,17477,746,4.3
10359,2015,December,Caldwell                                             ,Not Adjusted,16970,17676,706,4.0
10360,2015,March,Calhoun                                              ,Not Adjusted,11000,11438,438,3.8
10361,2015,June,Calhoun                                              ,Not Adjusted,11120,11592,472,4.1
10362,2015,September,Calhoun                                              ,Not Adjusted,10814,11275,461,4.1
10363,2015,December,Calhoun                                              ,Not Adjusted,10462,10921,459,4.2
10364,2015,March,Callahan                                             ,Not Adjusted,5476,5721,245,4.3
10365,2015,June,Callahan                                             ,Not Adjusted,5501,5749,248,4.3
10366,2015,September,Callahan                                             ,Not Adjusted,5464,5712,248,4.3
10367,2015,December,Callahan                                             ,Not Adjusted,5476,5723,247,4.3
10368,2015,March,Cameron                                              ,Not Adjusted,151144,163142,11998,7.4
10369,2015,June,Cameron                                              ,Not Adjusted,151826,164184,12358,7.5
10370,2015,September,Cameron                                              ,Not Adjusted,150855,161876,11021,6.8
10371,2015,December,Cameron                                              ,Not Adjusted,152704,163831,11127,6.8
10372,2015,March,Camp                                                 ,Not Adjusted,4904,5178,274,5.3
10373,2015,June,Camp                                                 ,Not Adjusted,4735,5097,362,7.1
10374,2015,September,Camp                                                 ,Not Adjusted,4732,5051,319,6.3
10375,2015,December,Camp                                                 ,Not Adjusted,4763,5065,302,6.0
10376,2015,March,Carson                                               ,Not Adjusted,3008,3100,92,3.0
10377,2015,June,Carson                                               ,Not Adjusted,2996,3106,110,3.5
10378,2015,September,Carson                                               ,Not Adjusted,2949,3049,100,3.3
10379,2015,December,Carson                                               ,Not Adjusted,2959,3050,91,3.0
10380,2015,March,Cass                                                 ,Not Adjusted,11277,12073,796,6.6
10381,2015,June,Cass                                                 ,Not Adjusted,11373,12256,883,7.2
10382,2015,September,Cass                                                 ,Not Adjusted,11328,12163,835,6.9
10383,2015,December,Cass                                                 ,Not Adjusted,11502,12264,762,6.2
10384,2015,March,Castro                                               ,Not Adjusted,3604,3735,131,3.5
10385,2015,June,Castro                                               ,Not Adjusted,3644,3781,137,3.6
10386,2015,September,Castro                                               ,Not Adjusted,3458,3577,119,3.3
10387,2015,December,Castro                                               ,Not Adjusted,3356,3455,99,2.9
10388,2015,March,Chambers                                             ,Not Adjusted,16848,17752,904,5.1
10389,2015,June,Chambers                                             ,Not Adjusted,16818,17810,992,5.6
10390,2015,September,Chambers                                             ,Not Adjusted,16789,17773,984,5.5
10391,2015,December,Chambers                                             ,Not Adjusted,16936,17892,956,5.3
10392,2015,March,Cherokee                                             ,Not Adjusted,19820,20885,1065,5.1
10393,2015,June,Cherokee                                             ,Not Adjusted,19855,21038,1183,5.6
10394,2015,September,Cherokee                                             ,Not Adjusted,19789,20866,1077,5.2
10395,2015,December,Cherokee                                             ,Not Adjusted,19948,20965,1017,4.9
10396,2015,March,Childress                                            ,Not Adjusted,2759,2850,91,3.2
10397,2015,June,Childress                                            ,Not Adjusted,2826,2923,97,3.3
10398,2015,September,Childress                                            ,Not Adjusted,2799,2890,91,3.1
10399,2015,December,Childress                                            ,Not Adjusted,2758,2831,73,2.6
10400,2015,March,Clay                                                 ,Not Adjusted,4736,4944,208,4.2
10401,2015,June,Clay                                                 ,Not Adjusted,4745,4987,242,4.9
10402,2015,September,Clay                                                 ,Not Adjusted,4654,4873,219,4.5
10403,2015,December,Clay                                                 ,Not Adjusted,4663,4875,212,4.3
10404,2015,March,Cochran                                              ,Not Adjusted,1356,1421,65,4.6
10405,2015,June,Cochran                                              ,Not Adjusted,1304,1389,85,6.1
10406,2015,September,Cochran                                              ,Not Adjusted,1217,1289,72,5.6
10407,2015,December,Cochran                                              ,Not Adjusted,1136,1196,60,5.0
10408,2015,March,Coke                                                 ,Not Adjusted,1322,1378,56,4.1
10409,2015,June,Coke                                                 ,Not Adjusted,1365,1425,60,4.2
10410,2015,September,Coke                                                 ,Not Adjusted,1339,1397,58,4.2
10411,2015,December,Coke                                                 ,Not Adjusted,1340,1393,53,3.8
10412,2015,March,Coleman                                              ,Not Adjusted,2915,3079,164,5.3
10413,2015,June,Coleman                                              ,Not Adjusted,2945,3118,173,5.5
10414,2015,September,Coleman                                              ,Not Adjusted,2866,3049,183,6.0
10415,2015,December,Coleman                                              ,Not Adjusted,2838,2992,154,5.1
10416,2015,March,Collin                                               ,Not Adjusted,463460,481592,18132,3.8
10417,2015,June,Collin                                               ,Not Adjusted,470173,489188,19015,3.9
10418,2015,September,Collin                                               ,Not Adjusted,472697,490244,17547,3.6
10419,2015,December,Collin                                               ,Not Adjusted,480213,496150,15937,3.2
10420,2015,March,Collingsworth                                        ,Not Adjusted,1260,1302,42,3.2
10421,2015,June,Collingsworth                                        ,Not Adjusted,1255,1310,55,4.2
10422,2015,September,Collingsworth                                        ,Not Adjusted,1198,1244,46,3.7
10423,2015,December,Collingsworth                                        ,Not Adjusted,1179,1219,40,3.3
10424,2015,March,Colorado                                             ,Not Adjusted,9505,9862,357,3.6
10425,2015,June,Colorado                                             ,Not Adjusted,9826,10257,431,4.2
10426,2015,September,Colorado                                             ,Not Adjusted,9462,9862,400,4.1
10427,2015,December,Colorado                                             ,Not Adjusted,9376,9758,382,3.9
10428,2015,March,Comal                                                ,Not Adjusted,59001,61246,2245,3.7
10429,2015,June,Comal                                                ,Not Adjusted,59586,62008,2422,3.9
10430,2015,September,Comal                                                ,Not Adjusted,59771,62043,2272,3.7
10431,2015,December,Comal                                                ,Not Adjusted,60449,62559,2110,3.4
10432,2015,March,Comanche                                             ,Not Adjusted,5187,5431,244,4.5
10433,2015,June,Comanche                                             ,Not Adjusted,5197,5452,255,4.7
10434,2015,September,Comanche                                             ,Not Adjusted,5138,5364,226,4.2
10435,2015,December,Comanche                                             ,Not Adjusted,5084,5282,198,3.7
10436,2015,March,Concho                                               ,Not Adjusted,1393,1435,42,2.9
10437,2015,June,Concho                                               ,Not Adjusted,1377,1425,48,3.4
10438,2015,September,Concho                                               ,Not Adjusted,1308,1356,48,3.5
10439,2015,December,Concho                                               ,Not Adjusted,1286,1335,49,3.7
10440,2015,March,Cooke                                                ,Not Adjusted,19541,20225,684,3.4
10441,2015,June,Cooke                                                ,Not Adjusted,19157,19976,819,4.1
10442,2015,September,Cooke                                                ,Not Adjusted,18580,19304,724,3.8
10443,2015,December,Cooke                                                ,Not Adjusted,18436,19158,722,3.8
10444,2015,March,Coryell                                              ,Not Adjusted,23061,24207,1146,4.7
10445,2015,June,Coryell                                              ,Not Adjusted,23160,24373,1213,5.0
10446,2015,September,Coryell                                              ,Not Adjusted,23385,24585,1200,4.9
10447,2015,December,Coryell                                              ,Not Adjusted,23970,25059,1089,4.3
10448,2015,March,Cottle                                               ,Not Adjusted,522,566,44,7.8
10449,2015,June,Cottle                                               ,Not Adjusted,529,569,40,7.0
10450,2015,September,Cottle                                               ,Not Adjusted,495,531,36,6.8
10451,2015,December,Cottle                                               ,Not Adjusted,487,520,33,6.3
10452,2015,March,Crane                                                ,Not Adjusted,1753,1845,92,5.0
10453,2015,June,Crane                                                ,Not Adjusted,1726,1832,106,5.8
10454,2015,September,Crane                                                ,Not Adjusted,1699,1816,117,6.4
10455,2015,December,Crane                                                ,Not Adjusted,1697,1821,124,6.8
10456,2015,March,Crockett                                             ,Not Adjusted,1842,1948,106,5.4
10457,2015,June,Crockett                                             ,Not Adjusted,1832,1953,121,6.2
10458,2015,September,Crockett                                             ,Not Adjusted,1782,1904,122,6.4
10459,2015,December,Crockett                                             ,Not Adjusted,1634,1753,119,6.8
10460,2015,March,Crosby                                               ,Not Adjusted,2605,2727,122,4.5
10461,2015,June,Crosby                                               ,Not Adjusted,2579,2713,134,4.9
10462,2015,September,Crosby                                               ,Not Adjusted,2516,2624,108,4.1
10463,2015,December,Crosby                                               ,Not Adjusted,2488,2582,94,3.6
10464,2015,March,Culberson                                            ,Not Adjusted,965,1010,45,4.5
10465,2015,June,Culberson                                            ,Not Adjusted,986,1034,48,4.6
10466,2015,September,Culberson                                            ,Not Adjusted,1028,1071,43,4.0
10467,2015,December,Culberson                                            ,Not Adjusted,1038,1076,38,3.5
10468,2015,March,Dallam                                               ,Not Adjusted,3957,4039,82,2.0
10469,2015,June,Dallam                                               ,Not Adjusted,3990,4090,100,2.4
10470,2015,September,Dallam                                               ,Not Adjusted,3921,4008,87,2.2
10471,2015,December,Dallam                                               ,Not Adjusted,3888,3965,77,1.9
10472,2015,March,Dallas                                               ,Not Adjusted,1189252,1244318,55066,4.4
10473,2015,June,Dallas                                               ,Not Adjusted,1206994,1263661,56667,4.5
10474,2015,September,Dallas                                               ,Not Adjusted,1213433,1267101,53668,4.2
10475,2015,December,Dallas                                               ,Not Adjusted,1232586,1281312,48726,3.8
10476,2015,March,Dawson                                               ,Not Adjusted,4618,4836,218,4.5
10477,2015,June,Dawson                                               ,Not Adjusted,4612,4846,234,4.8
10478,2015,September,Dawson                                               ,Not Adjusted,4485,4707,222,4.7
10479,2015,December,Dawson                                               ,Not Adjusted,4492,4691,199,4.2
10480,2015,March,Deaf Smith                                           ,Not Adjusted,8723,9008,285,3.2
10481,2015,June,Deaf Smith                                           ,Not Adjusted,8743,9046,303,3.3
10482,2015,September,Deaf Smith                                           ,Not Adjusted,8442,8720,278,3.2
10483,2015,December,Deaf Smith                                           ,Not Adjusted,8349,8605,256,3.0
10484,2015,March,Delta                                                ,Not Adjusted,2487,2610,123,4.7
10485,2015,June,Delta                                                ,Not Adjusted,2480,2605,125,4.8
10486,2015,September,Delta                                                ,Not Adjusted,2492,2603,111,4.3
10487,2015,December,Delta                                                ,Not Adjusted,2486,2580,94,3.6
10488,2015,March,Denton                                               ,Not Adjusted,406820,422427,15607,3.7
10489,2015,June,Denton                                               ,Not Adjusted,412571,428988,16417,3.8
10490,2015,September,Denton                                               ,Not Adjusted,414859,429923,15064,3.5
10491,2015,December,Denton                                               ,Not Adjusted,421542,435349,13807,3.2
10492,2015,March,DeWitt                                               ,Not Adjusted,9768,10121,353,3.5
10493,2015,June,DeWitt                                               ,Not Adjusted,9687,10111,424,4.2
10494,2015,September,DeWitt                                               ,Not Adjusted,9691,10127,436,4.3
10495,2015,December,DeWitt                                               ,Not Adjusted,9427,9830,403,4.1
10496,2015,March,Dickens                                              ,Not Adjusted,693,729,36,4.9
10497,2015,June,Dickens                                              ,Not Adjusted,701,734,33,4.5
10498,2015,September,Dickens                                              ,Not Adjusted,654,684,30,4.4
10499,2015,December,Dickens                                              ,Not Adjusted,635,662,27,4.1
10500,2015,March,Dimmit                                               ,Not Adjusted,7309,7586,277,3.7
10501,2015,June,Dimmit                                               ,Not Adjusted,6679,7031,352,5.0
10502,2015,September,Dimmit                                               ,Not Adjusted,6338,6706,368,5.5
10503,2015,December,Dimmit                                               ,Not Adjusted,6442,6834,392,5.7
10504,2015,March,Donley                                               ,Not Adjusted,1576,1636,60,3.7
10505,2015,June,Donley                                               ,Not Adjusted,1586,1664,78,4.7
10506,2015,September,Donley                                               ,Not Adjusted,1472,1544,72,4.7
10507,2015,December,Donley                                               ,Not Adjusted,1486,1546,60,3.9
10508,2015,March,Duval                                                ,Not Adjusted,5086,5447,361,6.6
10509,2015,June,Duval                                                ,Not Adjusted,4835,5294,459,8.7
10510,2015,September,Duval                                                ,Not Adjusted,4623,5095,472,9.3
10511,2015,December,Duval                                                ,Not Adjusted,4516,4986,470,9.4
10512,2015,March,Eastland                                             ,Not Adjusted,7867,8231,364,4.4
10513,2015,June,Eastland                                             ,Not Adjusted,7656,8080,424,5.2
10514,2015,September,Eastland                                             ,Not Adjusted,7557,7937,380,4.8
10515,2015,December,Eastland                                             ,Not Adjusted,7328,7716,388,5.0
10516,2015,March,Ector                                                ,Not Adjusted,78319,81635,3316,4.1
10517,2015,June,Ector                                                ,Not Adjusted,75747,79773,4026,5.0
10518,2015,September,Ector                                                ,Not Adjusted,74409,78438,4029,5.1
10519,2015,December,Ector                                                ,Not Adjusted,73305,77345,4040,5.2
10520,2015,March,Edwards                                              ,Not Adjusted,830,867,37,4.3
10521,2015,June,Edwards                                              ,Not Adjusted,862,911,49,5.4
10522,2015,September,Edwards                                              ,Not Adjusted,823,866,43,5.0
10523,2015,December,Edwards                                              ,Not Adjusted,806,841,35,4.2
10524,2015,March,Ellis                                                ,Not Adjusted,76579,79728,3149,3.9
10525,2015,June,Ellis                                                ,Not Adjusted,77705,81166,3461,4.3
10526,2015,September,Ellis                                                ,Not Adjusted,78046,81266,3220,4.0
10527,2015,December,Ellis                                                ,Not Adjusted,79221,82118,2897,3.5
10528,2015,March,El Paso                                              ,Not Adjusted,321610,339424,17814,5.2
10529,2015,June,El Paso                                              ,Not Adjusted,321802,340614,18812,5.5
10530,2015,September,El Paso                                              ,Not Adjusted,324194,341724,17530,5.1
10531,2015,December,El Paso                                              ,Not Adjusted,329361,345486,16125,4.7
10532,2015,March,Erath                                                ,Not Adjusted,19613,20377,764,3.7
10533,2015,June,Erath                                                ,Not Adjusted,19355,20319,964,4.7
10534,2015,September,Erath                                                ,Not Adjusted,19420,20204,784,3.9
10535,2015,December,Erath                                                ,Not Adjusted,19248,19974,726,3.6
10536,2015,March,Falls                                                ,Not Adjusted,6159,6438,279,4.3
10537,2015,June,Falls                                                ,Not Adjusted,6187,6480,293,4.5
10538,2015,September,Falls                                                ,Not Adjusted,6188,6455,267,4.1
10539,2015,December,Falls                                                ,Not Adjusted,6235,6483,248,3.8
10540,2015,March,Fannin                                               ,Not Adjusted,14614,15255,641,4.2
10541,2015,June,Fannin                                               ,Not Adjusted,14786,15454,668,4.3
10542,2015,September,Fannin                                               ,Not Adjusted,14785,15405,620,4.0
10543,2015,December,Fannin                                               ,Not Adjusted,14901,15459,558,3.6
10544,2015,March,Fayette                                              ,Not Adjusted,12538,12925,387,3.0
10545,2015,June,Fayette                                              ,Not Adjusted,12481,12941,460,3.6
10546,2015,September,Fayette                                              ,Not Adjusted,12100,12549,449,3.6
10547,2015,December,Fayette                                              ,Not Adjusted,12118,12527,409,3.3
10548,2015,March,Fisher                                               ,Not Adjusted,1735,1808,73,4.0
10549,2015,June,Fisher                                               ,Not Adjusted,1784,1855,71,3.8
10550,2015,September,Fisher                                               ,Not Adjusted,1706,1775,69,3.9
10551,2015,December,Fisher                                               ,Not Adjusted,1700,1766,66,3.7
10552,2015,March,Floyd                                                ,Not Adjusted,2617,2804,187,6.7
10553,2015,June,Floyd                                                ,Not Adjusted,2668,2834,166,5.9
10554,2015,September,Floyd                                                ,Not Adjusted,2564,2701,137,5.1
10555,2015,December,Floyd                                                ,Not Adjusted,2526,2636,110,4.2
10556,2015,March,Foard                                                ,Not Adjusted,535,559,24,4.3
10557,2015,June,Foard                                                ,Not Adjusted,559,583,24,4.1
10558,2015,September,Foard                                                ,Not Adjusted,508,528,20,3.8
10559,2015,December,Foard                                                ,Not Adjusted,494,511,17,3.3
10560,2015,March,Fort Bend                                            ,Not Adjusted,340458,354616,14158,4.0
10561,2015,June,Fort Bend                                            ,Not Adjusted,340019,356046,16027,4.5
10562,2015,September,Fort Bend                                            ,Not Adjusted,339349,355234,15885,4.5
10563,2015,December,Fort Bend                                            ,Not Adjusted,342249,357583,15334,4.3
10564,2015,March,Franklin                                             ,Not Adjusted,4361,4565,204,4.5
10565,2015,June,Franklin                                             ,Not Adjusted,4429,4671,242,5.2
10566,2015,September,Franklin                                             ,Not Adjusted,4264,4495,231,5.1
10567,2015,December,Franklin                                             ,Not Adjusted,4247,4460,213,4.8
10568,2015,March,Freestone                                            ,Not Adjusted,7402,7782,380,4.9
10569,2015,June,Freestone                                            ,Not Adjusted,7174,7613,439,5.8
10570,2015,September,Freestone                                            ,Not Adjusted,6734,7142,408,5.7
10571,2015,December,Freestone                                            ,Not Adjusted,6560,6976,416,6.0
10572,2015,March,Frio                                                 ,Not Adjusted,9992,10337,345,3.3
10573,2015,June,Frio                                                 ,Not Adjusted,9603,10012,409,4.1
10574,2015,September,Frio                                                 ,Not Adjusted,9027,9424,397,4.2
10575,2015,December,Frio                                                 ,Not Adjusted,8565,8959,394,4.4
10576,2015,March,Gaines                                               ,Not Adjusted,9102,9381,279,3.0
10577,2015,June,Gaines                                               ,Not Adjusted,9220,9562,342,3.6
10578,2015,September,Gaines                                               ,Not Adjusted,9130,9442,312,3.3
10579,2015,December,Gaines                                               ,Not Adjusted,9038,9338,300,3.2
10580,2015,March,Galveston                                            ,Not Adjusted,150052,157809,7757,4.9
10581,2015,June,Galveston                                            ,Not Adjusted,149841,158156,8315,5.3
10582,2015,September,Galveston                                            ,Not Adjusted,149455,157367,7912,5.0
10583,2015,December,Galveston                                            ,Not Adjusted,150665,158368,7703,4.9
10584,2015,March,Garza                                                ,Not Adjusted,2085,2160,75,3.5
10585,2015,June,Garza                                                ,Not Adjusted,2066,2152,86,4.0
10586,2015,September,Garza                                                ,Not Adjusted,2024,2099,75,3.6
10587,2015,December,Garza                                                ,Not Adjusted,2030,2106,76,3.6
10588,2015,March,Gillespie                                            ,Not Adjusted,12298,12657,359,2.8
10589,2015,June,Gillespie                                            ,Not Adjusted,12393,12785,392,3.1
10590,2015,September,Gillespie                                            ,Not Adjusted,12147,12511,364,2.9
10591,2015,December,Gillespie                                            ,Not Adjusted,12528,12854,326,2.5
10592,2015,March,Glasscock                                            ,Not Adjusted,849,868,19,2.2
10593,2015,June,Glasscock                                            ,Not Adjusted,826,851,25,2.9
10594,2015,September,Glasscock                                            ,Not Adjusted,788,811,23,2.8
10595,2015,December,Glasscock                                            ,Not Adjusted,735,764,29,3.8
10596,2015,March,Goliad                                               ,Not Adjusted,3327,3465,138,4.0
10597,2015,June,Goliad                                               ,Not Adjusted,3307,3478,171,4.9
10598,2015,September,Goliad                                               ,Not Adjusted,3263,3428,165,4.8
10599,2015,December,Goliad                                               ,Not Adjusted,3233,3377,144,4.3
10600,2015,March,Gonzales                                             ,Not Adjusted,9449,9774,325,3.3
10601,2015,June,Gonzales                                             ,Not Adjusted,9500,9872,372,3.8
10602,2015,September,Gonzales                                             ,Not Adjusted,9318,9712,394,4.1
10603,2015,December,Gonzales                                             ,Not Adjusted,9231,9586,355,3.7
10604,2015,March,Gray                                                 ,Not Adjusted,9142,9593,451,4.7
10605,2015,June,Gray                                                 ,Not Adjusted,8953,9513,560,5.9
10606,2015,September,Gray                                                 ,Not Adjusted,8481,9055,574,6.3
10607,2015,December,Gray                                                 ,Not Adjusted,8252,8810,558,6.3
10608,2015,March,Grayson                                              ,Not Adjusted,56891,59305,2414,4.1
10609,2015,June,Grayson                                              ,Not Adjusted,57906,60477,2571,4.3
10610,2015,September,Grayson                                              ,Not Adjusted,57407,59795,2388,4.0
10611,2015,December,Grayson                                              ,Not Adjusted,58077,60298,2221,3.7
10612,2015,March,Gregg                                                ,Not Adjusted,56868,59535,2667,4.5
10613,2015,June,Gregg                                                ,Not Adjusted,55850,59087,3237,5.5
10614,2015,September,Gregg                                                ,Not Adjusted,55635,58769,3134,5.3
10615,2015,December,Gregg                                                ,Not Adjusted,55876,58821,2945,5.0
10616,2015,March,Grimes                                               ,Not Adjusted,11220,11735,515,4.4
10617,2015,June,Grimes                                               ,Not Adjusted,10871,11572,701,6.1
10618,2015,September,Grimes                                               ,Not Adjusted,10742,11370,628,5.5
10619,2015,December,Grimes                                               ,Not Adjusted,10578,11194,616,5.5
10620,2015,March,Guadalupe                                            ,Not Adjusted,69733,72219,2486,3.4
10621,2015,June,Guadalupe                                            ,Not Adjusted,70260,73089,2829,3.9
10622,2015,September,Guadalupe                                            ,Not Adjusted,70533,73118,2585,3.5
10623,2015,December,Guadalupe                                            ,Not Adjusted,71398,73799,2401,3.3
10624,2015,March,Hale                                                 ,Not Adjusted,12167,13056,889,6.8
10625,2015,June,Hale                                                 ,Not Adjusted,12145,13101,956,7.3
10626,2015,September,Hale                                                 ,Not Adjusted,12150,12895,745,5.8
10627,2015,December,Hale                                                 ,Not Adjusted,11949,12600,651,5.2
10628,2015,March,Hall                                                 ,Not Adjusted,1189,1252,63,5.0
10629,2015,June,Hall                                                 ,Not Adjusted,1164,1234,70,5.7
10630,2015,September,Hall                                                 ,Not Adjusted,1117,1187,70,5.9
10631,2015,December,Hall                                                 ,Not Adjusted,1082,1137,55,4.8
10632,2015,March,Hamilton                                             ,Not Adjusted,3323,3473,150,4.3
10633,2015,June,Hamilton                                             ,Not Adjusted,3355,3530,175,5.0
10634,2015,September,Hamilton                                             ,Not Adjusted,3320,3492,172,4.9
10635,2015,December,Hamilton                                             ,Not Adjusted,3328,3490,162,4.6
10636,2015,March,Hansford                                             ,Not Adjusted,3104,3202,98,3.1
10637,2015,June,Hansford                                             ,Not Adjusted,3081,3181,100,3.1
10638,2015,September,Hansford                                             ,Not Adjusted,2983,3072,89,2.9
10639,2015,December,Hansford                                             ,Not Adjusted,2933,3028,95,3.1
10640,2015,March,Hardeman                                             ,Not Adjusted,1531,1619,88,5.4
10641,2015,June,Hardeman                                             ,Not Adjusted,1583,1669,86,5.2
10642,2015,September,Hardeman                                             ,Not Adjusted,1549,1625,76,4.7
10643,2015,December,Hardeman                                             ,Not Adjusted,1531,1591,60,3.8
10644,2015,March,Hardin                                               ,Not Adjusted,23728,25092,1364,5.4
10645,2015,June,Hardin                                               ,Not Adjusted,23636,25108,1472,5.9
10646,2015,September,Hardin                                               ,Not Adjusted,23457,24876,1419,5.7
10647,2015,December,Hardin                                               ,Not Adjusted,23508,24967,1459,5.8
10648,2015,March,Harris                                               ,Not Adjusted,2128359,2226444,98085,4.4
10649,2015,June,Harris                                               ,Not Adjusted,2126969,2235579,108610,4.9
10650,2015,September,Harris                                               ,Not Adjusted,2122437,2230419,107982,4.8
10651,2015,December,Harris                                               ,Not Adjusted,2140121,2244457,104336,4.6
10652,2015,March,Harrison                                             ,Not Adjusted,30062,31593,1531,4.8
10653,2015,June,Harrison                                             ,Not Adjusted,29504,31262,1758,5.6
10654,2015,September,Harrison                                             ,Not Adjusted,29215,30887,1672,5.4
10655,2015,December,Harrison                                             ,Not Adjusted,28760,30431,1671,5.5
10656,2015,March,Hartley                                              ,Not Adjusted,2960,3026,66,2.2
10657,2015,June,Hartley                                              ,Not Adjusted,2984,3058,74,2.4
10658,2015,September,Hartley                                              ,Not Adjusted,2946,3006,60,2.0
10659,2015,December,Hartley                                              ,Not Adjusted,2932,2991,59,2.0
10660,2015,March,Haskell                                              ,Not Adjusted,2571,2663,92,3.5
10661,2015,June,Haskell                                              ,Not Adjusted,2552,2661,109,4.1
10662,2015,September,Haskell                                              ,Not Adjusted,2475,2566,91,3.5
10663,2015,December,Haskell                                              ,Not Adjusted,2440,2515,75,3.0
10664,2015,March,Hays                                                 ,Not Adjusted,93977,97267,3290,3.4
10665,2015,June,Hays                                                 ,Not Adjusted,95187,98914,3727,3.8
10666,2015,September,Hays                                                 ,Not Adjusted,95488,98868,3380,3.4
10667,2015,December,Hays                                                 ,Not Adjusted,96989,100031,3042,3.0
10668,2015,March,Hemphill                                             ,Not Adjusted,2323,2394,71,3.0
10669,2015,June,Hemphill                                             ,Not Adjusted,2307,2392,85,3.6
10670,2015,September,Hemphill                                             ,Not Adjusted,2137,2210,73,3.3
10671,2015,December,Hemphill                                             ,Not Adjusted,2078,2145,67,3.1
10672,2015,March,Henderson                                            ,Not Adjusted,32399,34123,1724,5.1
10673,2015,June,Henderson                                            ,Not Adjusted,32900,34705,1805,5.2
10674,2015,September,Henderson                                            ,Not Adjusted,32472,34138,1666,4.9
10675,2015,December,Henderson                                            ,Not Adjusted,32917,34470,1553,4.5
10676,2015,March,Hidalgo                                              ,Not Adjusted,305443,331346,25903,7.8
10677,2015,June,Hidalgo                                              ,Not Adjusted,305406,333405,27999,8.4
10678,2015,September,Hidalgo                                              ,Not Adjusted,302071,327423,25352,7.7
10679,2015,December,Hidalgo                                              ,Not Adjusted,308202,334531,26329,7.9
10680,2015,March,Hill                                                 ,Not Adjusted,14836,15538,702,4.5
10681,2015,June,Hill                                                 ,Not Adjusted,14835,15633,798,5.1
10682,2015,September,Hill                                                 ,Not Adjusted,14923,15625,702,4.5
10683,2015,December,Hill                                                 ,Not Adjusted,15060,15723,663,4.2
10684,2015,March,Hockley                                              ,Not Adjusted,11573,12038,465,3.9
10685,2015,June,Hockley                                              ,Not Adjusted,11327,11874,547,4.6
10686,2015,September,Hockley                                              ,Not Adjusted,10910,11418,508,4.4
10687,2015,December,Hockley                                              ,Not Adjusted,10922,11390,468,4.1
10688,2015,March,Hood                                                 ,Not Adjusted,23248,24311,1063,4.4
10689,2015,June,Hood                                                 ,Not Adjusted,23483,24651,1168,4.7
10690,2015,September,Hood                                                 ,Not Adjusted,23420,24554,1134,4.6
10691,2015,December,Hood                                                 ,Not Adjusted,23658,24745,1087,4.4
10692,2015,March,Hopkins                                              ,Not Adjusted,16318,17071,753,4.4
10693,2015,June,Hopkins                                              ,Not Adjusted,16304,17092,788,4.6
10694,2015,September,Hopkins                                              ,Not Adjusted,16283,16980,697,4.1
10695,2015,December,Hopkins                                              ,Not Adjusted,16262,16898,636,3.8
10696,2015,March,Houston                                              ,Not Adjusted,9177,9617,440,4.6
10697,2015,June,Houston                                              ,Not Adjusted,9723,10207,484,4.7
10698,2015,September,Houston                                              ,Not Adjusted,9586,10017,431,4.3
10699,2015,December,Houston                                              ,Not Adjusted,9604,10047,443,4.4
10700,2015,March,Howard                                               ,Not Adjusted,12975,13570,595,4.4
10701,2015,June,Howard                                               ,Not Adjusted,12658,13330,672,5.0
10702,2015,September,Howard                                               ,Not Adjusted,12596,13222,626,4.7
10703,2015,December,Howard                                               ,Not Adjusted,12595,13218,623,4.7
10704,2015,March,Hudspeth                                             ,Not Adjusted,1231,1304,73,5.6
10705,2015,June,Hudspeth                                             ,Not Adjusted,1227,1297,70,5.4
10706,2015,September,Hudspeth                                             ,Not Adjusted,1203,1275,72,5.6
10707,2015,December,Hudspeth                                             ,Not Adjusted,1197,1268,71,5.6
10708,2015,March,Hunt                                                 ,Not Adjusted,36531,38359,1828,4.8
10709,2015,June,Hunt                                                 ,Not Adjusted,37070,39084,2014,5.2
10710,2015,September,Hunt                                                 ,Not Adjusted,37198,39019,1821,4.7
10711,2015,December,Hunt                                                 ,Not Adjusted,37731,39393,1662,4.2
10712,2015,March,Hutchinson                                           ,Not Adjusted,10504,10913,409,3.7
10713,2015,June,Hutchinson                                           ,Not Adjusted,9057,9507,450,4.7
10714,2015,September,Hutchinson                                           ,Not Adjusted,8947,9417,470,5.0
10715,2015,December,Hutchinson                                           ,Not Adjusted,9083,9532,449,4.7
10716,2015,March,Irion                                                ,Not Adjusted,781,810,29,3.6
10717,2015,June,Irion                                                ,Not Adjusted,785,817,32,3.9
10718,2015,September,Irion                                                ,Not Adjusted,764,794,30,3.8
10719,2015,December,Irion                                                ,Not Adjusted,757,781,24,3.1
10720,2015,March,Jack                                                 ,Not Adjusted,3956,4130,174,4.2
10721,2015,June,Jack                                                 ,Not Adjusted,3901,4097,196,4.8
10722,2015,September,Jack                                                 ,Not Adjusted,3831,4006,175,4.4
10723,2015,December,Jack                                                 ,Not Adjusted,3766,3926,160,4.1
10724,2015,March,Jackson                                              ,Not Adjusted,7204,7464,260,3.5
10725,2015,June,Jackson                                              ,Not Adjusted,7097,7402,305,4.1
10726,2015,September,Jackson                                              ,Not Adjusted,7066,7350,284,3.9
10727,2015,December,Jackson                                              ,Not Adjusted,7013,7286,273,3.7
10728,2015,March,Jasper                                               ,Not Adjusted,13218,14238,1020,7.2
10729,2015,June,Jasper                                               ,Not Adjusted,13113,14209,1096,7.7
10730,2015,September,Jasper                                               ,Not Adjusted,12698,13708,1010,7.4
10731,2015,December,Jasper                                               ,Not Adjusted,12486,13538,1052,7.8
10732,2015,March,Jeff Davis                                           ,Not Adjusted,1079,1118,39,3.5
10733,2015,June,Jeff Davis                                           ,Not Adjusted,1099,1133,34,3.0
10734,2015,September,Jeff Davis                                           ,Not Adjusted,1042,1075,33,3.1
10735,2015,December,Jeff Davis                                           ,Not Adjusted,1004,1038,34,3.3
10736,2015,March,Jefferson                                            ,Not Adjusted,101064,108456,7392,6.8
10737,2015,June,Jefferson                                            ,Not Adjusted,100713,108362,7649,7.1
10738,2015,September,Jefferson                                            ,Not Adjusted,99928,107397,7469,7.0
10739,2015,December,Jefferson                                            ,Not Adjusted,100111,107491,7380,6.9
10740,2015,March,Jim Hogg                                             ,Not Adjusted,1903,2035,132,6.5
10741,2015,June,Jim Hogg                                             ,Not Adjusted,1877,2050,173,8.4
10742,2015,September,Jim Hogg                                             ,Not Adjusted,1903,2045,142,6.9
10743,2015,December,Jim Hogg                                             ,Not Adjusted,1821,1979,158,8.0
10744,2015,March,Jim Wells                                            ,Not Adjusted,18462,19695,1233,6.3
10745,2015,June,Jim Wells                                            ,Not Adjusted,17785,19497,1712,8.8
10746,2015,September,Jim Wells                                            ,Not Adjusted,17090,18820,1730,9.2
10747,2015,December,Jim Wells                                            ,Not Adjusted,16845,18511,1666,9.0
10748,2015,March,Johnson                                              ,Not Adjusted,70406,73661,3255,4.4
10749,2015,June,Johnson                                              ,Not Adjusted,71002,74524,3522,4.7
10750,2015,September,Johnson                                              ,Not Adjusted,71016,74317,3301,4.4
10751,2015,December,Johnson                                              ,Not Adjusted,71928,74974,3046,4.1
10752,2015,March,Jones                                                ,Not Adjusted,5399,5709,310,5.4
10753,2015,June,Jones                                                ,Not Adjusted,5396,5736,340,5.9
10754,2015,September,Jones                                                ,Not Adjusted,5323,5650,327,5.8
10755,2015,December,Jones                                                ,Not Adjusted,5311,5589,278,5.0
10756,2015,March,Karnes                                               ,Not Adjusted,6376,6613,237,3.6
10757,2015,June,Karnes                                               ,Not Adjusted,6211,6510,299,4.6
10758,2015,September,Karnes                                               ,Not Adjusted,5937,6238,301,4.8
10759,2015,December,Karnes                                               ,Not Adjusted,5890,6157,267,4.3
10760,2015,March,Kaufman                                              ,Not Adjusted,52015,54335,2320,4.3
10761,2015,June,Kaufman                                              ,Not Adjusted,52741,55166,2425,4.4
10762,2015,September,Kaufman                                              ,Not Adjusted,53018,55229,2211,4.0
10763,2015,December,Kaufman                                              ,Not Adjusted,53862,55896,2034,3.6
10764,2015,March,Kendall                                              ,Not Adjusted,18429,19054,625,3.3
10765,2015,June,Kendall                                              ,Not Adjusted,18611,19288,677,3.5
10766,2015,September,Kendall                                              ,Not Adjusted,18557,19194,637,3.3
10767,2015,December,Kendall                                              ,Not Adjusted,18683,19258,575,3.0
10768,2015,March,Kenedy                                               ,Not Adjusted,329,339,10,2.9
10769,2015,June,Kenedy                                               ,Not Adjusted,296,307,11,3.6
10770,2015,September,Kenedy                                               ,Not Adjusted,244,252,8,3.2
10771,2015,December,Kenedy                                               ,Not Adjusted,229,238,9,3.8
10772,2015,March,Kent                                                 ,Not Adjusted,493,504,11,2.2
10773,2015,June,Kent                                                 ,Not Adjusted,517,530,13,2.5
10774,2015,September,Kent                                                 ,Not Adjusted,487,499,12,2.4
10775,2015,December,Kent                                                 ,Not Adjusted,464,479,15,3.1
10776,2015,March,Kerr                                                 ,Not Adjusted,20204,20980,776,3.7
10777,2015,June,Kerr                                                 ,Not Adjusted,20702,21540,838,3.9
10778,2015,September,Kerr                                                 ,Not Adjusted,20464,21245,781,3.7
10779,2015,December,Kerr                                                 ,Not Adjusted,20635,21346,711,3.3
10780,2015,March,Kimble                                               ,Not Adjusted,1947,2015,68,3.4
10781,2015,June,Kimble                                               ,Not Adjusted,1999,2077,78,3.8
10782,2015,September,Kimble                                               ,Not Adjusted,1873,1949,76,3.9
10783,2015,December,Kimble                                               ,Not Adjusted,1882,1962,80,4.1
10784,2015,March,King                                                 ,Not Adjusted,206,213,7,3.3
10785,2015,June,King                                                 ,Not Adjusted,217,225,8,3.6
10786,2015,September,King                                                 ,Not Adjusted,187,193,6,3.1
10787,2015,December,King                                                 ,Not Adjusted,157,164,7,4.3
10788,2015,March,Kinney                                               ,Not Adjusted,1116,1191,75,6.3
10789,2015,June,Kinney                                               ,Not Adjusted,1144,1218,74,6.1
10790,2015,September,Kinney                                               ,Not Adjusted,1092,1169,77,6.6
10791,2015,December,Kinney                                               ,Not Adjusted,1088,1153,65,5.6
10792,2015,March,Kleberg                                              ,Not Adjusted,14099,14895,796,5.3
10793,2015,June,Kleberg                                              ,Not Adjusted,13438,14389,951,6.6
10794,2015,September,Kleberg                                              ,Not Adjusted,13169,14041,872,6.2
10795,2015,December,Kleberg                                              ,Not Adjusted,13440,14278,838,5.9
10796,2015,March,Knox                                                 ,Not Adjusted,1675,1733,58,3.3
10797,2015,June,Knox                                                 ,Not Adjusted,1695,1766,71,4.0
10798,2015,September,Knox                                                 ,Not Adjusted,1594,1661,67,4.0
10799,2015,December,Knox                                                 ,Not Adjusted,1542,1607,65,4.0
10800,2015,March,Lamar                                                ,Not Adjusted,21026,22120,1094,4.9
10801,2015,June,Lamar                                                ,Not Adjusted,21233,22367,1134,5.1
10802,2015,September,Lamar                                                ,Not Adjusted,21129,22193,1064,4.8
10803,2015,December,Lamar                                                ,Not Adjusted,21271,22217,946,4.3
10804,2015,March,Lamb                                                 ,Not Adjusted,5175,5725,550,9.6
10805,2015,June,Lamb                                                 ,Not Adjusted,5157,5681,524,9.2
10806,2015,September,Lamb                                                 ,Not Adjusted,4920,5396,476,8.8
10807,2015,December,Lamb                                                 ,Not Adjusted,4833,5227,394,7.5
10808,2015,March,Lampasas                                             ,Not Adjusted,8578,8979,401,4.5
10809,2015,June,Lampasas                                             ,Not Adjusted,8623,9049,426,4.7
10810,2015,September,Lampasas                                             ,Not Adjusted,8671,9063,392,4.3
10811,2015,December,Lampasas                                             ,Not Adjusted,8856,9222,366,4.0
10812,2015,March,La Salle                                             ,Not Adjusted,4176,4355,179,4.1
10813,2015,June,La Salle                                             ,Not Adjusted,4257,4453,196,4.4
10814,2015,September,La Salle                                             ,Not Adjusted,3895,4068,173,4.3
10815,2015,December,La Salle                                             ,Not Adjusted,3737,3908,171,4.4
10816,2015,March,Lavaca                                               ,Not Adjusted,8438,8735,297,3.4
10817,2015,June,Lavaca                                               ,Not Adjusted,8663,9027,364,4.0
10818,2015,September,Lavaca                                               ,Not Adjusted,8380,8740,360,4.1
10819,2015,December,Lavaca                                               ,Not Adjusted,8357,8678,321,3.7
10820,2015,March,Lee                                                  ,Not Adjusted,9022,9339,317,3.4
10821,2015,June,Lee                                                  ,Not Adjusted,8913,9281,368,4.0
10822,2015,September,Lee                                                  ,Not Adjusted,9018,9349,331,3.5
10823,2015,December,Lee                                                  ,Not Adjusted,8970,9285,315,3.4
10824,2015,March,Leon                                                 ,Not Adjusted,6846,7193,347,4.8
10825,2015,June,Leon                                                 ,Not Adjusted,6560,6961,401,5.8
10826,2015,September,Leon                                                 ,Not Adjusted,6430,6803,373,5.5
10827,2015,December,Leon                                                 ,Not Adjusted,6220,6606,386,5.8
10828,2015,March,Liberty                                              ,Not Adjusted,28846,30933,2087,6.7
10829,2015,June,Liberty                                              ,Not Adjusted,28808,31076,2268,7.3
10830,2015,September,Liberty                                              ,Not Adjusted,28686,30860,2174,7.0
10831,2015,December,Liberty                                              ,Not Adjusted,28882,30998,2116,6.8
10832,2015,March,Limestone                                            ,Not Adjusted,8247,8664,417,4.8
10833,2015,June,Limestone                                            ,Not Adjusted,8191,8648,457,5.3
10834,2015,September,Limestone                                            ,Not Adjusted,8022,8447,425,5.0
10835,2015,December,Limestone                                            ,Not Adjusted,7935,8368,433,5.2
10836,2015,March,Lipscomb                                             ,Not Adjusted,1721,1787,66,3.7
10837,2015,June,Lipscomb                                             ,Not Adjusted,1712,1788,76,4.3
10838,2015,September,Lipscomb                                             ,Not Adjusted,1609,1676,67,4.0
10839,2015,December,Lipscomb                                             ,Not Adjusted,1595,1661,66,4.0
10840,2015,March,Live Oak                                             ,Not Adjusted,5725,5951,226,3.8
10841,2015,June,Live Oak                                             ,Not Adjusted,5632,5891,259,4.4
10842,2015,September,Live Oak                                             ,Not Adjusted,5641,5889,248,4.2
10843,2015,December,Live Oak                                             ,Not Adjusted,5553,5793,240,4.1
10844,2015,March,Llano                                                ,Not Adjusted,7729,8081,352,4.4
10845,2015,June,Llano                                                ,Not Adjusted,8020,8376,356,4.3
10846,2015,September,Llano                                                ,Not Adjusted,7793,8140,347,4.3
10847,2015,December,Llano                                                ,Not Adjusted,7723,8045,322,4.0
10848,2015,March,Loving                                               ,Not Adjusted,67,71,4,5.6
10849,2015,June,Loving                                               ,Not Adjusted,70,73,3,4.1
10850,2015,September,Loving                                               ,Not Adjusted,72,76,4,5.3
10851,2015,December,Loving                                               ,Not Adjusted,78,82,4,4.9
10852,2015,March,Lubbock                                              ,Not Adjusted,144301,149187,4886,3.3
10853,2015,June,Lubbock                                              ,Not Adjusted,143280,149221,5941,4.0
10854,2015,September,Lubbock                                              ,Not Adjusted,144570,149679,5109,3.4
10855,2015,December,Lubbock                                              ,Not Adjusted,146368,150913,4545,3.0
10856,2015,March,Lynn                                                 ,Not Adjusted,2715,2831,116,4.1
10857,2015,June,Lynn                                                 ,Not Adjusted,2688,2824,136,4.8
10858,2015,September,Lynn                                                 ,Not Adjusted,2637,2753,116,4.2
10859,2015,December,Lynn                                                 ,Not Adjusted,2617,2705,88,3.3
10860,2015,March,McCulloch                                            ,Not Adjusted,3911,4067,156,3.8
10861,2015,June,McCulloch                                            ,Not Adjusted,3762,3974,212,5.3
10862,2015,September,McCulloch                                            ,Not Adjusted,3628,3843,215,5.6
10863,2015,December,McCulloch                                            ,Not Adjusted,3555,3739,184,4.9
10864,2015,March,McLennan                                             ,Not Adjusted,106458,111012,4554,4.1
10865,2015,June,McLennan                                             ,Not Adjusted,107287,112381,5094,4.5
10866,2015,September,McLennan                                             ,Not Adjusted,108373,112964,4591,4.1
10867,2015,December,McLennan                                             ,Not Adjusted,109948,114005,4057,3.6
10868,2015,March,McMullen                                             ,Not Adjusted,966,988,22,2.2
10869,2015,June,McMullen                                             ,Not Adjusted,947,966,19,2.0
10870,2015,September,McMullen                                             ,Not Adjusted,920,943,23,2.4
10871,2015,December,McMullen                                             ,Not Adjusted,909,926,17,1.8
10872,2015,March,Madison                                              ,Not Adjusted,4971,5189,218,4.2
10873,2015,June,Madison                                              ,Not Adjusted,4919,5169,250,4.8
10874,2015,September,Madison                                              ,Not Adjusted,5006,5218,212,4.1
10875,2015,December,Madison                                              ,Not Adjusted,4774,4989,215,4.3
10876,2015,March,Marion                                               ,Not Adjusted,4116,4389,273,6.2
10877,2015,June,Marion                                               ,Not Adjusted,4127,4440,313,7.0
10878,2015,September,Marion                                               ,Not Adjusted,4089,4383,294,6.7
10879,2015,December,Marion                                               ,Not Adjusted,4096,4368,272,6.2
10880,2015,March,Martin                                               ,Not Adjusted,2564,2643,79,3.0
10881,2015,June,Martin                                               ,Not Adjusted,2523,2623,100,3.8
10882,2015,September,Martin                                               ,Not Adjusted,2439,2537,98,3.9
10883,2015,December,Martin                                               ,Not Adjusted,2406,2489,83,3.3
10884,2015,March,Mason                                                ,Not Adjusted,1750,1818,68,3.7
10885,2015,June,Mason                                                ,Not Adjusted,1782,1860,78,4.2
10886,2015,September,Mason                                                ,Not Adjusted,1722,1792,70,3.9
10887,2015,December,Mason                                                ,Not Adjusted,1697,1755,58,3.3
10888,2015,March,Matagorda                                            ,Not Adjusted,16342,17431,1089,6.2
10889,2015,June,Matagorda                                            ,Not Adjusted,16112,17302,1190,6.9
10890,2015,September,Matagorda                                            ,Not Adjusted,15850,17007,1157,6.8
10891,2015,December,Matagorda                                            ,Not Adjusted,15716,16943,1227,7.2
10892,2015,March,Maverick                                             ,Not Adjusted,21041,23787,2746,11.5
10893,2015,June,Maverick                                             ,Not Adjusted,21310,23870,2560,10.7
10894,2015,September,Maverick                                             ,Not Adjusted,21019,23329,2310,9.9
10895,2015,December,Maverick                                             ,Not Adjusted,21573,24198,2625,10.8
10896,2015,March,Medina                                               ,Not Adjusted,19441,20328,887,4.4
10897,2015,June,Medina                                               ,Not Adjusted,19587,20550,963,4.7
10898,2015,September,Medina                                               ,Not Adjusted,19555,20475,920,4.5
10899,2015,December,Medina                                               ,Not Adjusted,19711,20551,840,4.1
10900,2015,March,Menard                                               ,Not Adjusted,824,866,42,4.8
10901,2015,June,Menard                                               ,Not Adjusted,839,891,52,5.8
10902,2015,September,Menard                                               ,Not Adjusted,806,853,47,5.5
10903,2015,December,Menard                                               ,Not Adjusted,769,809,40,4.9
10904,2015,March,Midland                                              ,Not Adjusted,86576,89435,2859,3.2
10905,2015,June,Midland                                              ,Not Adjusted,85170,88574,3404,3.8
10906,2015,September,Midland                                              ,Not Adjusted,83580,86793,3213,3.7
10907,2015,December,Midland                                              ,Not Adjusted,83403,86571,3168,3.7
10908,2015,March,Milam                                                ,Not Adjusted,9514,10031,517,5.2
10909,2015,June,Milam                                                ,Not Adjusted,9689,10256,567,5.5
10910,2015,September,Milam                                                ,Not Adjusted,9636,10178,542,5.3
10911,2015,December,Milam                                                ,Not Adjusted,9630,10113,483,4.8
10912,2015,March,Mills                                                ,Not Adjusted,1972,2041,69,3.4
10913,2015,June,Mills                                                ,Not Adjusted,1955,2035,80,3.9
10914,2015,September,Mills                                                ,Not Adjusted,1869,1941,72,3.7
10915,2015,December,Mills                                                ,Not Adjusted,1826,1897,71,3.7
10916,2015,March,Mitchell                                             ,Not Adjusted,2666,2814,148,5.3
10917,2015,June,Mitchell                                             ,Not Adjusted,2613,2782,169,6.1
10918,2015,September,Mitchell                                             ,Not Adjusted,2535,2699,164,6.1
10919,2015,December,Mitchell                                             ,Not Adjusted,2522,2682,160,6.0
10920,2015,March,Montague                                             ,Not Adjusted,9439,9840,401,4.1
10921,2015,June,Montague                                             ,Not Adjusted,9425,9860,435,4.4
10922,2015,September,Montague                                             ,Not Adjusted,9150,9588,438,4.6
10923,2015,December,Montague                                             ,Not Adjusted,8915,9360,445,4.8
10924,2015,March,Montgomery                                           ,Not Adjusted,247034,257276,10242,4.0
10925,2015,June,Montgomery                                           ,Not Adjusted,246944,258664,11720,4.5
10926,2015,September,Montgomery                                           ,Not Adjusted,246291,257793,11502,4.5
10927,2015,December,Montgomery                                           ,Not Adjusted,248235,259281,11046,4.3
10928,2015,March,Moore                                                ,Not Adjusted,10870,11213,343,3.1
10929,2015,June,Moore                                                ,Not Adjusted,10867,11243,376,3.3
10930,2015,September,Moore                                                ,Not Adjusted,10849,11201,352,3.1
10931,2015,December,Moore                                                ,Not Adjusted,10634,10967,333,3.0
10932,2015,March,Morris                                               ,Not Adjusted,5065,5464,399,7.3
10933,2015,June,Morris                                               ,Not Adjusted,4889,5412,523,9.7
10934,2015,September,Morris                                               ,Not Adjusted,4736,5201,465,8.9
10935,2015,December,Morris                                               ,Not Adjusted,4635,5131,496,9.7
10936,2015,March,Motley                                               ,Not Adjusted,477,496,19,3.8
10937,2015,June,Motley                                               ,Not Adjusted,486,505,19,3.8
10938,2015,September,Motley                                               ,Not Adjusted,472,488,16,3.3
10939,2015,December,Motley                                               ,Not Adjusted,473,488,15,3.1
10940,2015,March,Nacogdoches                                          ,Not Adjusted,26831,28050,1219,4.3
10941,2015,June,Nacogdoches                                          ,Not Adjusted,26738,28284,1546,5.5
10942,2015,September,Nacogdoches                                          ,Not Adjusted,26928,28243,1315,4.7
10943,2015,December,Nacogdoches                                          ,Not Adjusted,26945,28136,1191,4.2
10944,2015,March,Navarro                                              ,Not Adjusted,22038,23072,1034,4.5
10945,2015,June,Navarro                                              ,Not Adjusted,21735,22812,1077,4.7
10946,2015,September,Navarro                                              ,Not Adjusted,21766,22692,926,4.1
10947,2015,December,Navarro                                              ,Not Adjusted,21883,22721,838,3.7
10948,2015,March,Newton                                               ,Not Adjusted,5009,5383,374,6.9
10949,2015,June,Newton                                               ,Not Adjusted,4987,5412,425,7.9
10950,2015,September,Newton                                               ,Not Adjusted,4935,5332,397,7.4
10951,2015,December,Newton                                               ,Not Adjusted,4935,5332,397,7.4
10952,2015,March,Nolan                                                ,Not Adjusted,6602,6862,260,3.8
10953,2015,June,Nolan                                                ,Not Adjusted,6623,6924,301,4.3
10954,2015,September,Nolan                                                ,Not Adjusted,6659,6946,287,4.1
10955,2015,December,Nolan                                                ,Not Adjusted,6588,6882,294,4.3
10956,2015,March,Nueces                                               ,Not Adjusted,158107,165718,7611,4.6
10957,2015,June,Nueces                                               ,Not Adjusted,157974,166635,8661,5.2
10958,2015,September,Nueces                                               ,Not Adjusted,157256,165711,8455,5.1
10959,2015,December,Nueces                                               ,Not Adjusted,157028,165460,8432,5.1
10960,2015,March,Ochiltree                                            ,Not Adjusted,5116,5325,209,3.9
10961,2015,June,Ochiltree                                            ,Not Adjusted,5097,5348,251,4.7
10962,2015,September,Ochiltree                                            ,Not Adjusted,5003,5247,244,4.7
10963,2015,December,Ochiltree                                            ,Not Adjusted,4760,4995,235,4.7
10964,2015,March,Oldham                                               ,Not Adjusted,903,928,25,2.7
10965,2015,June,Oldham                                               ,Not Adjusted,898,925,27,2.9
10966,2015,September,Oldham                                               ,Not Adjusted,880,910,30,3.3
10967,2015,December,Oldham                                               ,Not Adjusted,881,905,24,2.7
10968,2015,March,Orange                                               ,Not Adjusted,34937,37261,2324,6.2
10969,2015,June,Orange                                               ,Not Adjusted,34830,37294,2464,6.6
10970,2015,September,Orange                                               ,Not Adjusted,34581,37007,2426,6.6
10971,2015,December,Orange                                               ,Not Adjusted,34661,37069,2408,6.5
10972,2015,March,Palo Pinto                                           ,Not Adjusted,12412,13056,644,4.9
10973,2015,June,Palo Pinto                                           ,Not Adjusted,12523,13243,720,5.4
10974,2015,September,Palo Pinto                                           ,Not Adjusted,12494,13183,689,5.2
10975,2015,December,Palo Pinto                                           ,Not Adjusted,12567,13290,723,5.4
10976,2015,March,Panola                                               ,Not Adjusted,11489,12017,528,4.4
10977,2015,June,Panola                                               ,Not Adjusted,11124,11766,642,5.5
10978,2015,September,Panola                                               ,Not Adjusted,10736,11380,644,5.7
10979,2015,December,Panola                                               ,Not Adjusted,9903,10532,629,6.0
10980,2015,March,Parker                                               ,Not Adjusted,56635,59043,2408,4.1
10981,2015,June,Parker                                               ,Not Adjusted,57141,59821,2680,4.5
10982,2015,September,Parker                                               ,Not Adjusted,57073,59603,2530,4.2
10983,2015,December,Parker                                               ,Not Adjusted,57737,60067,2330,3.9
10984,2015,March,Parmer                                               ,Not Adjusted,4923,5033,110,2.2
10985,2015,June,Parmer                                               ,Not Adjusted,4902,5028,126,2.5
10986,2015,September,Parmer                                               ,Not Adjusted,4842,4962,120,2.4
10987,2015,December,Parmer                                               ,Not Adjusted,4812,4916,104,2.1
10988,2015,March,Pecos                                                ,Not Adjusted,6738,7056,318,4.5
10989,2015,June,Pecos                                                ,Not Adjusted,6521,6944,423,6.1
10990,2015,September,Pecos                                                ,Not Adjusted,6405,6766,361,5.3
10991,2015,December,Pecos                                                ,Not Adjusted,6167,6504,337,5.2
10992,2015,March,Polk                                                 ,Not Adjusted,16320,17310,990,5.7
10993,2015,June,Polk                                                 ,Not Adjusted,16008,17090,1082,6.3
10994,2015,September,Polk                                                 ,Not Adjusted,15664,16690,1026,6.1
10995,2015,December,Polk                                                 ,Not Adjusted,16059,17104,1045,6.1
10996,2015,March,Potter                                               ,Not Adjusted,54311,56109,1798,3.2
10997,2015,June,Potter                                               ,Not Adjusted,54233,56263,2030,3.6
10998,2015,September,Potter                                               ,Not Adjusted,54133,56030,1897,3.4
10999,2015,December,Potter                                               ,Not Adjusted,54956,56688,1732,3.1
11000,2015,March,Presidio                                             ,Not Adjusted,2870,3193,323,10.1
11001,2015,June,Presidio                                             ,Not Adjusted,2843,3217,374,11.6
11002,2015,September,Presidio                                             ,Not Adjusted,2714,3052,338,11.1
11003,2015,December,Presidio                                             ,Not Adjusted,2695,3027,332,11.0
11004,2015,March,Rains                                                ,Not Adjusted,5146,5400,254,4.7
11005,2015,June,Rains                                                ,Not Adjusted,5200,5461,261,4.8
11006,2015,September,Rains                                                ,Not Adjusted,5147,5382,235,4.4
11007,2015,December,Rains                                                ,Not Adjusted,5179,5394,215,4.0
11008,2015,March,Randall                                              ,Not Adjusted,67172,69116,1944,2.8
11009,2015,June,Randall                                              ,Not Adjusted,66931,69145,2214,3.2
11010,2015,September,Randall                                              ,Not Adjusted,66746,68771,2025,2.9
11011,2015,December,Randall                                              ,Not Adjusted,67740,69530,1790,2.6
11012,2015,March,Reagan                                               ,Not Adjusted,1985,2058,73,3.5
11013,2015,June,Reagan                                               ,Not Adjusted,1879,1973,94,4.8
11014,2015,September,Reagan                                               ,Not Adjusted,1764,1855,91,4.9
11015,2015,December,Reagan                                               ,Not Adjusted,1647,1749,102,5.8
11016,2015,March,Real                                                 ,Not Adjusted,982,1034,52,5.0
11017,2015,June,Real                                                 ,Not Adjusted,1131,1191,60,5.0
11018,2015,September,Real                                                 ,Not Adjusted,1004,1057,53,5.0
11019,2015,December,Real                                                 ,Not Adjusted,959,1009,50,5.0
11020,2015,March,Red River                                            ,Not Adjusted,4592,4908,316,6.4
11021,2015,June,Red River                                            ,Not Adjusted,4599,4916,317,6.4
11022,2015,September,Red River                                            ,Not Adjusted,4603,4910,307,6.3
11023,2015,December,Red River                                            ,Not Adjusted,4647,4930,283,5.7
11024,2015,March,Reeves                                               ,Not Adjusted,5310,5541,231,4.2
11025,2015,June,Reeves                                               ,Not Adjusted,5357,5655,298,5.3
11026,2015,September,Reeves                                               ,Not Adjusted,5358,5661,303,5.4
11027,2015,December,Reeves                                               ,Not Adjusted,5528,5806,278,4.8
11028,2015,March,Refugio                                              ,Not Adjusted,3262,3432,170,5.0
11029,2015,June,Refugio                                              ,Not Adjusted,3166,3358,192,5.7
11030,2015,September,Refugio                                              ,Not Adjusted,3092,3277,185,5.6
11031,2015,December,Refugio                                              ,Not Adjusted,2975,3145,170,5.4
11032,2015,March,Roberts                                              ,Not Adjusted,441,459,18,3.9
11033,2015,June,Roberts                                              ,Not Adjusted,464,486,22,4.5
11034,2015,September,Roberts                                              ,Not Adjusted,429,448,19,4.2
11035,2015,December,Roberts                                              ,Not Adjusted,422,437,15,3.4
11036,2015,March,Robertson                                            ,Not Adjusted,7072,7386,314,4.3
11037,2015,June,Robertson                                            ,Not Adjusted,6731,7109,378,5.3
11038,2015,September,Robertson                                            ,Not Adjusted,6932,7288,356,4.9
11039,2015,December,Robertson                                            ,Not Adjusted,6926,7258,332,4.6
11040,2015,March,Rockwall                                             ,Not Adjusted,42527,44255,1728,3.9
11041,2015,June,Rockwall                                             ,Not Adjusted,43164,45002,1838,4.1
11042,2015,September,Rockwall                                             ,Not Adjusted,43379,45057,1678,3.7
11043,2015,December,Rockwall                                             ,Not Adjusted,44050,45583,1533,3.4
11044,2015,March,Runnels                                              ,Not Adjusted,4585,4759,174,3.7
11045,2015,June,Runnels                                              ,Not Adjusted,4609,4804,195,4.1
11046,2015,September,Runnels                                              ,Not Adjusted,4454,4623,169,3.7
11047,2015,December,Runnels                                              ,Not Adjusted,4355,4507,152,3.4
11048,2015,March,Rusk                                                 ,Not Adjusted,21991,22975,984,4.3
11049,2015,June,Rusk                                                 ,Not Adjusted,21624,22818,1194,5.2
11050,2015,September,Rusk                                                 ,Not Adjusted,21482,22623,1141,5.0
11051,2015,December,Rusk                                                 ,Not Adjusted,21531,22630,1099,4.9
11052,2015,March,Sabine                                               ,Not Adjusted,3173,3486,313,9.0
11053,2015,June,Sabine                                               ,Not Adjusted,3168,3509,341,9.7
11054,2015,September,Sabine                                               ,Not Adjusted,3179,3494,315,9.0
11055,2015,December,Sabine                                               ,Not Adjusted,3157,3494,337,9.6
11056,2015,March,San Augustine                                        ,Not Adjusted,2558,2803,245,8.7
11057,2015,June,San Augustine                                        ,Not Adjusted,2604,2877,273,9.5
11058,2015,September,San Augustine                                        ,Not Adjusted,2483,2747,264,9.6
11059,2015,December,San Augustine                                        ,Not Adjusted,2511,2756,245,8.9
11060,2015,March,San Jacinto                                          ,Not Adjusted,10735,11312,577,5.1
11061,2015,June,San Jacinto                                          ,Not Adjusted,10731,11400,669,5.9
11062,2015,September,San Jacinto                                          ,Not Adjusted,10503,11177,674,6.0
11063,2015,December,San Jacinto                                          ,Not Adjusted,10634,11301,667,5.9
11064,2015,March,San Patricio                                         ,Not Adjusted,28431,30340,1909,6.3
11065,2015,June,San Patricio                                         ,Not Adjusted,28364,30396,2032,6.7
11066,2015,September,San Patricio                                         ,Not Adjusted,28179,30112,1933,6.4
11067,2015,December,San Patricio                                         ,Not Adjusted,28101,30147,2046,6.8
11068,2015,March,San Saba                                             ,Not Adjusted,2145,2222,77,3.5
11069,2015,June,San Saba                                             ,Not Adjusted,2165,2258,93,4.1
11070,2015,September,San Saba                                             ,Not Adjusted,2184,2273,89,3.9
11071,2015,December,San Saba                                             ,Not Adjusted,2185,2261,76,3.4
11072,2015,March,Schleicher                                           ,Not Adjusted,1515,1597,82,5.1
11073,2015,June,Schleicher                                           ,Not Adjusted,1470,1559,89,5.7
11074,2015,September,Schleicher                                           ,Not Adjusted,1318,1400,82,5.9
11075,2015,December,Schleicher                                           ,Not Adjusted,1295,1370,75,5.5
11076,2015,March,Scurry                                               ,Not Adjusted,7980,8320,340,4.1
11077,2015,June,Scurry                                               ,Not Adjusted,7928,8316,388,4.7
11078,2015,September,Scurry                                               ,Not Adjusted,7667,8016,349,4.4
11079,2015,December,Scurry                                               ,Not Adjusted,7471,7812,341,4.4
11080,2015,March,Shackelford                                          ,Not Adjusted,2130,2187,57,2.6
11081,2015,June,Shackelford                                          ,Not Adjusted,2058,2122,64,3.0
11082,2015,September,Shackelford                                          ,Not Adjusted,1964,2023,59,2.9
11083,2015,December,Shackelford                                          ,Not Adjusted,1869,1927,58,3.0
11084,2015,March,Shelby                                               ,Not Adjusted,10912,11467,555,4.8
11085,2015,June,Shelby                                               ,Not Adjusted,10867,11532,665,5.8
11086,2015,September,Shelby                                               ,Not Adjusted,10793,11401,608,5.3
11087,2015,December,Shelby                                               ,Not Adjusted,10489,11085,596,5.4
11088,2015,March,Sherman                                              ,Not Adjusted,1445,1481,36,2.4
11089,2015,June,Sherman                                              ,Not Adjusted,1426,1470,44,3.0
11090,2015,September,Sherman                                              ,Not Adjusted,1357,1396,39,2.8
11091,2015,December,Sherman                                              ,Not Adjusted,1307,1345,38,2.8
11092,2015,March,Smith                                                ,Not Adjusted,98094,102619,4525,4.4
11093,2015,June,Smith                                                ,Not Adjusted,98946,103808,4862,4.7
11094,2015,September,Smith                                                ,Not Adjusted,99126,103828,4702,4.5
11095,2015,December,Smith                                                ,Not Adjusted,100744,105281,4537,4.3
11096,2015,March,Somervell                                            ,Not Adjusted,3867,4047,180,4.4
11097,2015,June,Somervell                                            ,Not Adjusted,3904,4142,238,5.7
11098,2015,September,Somervell                                            ,Not Adjusted,3903,4109,206,5.0
11099,2015,December,Somervell                                            ,Not Adjusted,3952,4167,215,5.2
11100,2015,March,Starr                                                ,Not Adjusted,22581,26262,3681,14.0
11101,2015,June,Starr                                                ,Not Adjusted,22343,26032,3689,14.2
11102,2015,September,Starr                                                ,Not Adjusted,22032,25229,3197,12.7
11103,2015,December,Starr                                                ,Not Adjusted,22687,26202,3515,13.4
11104,2015,March,Stephens                                             ,Not Adjusted,4070,4228,158,3.7
11105,2015,June,Stephens                                             ,Not Adjusted,3997,4174,177,4.2
11106,2015,September,Stephens                                             ,Not Adjusted,3827,4003,176,4.4
11107,2015,December,Stephens                                             ,Not Adjusted,3814,3998,184,4.6
11108,2015,March,Sterling                                             ,Not Adjusted,758,785,27,3.4
11109,2015,June,Sterling                                             ,Not Adjusted,745,775,30,3.9
11110,2015,September,Sterling                                             ,Not Adjusted,727,751,24,3.2
11111,2015,December,Sterling                                             ,Not Adjusted,676,697,21,3.0
11112,2015,March,Stonewall                                            ,Not Adjusted,633,668,35,5.2
11113,2015,June,Stonewall                                            ,Not Adjusted,675,701,26,3.7
11114,2015,September,Stonewall                                            ,Not Adjusted,629,657,28,4.3
11115,2015,December,Stonewall                                            ,Not Adjusted,593,620,27,4.4
11116,2015,March,Sutton                                               ,Not Adjusted,1708,1797,89,5.0
11117,2015,June,Sutton                                               ,Not Adjusted,1629,1734,105,6.1
11118,2015,September,Sutton                                               ,Not Adjusted,1579,1699,120,7.1
11119,2015,December,Sutton                                               ,Not Adjusted,1475,1589,114,7.2
11120,2015,March,Swisher                                              ,Not Adjusted,2615,2750,135,4.9
11121,2015,June,Swisher                                              ,Not Adjusted,2677,2822,145,5.1
11122,2015,September,Swisher                                              ,Not Adjusted,2582,2711,129,4.8
11123,2015,December,Swisher                                              ,Not Adjusted,2560,2671,111,4.2
11124,2015,March,Tarrant                                              ,Not Adjusted,940802,982586,41784,4.3
11125,2015,June,Tarrant                                              ,Not Adjusted,948992,992861,43869,4.4
11126,2015,September,Tarrant                                              ,Not Adjusted,950338,991746,41408,4.2
11127,2015,December,Tarrant                                              ,Not Adjusted,963396,1000727,37331,3.7
11128,2015,March,Taylor                                               ,Not Adjusted,60891,63206,2315,3.7
11129,2015,June,Taylor                                               ,Not Adjusted,60981,63547,2566,4.0
11130,2015,September,Taylor                                               ,Not Adjusted,60763,63115,2352,3.7
11131,2015,December,Taylor                                               ,Not Adjusted,61064,63148,2084,3.3
11132,2015,March,Terrell                                              ,Not Adjusted,442,461,19,4.1
11133,2015,June,Terrell                                              ,Not Adjusted,438,463,25,5.4
11134,2015,September,Terrell                                              ,Not Adjusted,395,420,25,6.0
11135,2015,December,Terrell                                              ,Not Adjusted,380,398,18,4.5
11136,2015,March,Terry                                                ,Not Adjusted,5263,5518,255,4.6
11137,2015,June,Terry                                                ,Not Adjusted,5208,5500,292,5.3
11138,2015,September,Terry                                                ,Not Adjusted,5018,5278,260,4.9
11139,2015,December,Terry                                                ,Not Adjusted,5083,5303,220,4.1
11140,2015,March,Throckmorton                                         ,Not Adjusted,775,798,23,2.9
11141,2015,June,Throckmorton                                         ,Not Adjusted,783,812,29,3.6
11142,2015,September,Throckmorton                                         ,Not Adjusted,736,761,25,3.3
11143,2015,December,Throckmorton                                         ,Not Adjusted,727,749,22,2.9
11144,2015,March,Titus                                                ,Not Adjusted,12030,12736,706,5.5
11145,2015,June,Titus                                                ,Not Adjusted,12058,12887,829,6.4
11146,2015,September,Titus                                                ,Not Adjusted,11922,12656,734,5.8
11147,2015,December,Titus                                                ,Not Adjusted,12126,12814,688,5.4
11148,2015,March,Tom Green                                            ,Not Adjusted,52482,54663,2181,4.0
11149,2015,June,Tom Green                                            ,Not Adjusted,52609,55086,2477,4.5
11150,2015,September,Tom Green                                            ,Not Adjusted,51915,54171,2256,4.2
11151,2015,December,Tom Green                                            ,Not Adjusted,52179,54339,2160,4.0
11152,2015,March,Travis                                               ,Not Adjusted,626294,647559,21265,3.3
11153,2015,June,Travis                                               ,Not Adjusted,634780,657468,22688,3.5
11154,2015,September,Travis                                               ,Not Adjusted,636946,658515,21569,3.3
11155,2015,December,Travis                                               ,Not Adjusted,646993,666624,19631,2.9
11156,2015,March,Trinity                                              ,Not Adjusted,5178,5483,305,5.6
11157,2015,June,Trinity                                              ,Not Adjusted,5245,5591,346,6.2
11158,2015,September,Trinity                                              ,Not Adjusted,5183,5514,331,6.0
11159,2015,December,Trinity                                              ,Not Adjusted,5092,5416,324,6.0
11160,2015,March,Tyler                                                ,Not Adjusted,7035,7537,502,6.7
11161,2015,June,Tyler                                                ,Not Adjusted,6933,7470,537,7.2
11162,2015,September,Tyler                                                ,Not Adjusted,6719,7225,506,7.0
11163,2015,December,Tyler                                                ,Not Adjusted,6647,7171,524,7.3
11164,2015,March,Upshur                                               ,Not Adjusted,17214,18060,846,4.7
11165,2015,June,Upshur                                               ,Not Adjusted,16927,17952,1025,5.7
11166,2015,September,Upshur                                               ,Not Adjusted,16816,17798,982,5.5
11167,2015,December,Upshur                                               ,Not Adjusted,16856,17819,963,5.4
11168,2015,March,Upton                                                ,Not Adjusted,1783,1841,58,3.2
11169,2015,June,Upton                                                ,Not Adjusted,1734,1814,80,4.4
11170,2015,September,Upton                                                ,Not Adjusted,1656,1732,76,4.4
11171,2015,December,Upton                                                ,Not Adjusted,1623,1700,77,4.5
11172,2015,March,Uvalde                                               ,Not Adjusted,11197,11768,571,4.9
11173,2015,June,Uvalde                                               ,Not Adjusted,11259,11872,613,5.2
11174,2015,September,Uvalde                                               ,Not Adjusted,11105,11696,591,5.1
11175,2015,December,Uvalde                                               ,Not Adjusted,10931,11544,613,5.3
11176,2015,March,Val Verde                                            ,Not Adjusted,18332,19497,1165,6.0
11177,2015,June,Val Verde                                            ,Not Adjusted,18558,19811,1253,6.3
11178,2015,September,Val Verde                                            ,Not Adjusted,18396,19570,1174,6.0
11179,2015,December,Val Verde                                            ,Not Adjusted,18489,19666,1177,6.0
11180,2015,March,Van Zandt                                            ,Not Adjusted,22957,24017,1060,4.4
11181,2015,June,Van Zandt                                            ,Not Adjusted,23477,24666,1189,4.8
11182,2015,September,Van Zandt                                            ,Not Adjusted,23124,24211,1087,4.5
11183,2015,December,Van Zandt                                            ,Not Adjusted,23061,24062,1001,4.2
11184,2015,March,Victoria                                             ,Not Adjusted,43757,45531,1774,3.9
11185,2015,June,Victoria                                             ,Not Adjusted,43445,45529,2084,4.6
11186,2015,September,Victoria                                             ,Not Adjusted,43019,45022,2003,4.4
11187,2015,December,Victoria                                             ,Not Adjusted,42743,44642,1899,4.3
11188,2015,March,Walker                                               ,Not Adjusted,21776,22867,1091,4.8
11189,2015,June,Walker                                               ,Not Adjusted,21890,23177,1287,5.6
11190,2015,September,Walker                                               ,Not Adjusted,21783,22992,1209,5.3
11191,2015,December,Walker                                               ,Not Adjusted,21946,23035,1089,4.7
11192,2015,March,Waller                                               ,Not Adjusted,20686,21608,922,4.3
11193,2015,June,Waller                                               ,Not Adjusted,20649,21840,1191,5.5
11194,2015,September,Waller                                               ,Not Adjusted,20523,21579,1056,4.9
11195,2015,December,Waller                                               ,Not Adjusted,20636,21658,1022,4.7
11196,2015,March,Ward                                                 ,Not Adjusted,5862,6105,243,4.0
11197,2015,June,Ward                                                 ,Not Adjusted,5684,5963,279,4.7
11198,2015,September,Ward                                                 ,Not Adjusted,5521,5793,272,4.7
11199,2015,December,Ward                                                 ,Not Adjusted,5270,5523,253,4.6
11200,2015,March,Washington                                           ,Not Adjusted,15176,15778,602,3.8
11201,2015,June,Washington                                           ,Not Adjusted,14712,15593,881,5.6
11202,2015,September,Washington                                           ,Not Adjusted,14299,15095,796,5.3
11203,2015,December,Washington                                           ,Not Adjusted,14262,15006,744,5.0
11204,2015,March,Webb                                                 ,Not Adjusted,106297,111429,5132,4.6
11205,2015,June,Webb                                                 ,Not Adjusted,106490,112408,5918,5.3
11206,2015,September,Webb                                                 ,Not Adjusted,106211,111495,5284,4.7
11207,2015,December,Webb                                                 ,Not Adjusted,107755,112814,5059,4.5
11208,2015,March,Wharton                                              ,Not Adjusted,20572,21422,850,4.0
11209,2015,June,Wharton                                              ,Not Adjusted,20367,21375,1008,4.7
11210,2015,September,Wharton                                              ,Not Adjusted,20174,21172,998,4.7
11211,2015,December,Wharton                                              ,Not Adjusted,20067,21002,935,4.5
11212,2015,March,Wheeler                                              ,Not Adjusted,2781,2892,111,3.8
11213,2015,June,Wheeler                                              ,Not Adjusted,2762,2883,121,4.2
11214,2015,September,Wheeler                                              ,Not Adjusted,2744,2854,110,3.9
11215,2015,December,Wheeler                                              ,Not Adjusted,2591,2701,110,4.1
11216,2015,March,Wichita                                              ,Not Adjusted,52831,55125,2294,4.2
11217,2015,June,Wichita                                              ,Not Adjusted,53081,55627,2546,4.6
11218,2015,September,Wichita                                              ,Not Adjusted,52580,55018,2438,4.4
11219,2015,December,Wichita                                              ,Not Adjusted,53090,55388,2298,4.1
11220,2015,March,Wilbarger                                            ,Not Adjusted,4980,5216,236,4.5
11221,2015,June,Wilbarger                                            ,Not Adjusted,4925,5217,292,5.6
11222,2015,September,Wilbarger                                            ,Not Adjusted,4855,5096,241,4.7
11223,2015,December,Wilbarger                                            ,Not Adjusted,4779,4999,220,4.4
11224,2015,March,Willacy                                              ,Not Adjusted,6098,7047,949,13.5
11225,2015,June,Willacy                                              ,Not Adjusted,5778,6770,992,14.7
11226,2015,September,Willacy                                              ,Not Adjusted,5734,6556,822,12.5
11227,2015,December,Willacy                                              ,Not Adjusted,5681,6459,778,12.0
11228,2015,March,Williamson                                           ,Not Adjusted,251874,260971,9097,3.5
11229,2015,June,Williamson                                           ,Not Adjusted,254973,264691,9718,3.7
11230,2015,September,Williamson                                           ,Not Adjusted,255989,265141,9152,3.5
11231,2015,December,Williamson                                           ,Not Adjusted,260217,268434,8217,3.1
11232,2015,March,Wilson                                               ,Not Adjusted,21930,22751,821,3.6
11233,2015,June,Wilson                                               ,Not Adjusted,22113,23054,941,4.1
11234,2015,September,Wilson                                               ,Not Adjusted,22147,23053,906,3.9
11235,2015,December,Wilson                                               ,Not Adjusted,22376,23217,841,3.6
11236,2015,March,Winkler                                              ,Not Adjusted,2958,3124,166,5.3
11237,2015,June,Winkler                                              ,Not Adjusted,2931,3129,198,6.3
11238,2015,September,Winkler                                              ,Not Adjusted,2879,3060,181,5.9
11239,2015,December,Winkler                                              ,Not Adjusted,2847,3021,174,5.8
11240,2015,March,Wise                                                 ,Not Adjusted,27164,28502,1338,4.7
11241,2015,June,Wise                                                 ,Not Adjusted,27400,28877,1477,5.1
11242,2015,September,Wise                                                 ,Not Adjusted,27327,28666,1339,4.7
11243,2015,December,Wise                                                 ,Not Adjusted,27613,28920,1307,4.5
11244,2015,March,Wood                                                 ,Not Adjusted,15690,16557,867,5.2
11245,2015,June,Wood                                                 ,Not Adjusted,15967,16924,957,5.7
11246,2015,September,Wood                                                 ,Not Adjusted,15977,16875,898,5.3
11247,2015,December,Wood                                                 ,Not Adjusted,15972,16825,853,5.1
11248,2015,March,Yoakum                                               ,Not Adjusted,4031,4179,148,3.5
11249,2015,June,Yoakum                                               ,Not Adjusted,3983,4155,172,4.1
11250,2015,September,Yoakum                                               ,Not Adjusted,3842,3997,155,3.9
11251,2015,December,Yoakum                                               ,Not Adjusted,3696,3848,152,4.0
11252,2015,March,Young                                                ,Not Adjusted,8139,8519,380,4.5
11253,2015,June,Young                                                ,Not Adjusted,8164,8549,385,4.5
11254,2015,September,Young                                                ,Not Adjusted,7954,8325,371,4.5
11255,2015,December,Young                                                ,Not Adjusted,8011,8343,332,4.0
11256,2015,March,Zapata                                               ,Not Adjusted,6272,6713,441,6.6
11257,2015,June,Zapata                                               ,Not Adjusted,5840,6383,543,8.5
11258,2015,September,Zapata                                               ,Not Adjusted,5308,5814,506,8.7
11259,2015,December,Zapata                                               ,Not Adjusted,5133,5620,487,8.7
11260,2015,March,Zavala                                               ,Not Adjusted,3475,3876,401,10.3
11261,2015,June,Zavala                                               ,Not Adjusted,3280,3733,453,12.1
11262,2015,September,Zavala                                               ,Not Adjusted,3453,3864,411,10.6
11263,2015,December,Zavala                                               ,Not Adjusted,3343,3812,469,12.3
11264,2016,March,Texas,Not Adjusted,12708482,13307365,598883,4.5
11265,2016,March,Texas,Adjusted,12683175,13275533,592358,4.5
11266,2016,June,Texas,Not Adjusted,12700951,13363752,662801,5.0
11267,2016,June,Texas,Adjusted,12722956,13344101,621145,4.7
11268,2016,September,Texas,Not Adjusted,12744681,13404600,659919,4.9
11269,2016,September,Texas,Adjusted,12763563,13403980,640417,4.8
11270,2016,December,Texas,Not Adjusted,12805069,13420306,615237,4.6
11271,2016,December,Texas,Adjusted,12805992,13452830,646838,4.8
11272,2016,March,Anderson                                             ,Not Adjusted,22547,23567,1020,4.3
11273,2016,June,Anderson                                             ,Not Adjusted,22473,23590,1117,4.7
11274,2016,September,Anderson                                             ,Not Adjusted,22557,23626,1069,4.5
11275,2016,December,Anderson                                             ,Not Adjusted,22447,23394,947,4.0
11276,2016,March,Andrews                                              ,Not Adjusted,8346,8788,442,5.0
11277,2016,June,Andrews                                              ,Not Adjusted,8250,8710,460,5.3
11278,2016,September,Andrews                                              ,Not Adjusted,8161,8577,416,4.9
11279,2016,December,Andrews                                              ,Not Adjusted,8312,8674,362,4.2
11280,2016,March,Angelina                                             ,Not Adjusted,34712,36829,2117,5.7
11281,2016,June,Angelina                                             ,Not Adjusted,34830,37104,2274,6.1
11282,2016,September,Angelina                                             ,Not Adjusted,34869,37286,2417,6.5
11283,2016,December,Angelina                                             ,Not Adjusted,35006,37184,2178,5.9
11284,2016,March,Aransas                                              ,Not Adjusted,9722,10280,558,5.4
11285,2016,June,Aransas                                              ,Not Adjusted,9716,10286,570,5.5
11286,2016,September,Aransas                                              ,Not Adjusted,9615,10220,605,5.9
11287,2016,December,Aransas                                              ,Not Adjusted,9637,10250,613,6.0
11288,2016,March,Archer                                               ,Not Adjusted,3955,4140,185,4.5
11289,2016,June,Archer                                               ,Not Adjusted,3940,4136,196,4.7
11290,2016,September,Archer                                               ,Not Adjusted,3860,4042,182,4.5
11291,2016,December,Archer                                               ,Not Adjusted,3912,4069,157,3.9
11292,2016,March,Armstrong                                            ,Not Adjusted,927,952,25,2.6
11293,2016,June,Armstrong                                            ,Not Adjusted,917,945,28,3.0
11294,2016,September,Armstrong                                            ,Not Adjusted,895,924,29,3.1
11295,2016,December,Armstrong                                            ,Not Adjusted,892,919,27,2.9
11296,2016,March,Atascosa                                             ,Not Adjusted,19890,21055,1165,5.5
11297,2016,June,Atascosa                                             ,Not Adjusted,19935,21118,1183,5.6
11298,2016,September,Atascosa                                             ,Not Adjusted,19947,21107,1160,5.5
11299,2016,December,Atascosa                                             ,Not Adjusted,20017,21066,1049,5.0
11300,2016,March,Austin                                               ,Not Adjusted,13384,14131,747,5.3
11301,2016,June,Austin                                               ,Not Adjusted,13320,14156,836,5.9
11302,2016,September,Austin                                               ,Not Adjusted,13217,14027,810,5.8
11303,2016,December,Austin                                               ,Not Adjusted,13220,13914,694,5.0
11304,2016,March,Bailey                                               ,Not Adjusted,2709,2833,124,4.4
11305,2016,June,Bailey                                               ,Not Adjusted,2695,2832,137,4.8
11306,2016,September,Bailey                                               ,Not Adjusted,2544,2653,109,4.1
11307,2016,December,Bailey                                               ,Not Adjusted,2491,2598,107,4.1
11308,2016,March,Bandera                                              ,Not Adjusted,9107,9504,397,4.2
11309,2016,June,Bandera                                              ,Not Adjusted,9143,9553,410,4.3
11310,2016,September,Bandera                                              ,Not Adjusted,9122,9531,409,4.3
11311,2016,December,Bandera                                              ,Not Adjusted,9175,9559,384,4.0
11312,2016,March,Bastrop                                              ,Not Adjusted,37417,38814,1397,3.6
11313,2016,June,Bastrop                                              ,Not Adjusted,37617,39254,1637,4.2
11314,2016,September,Bastrop                                              ,Not Adjusted,37713,39242,1529,3.9
11315,2016,December,Bastrop                                              ,Not Adjusted,37945,39363,1418,3.6
11316,2016,March,Baylor                                               ,Not Adjusted,1561,1615,54,3.3
11317,2016,June,Baylor                                               ,Not Adjusted,1593,1656,63,3.8
11318,2016,September,Baylor                                               ,Not Adjusted,1540,1593,53,3.3
11319,2016,December,Baylor                                               ,Not Adjusted,1521,1586,65,4.1
11320,2016,March,Bee                                                  ,Not Adjusted,9725,10480,755,7.2
11321,2016,June,Bee                                                  ,Not Adjusted,9509,10387,878,8.5
11322,2016,September,Bee                                                  ,Not Adjusted,9462,10283,821,8.0
11323,2016,December,Bee                                                  ,Not Adjusted,9470,10237,767,7.5
11324,2016,March,Bell                                                 ,Not Adjusted,133072,139157,6085,4.4
11325,2016,June,Bell                                                 ,Not Adjusted,132691,139512,6821,4.9
11326,2016,September,Bell                                                 ,Not Adjusted,133369,140113,6744,4.8
11327,2016,December,Bell                                                 ,Not Adjusted,134077,140255,6178,4.4
11328,2016,March,Bexar                                                ,Not Adjusted,866791,899666,32875,3.7
11329,2016,June,Bexar                                                ,Not Adjusted,868569,905146,36577,4.0
11330,2016,September,Bexar                                                ,Not Adjusted,877213,913575,36362,4.0
11331,2016,December,Bexar                                                ,Not Adjusted,881010,914483,33473,3.7
11332,2016,March,Blanco                                               ,Not Adjusted,5782,5972,190,3.2
11333,2016,June,Blanco                                               ,Not Adjusted,5820,6017,197,3.3
11334,2016,September,Blanco                                               ,Not Adjusted,5727,5919,192,3.2
11335,2016,December,Blanco                                               ,Not Adjusted,5772,5946,174,2.9
11336,2016,March,Borden                                               ,Not Adjusted,383,398,15,3.8
11337,2016,June,Borden                                               ,Not Adjusted,365,379,14,3.7
11338,2016,September,Borden                                               ,Not Adjusted,329,340,11,3.2
11339,2016,December,Borden                                               ,Not Adjusted,322,333,11,3.3
11340,2016,March,Bosque                                               ,Not Adjusted,7799,8150,351,4.3
11341,2016,June,Bosque                                               ,Not Adjusted,7925,8301,376,4.5
11342,2016,September,Bosque                                               ,Not Adjusted,7854,8211,357,4.3
11343,2016,December,Bosque                                               ,Not Adjusted,7765,8117,352,4.3
11344,2016,March,Bowie                                                ,Not Adjusted,38082,39829,1747,4.4
11345,2016,June,Bowie                                                ,Not Adjusted,38098,39988,1890,4.7
11346,2016,September,Bowie                                                ,Not Adjusted,37571,39638,2067,5.2
11347,2016,December,Bowie                                                ,Not Adjusted,37420,39330,1910,4.9
11348,2016,March,Brazoria                                             ,Not Adjusted,161555,169760,8205,4.8
11349,2016,June,Brazoria                                             ,Not Adjusted,160613,169974,9361,5.5
11350,2016,September,Brazoria                                             ,Not Adjusted,160903,170611,9708,5.7
11351,2016,December,Brazoria                                             ,Not Adjusted,160987,170325,9338,5.5
11352,2016,March,Brazos                                               ,Not Adjusted,108574,112229,3655,3.3
11353,2016,June,Brazos                                               ,Not Adjusted,104001,108413,4412,4.1
11354,2016,September,Brazos                                               ,Not Adjusted,108721,112755,4034,3.6
11355,2016,December,Brazos                                               ,Not Adjusted,109212,112886,3674,3.3
11356,2016,March,Brewster                                             ,Not Adjusted,3839,3983,144,3.6
11357,2016,June,Brewster                                             ,Not Adjusted,3826,3985,159,4.0
11358,2016,September,Brewster                                             ,Not Adjusted,3867,4027,160,4.0
11359,2016,December,Brewster                                             ,Not Adjusted,3747,3891,144,3.7
11360,2016,March,Briscoe                                              ,Not Adjusted,540,563,23,4.1
11361,2016,June,Briscoe                                              ,Not Adjusted,544,572,28,4.9
11362,2016,September,Briscoe                                              ,Not Adjusted,512,534,22,4.1
11363,2016,December,Briscoe                                              ,Not Adjusted,509,531,22,4.1
11364,2016,March,Brooks                                               ,Not Adjusted,2218,2533,315,12.4
11365,2016,June,Brooks                                               ,Not Adjusted,2113,2446,333,13.6
11366,2016,September,Brooks                                               ,Not Adjusted,2123,2412,289,12.0
11367,2016,December,Brooks                                               ,Not Adjusted,2137,2383,246,10.3
11368,2016,March,Brown                                                ,Not Adjusted,15625,16340,715,4.4
11369,2016,June,Brown                                                ,Not Adjusted,15508,16302,794,4.9
11370,2016,September,Brown                                                ,Not Adjusted,15467,16196,729,4.5
11371,2016,December,Brown                                                ,Not Adjusted,15502,16151,649,4.0
11372,2016,March,Burleson                                             ,Not Adjusted,7616,7975,359,4.5
11373,2016,June,Burleson                                             ,Not Adjusted,7322,7728,406,5.3
11374,2016,September,Burleson                                             ,Not Adjusted,7565,7957,392,4.9
11375,2016,December,Burleson                                             ,Not Adjusted,7599,7951,352,4.4
11376,2016,March,Burnet                                               ,Not Adjusted,21067,21816,749,3.4
11377,2016,June,Burnet                                               ,Not Adjusted,21623,22429,806,3.6
11378,2016,September,Burnet                                               ,Not Adjusted,21212,22029,817,3.7
11379,2016,December,Burnet                                               ,Not Adjusted,21335,22091,756,3.4
11380,2016,March,Caldwell                                             ,Not Adjusted,17089,17870,781,4.4
11381,2016,June,Caldwell                                             ,Not Adjusted,17181,18045,864,4.8
11382,2016,September,Caldwell                                             ,Not Adjusted,17239,18055,816,4.5
11383,2016,December,Caldwell                                             ,Not Adjusted,17346,18079,733,4.1
11384,2016,March,Calhoun                                              ,Not Adjusted,10285,10839,554,5.1
11385,2016,June,Calhoun                                              ,Not Adjusted,10355,10966,611,5.6
11386,2016,September,Calhoun                                              ,Not Adjusted,10158,10854,696,6.4
11387,2016,December,Calhoun                                              ,Not Adjusted,9679,10336,657,6.4
11388,2016,March,Callahan                                             ,Not Adjusted,5590,5844,254,4.3
11389,2016,June,Callahan                                             ,Not Adjusted,5555,5817,262,4.5
11390,2016,September,Callahan                                             ,Not Adjusted,5549,5800,251,4.3
11391,2016,December,Callahan                                             ,Not Adjusted,5562,5798,236,4.1
11392,2016,March,Cameron                                              ,Not Adjusted,154729,166355,11626,7.0
11393,2016,June,Cameron                                              ,Not Adjusted,154667,167636,12969,7.7
11394,2016,September,Cameron                                              ,Not Adjusted,153183,165524,12341,7.5
11395,2016,December,Cameron                                              ,Not Adjusted,154808,167116,12308,7.4
11396,2016,March,Camp                                                 ,Not Adjusted,4834,5137,303,5.9
11397,2016,June,Camp                                                 ,Not Adjusted,4733,5131,398,7.8
11398,2016,September,Camp                                                 ,Not Adjusted,4685,5063,378,7.5
11399,2016,December,Camp                                                 ,Not Adjusted,4662,4999,337,6.7
11400,2016,March,Carson                                               ,Not Adjusted,3055,3160,105,3.3
11401,2016,June,Carson                                               ,Not Adjusted,3024,3134,110,3.5
11402,2016,September,Carson                                               ,Not Adjusted,2957,3055,98,3.2
11403,2016,December,Carson                                               ,Not Adjusted,2948,3043,95,3.1
11404,2016,March,Cass                                                 ,Not Adjusted,11662,12454,792,6.4
11405,2016,June,Cass                                                 ,Not Adjusted,11383,12365,982,7.9
11406,2016,September,Cass                                                 ,Not Adjusted,11341,12301,960,7.8
11407,2016,December,Cass                                                 ,Not Adjusted,11362,12225,863,7.1
11408,2016,March,Castro                                               ,Not Adjusted,3494,3596,102,2.8
11409,2016,June,Castro                                               ,Not Adjusted,3512,3632,120,3.3
11410,2016,September,Castro                                               ,Not Adjusted,3390,3498,108,3.1
11411,2016,December,Castro                                               ,Not Adjusted,3222,3336,114,3.4
11412,2016,March,Chambers                                             ,Not Adjusted,17147,18152,1005,5.5
11413,2016,June,Chambers                                             ,Not Adjusted,17055,18241,1186,6.5
11414,2016,September,Chambers                                             ,Not Adjusted,17087,18285,1198,6.6
11415,2016,December,Chambers                                             ,Not Adjusted,17109,18392,1283,7.0
11416,2016,March,Cherokee                                             ,Not Adjusted,20252,21326,1074,5.0
11417,2016,June,Cherokee                                             ,Not Adjusted,20288,21420,1132,5.3
11418,2016,September,Cherokee                                             ,Not Adjusted,20015,21135,1120,5.3
11419,2016,December,Cherokee                                             ,Not Adjusted,19931,21001,1070,5.1
11420,2016,March,Childress                                            ,Not Adjusted,2822,2912,90,3.1
11421,2016,June,Childress                                            ,Not Adjusted,2976,3070,94,3.1
11422,2016,September,Childress                                            ,Not Adjusted,2890,2989,99,3.3
11423,2016,December,Childress                                            ,Not Adjusted,2837,2916,79,2.7
11424,2016,March,Clay                                                 ,Not Adjusted,4648,4871,223,4.6
11425,2016,June,Clay                                                 ,Not Adjusted,4623,4843,220,4.5
11426,2016,September,Clay                                                 ,Not Adjusted,4522,4735,213,4.5
11427,2016,December,Clay                                                 ,Not Adjusted,4572,4766,194,4.1
11428,2016,March,Cochran                                              ,Not Adjusted,1180,1237,57,4.6
11429,2016,June,Cochran                                              ,Not Adjusted,1165,1230,65,5.3
11430,2016,September,Cochran                                              ,Not Adjusted,1076,1136,60,5.3
11431,2016,December,Cochran                                              ,Not Adjusted,1049,1107,58,5.2
11432,2016,March,Coke                                                 ,Not Adjusted,1381,1443,62,4.3
11433,2016,June,Coke                                                 ,Not Adjusted,1382,1447,65,4.5
11434,2016,September,Coke                                                 ,Not Adjusted,1378,1441,63,4.4
11435,2016,December,Coke                                                 ,Not Adjusted,1337,1393,56,4.0
11436,2016,March,Coleman                                              ,Not Adjusted,2921,3103,182,5.9
11437,2016,June,Coleman                                              ,Not Adjusted,2926,3122,196,6.3
11438,2016,September,Coleman                                              ,Not Adjusted,2893,3072,179,5.8
11439,2016,December,Coleman                                              ,Not Adjusted,2859,3023,164,5.4
11440,2016,March,Collin                                               ,Not Adjusted,489709,507494,17785,3.5
11441,2016,June,Collin                                               ,Not Adjusted,493203,512470,19267,3.8
11442,2016,September,Collin                                               ,Not Adjusted,498394,517902,19508,3.8
11443,2016,December,Collin                                               ,Not Adjusted,502771,520812,18041,3.5
11444,2016,March,Collingsworth                                        ,Not Adjusted,1197,1236,39,3.2
11445,2016,June,Collingsworth                                        ,Not Adjusted,1207,1258,51,4.1
11446,2016,September,Collingsworth                                        ,Not Adjusted,1143,1186,43,3.6
11447,2016,December,Collingsworth                                        ,Not Adjusted,1124,1163,39,3.4
11448,2016,March,Colorado                                             ,Not Adjusted,9368,9784,416,4.3
11449,2016,June,Colorado                                             ,Not Adjusted,9693,10220,527,5.2
11450,2016,September,Colorado                                             ,Not Adjusted,9187,9714,527,5.4
11451,2016,December,Colorado                                             ,Not Adjusted,9096,9559,463,4.8
11452,2016,March,Comal                                                ,Not Adjusted,62808,65113,2305,3.5
11453,2016,June,Comal                                                ,Not Adjusted,63062,65623,2561,3.9
11454,2016,September,Comal                                                ,Not Adjusted,63390,65916,2526,3.8
11455,2016,December,Comal                                                ,Not Adjusted,63818,66173,2355,3.6
11456,2016,March,Comanche                                             ,Not Adjusted,5209,5433,224,4.1
11457,2016,June,Comanche                                             ,Not Adjusted,5190,5444,254,4.7
11458,2016,September,Comanche                                             ,Not Adjusted,5113,5357,244,4.6
11459,2016,December,Comanche                                             ,Not Adjusted,5068,5297,229,4.3
11460,2016,March,Concho                                               ,Not Adjusted,1381,1434,53,3.7
11461,2016,June,Concho                                               ,Not Adjusted,1340,1392,52,3.7
11462,2016,September,Concho                                               ,Not Adjusted,1225,1266,41,3.2
11463,2016,December,Concho                                               ,Not Adjusted,1211,1245,34,2.7
11464,2016,March,Cooke                                                ,Not Adjusted,18237,18993,756,4.0
11465,2016,June,Cooke                                                ,Not Adjusted,18163,18964,801,4.2
11466,2016,September,Cooke                                                ,Not Adjusted,18073,18856,783,4.2
11467,2016,December,Cooke                                                ,Not Adjusted,18197,18907,710,3.8
11468,2016,March,Coryell                                              ,Not Adjusted,23264,24380,1116,4.6
11469,2016,June,Coryell                                              ,Not Adjusted,23198,24431,1233,5.0
11470,2016,September,Coryell                                              ,Not Adjusted,23294,24507,1213,4.9
11471,2016,December,Coryell                                              ,Not Adjusted,23417,24510,1093,4.5
11472,2016,March,Cottle                                               ,Not Adjusted,509,536,27,5.0
11473,2016,June,Cottle                                               ,Not Adjusted,509,537,28,5.2
11474,2016,September,Cottle                                               ,Not Adjusted,506,534,28,5.2
11475,2016,December,Cottle                                               ,Not Adjusted,473,497,24,4.8
11476,2016,March,Crane                                                ,Not Adjusted,1618,1792,174,9.7
11477,2016,June,Crane                                                ,Not Adjusted,1564,1737,173,10.0
11478,2016,September,Crane                                                ,Not Adjusted,1530,1676,146,8.7
11479,2016,December,Crane                                                ,Not Adjusted,1506,1621,115,7.1
11480,2016,March,Crockett                                             ,Not Adjusted,1615,1767,152,8.6
11481,2016,June,Crockett                                             ,Not Adjusted,1641,1781,140,7.9
11482,2016,September,Crockett                                             ,Not Adjusted,1601,1730,129,7.5
11483,2016,December,Crockett                                             ,Not Adjusted,1565,1668,103,6.2
11484,2016,March,Crosby                                               ,Not Adjusted,2583,2690,107,4.0
11485,2016,June,Crosby                                               ,Not Adjusted,2560,2699,139,5.2
11486,2016,September,Crosby                                               ,Not Adjusted,2467,2590,123,4.7
11487,2016,December,Crosby                                               ,Not Adjusted,2445,2545,100,3.9
11488,2016,March,Culberson                                            ,Not Adjusted,974,1013,39,3.8
11489,2016,June,Culberson                                            ,Not Adjusted,970,1013,43,4.2
11490,2016,September,Culberson                                            ,Not Adjusted,949,991,42,4.2
11491,2016,December,Culberson                                            ,Not Adjusted,918,960,42,4.4
11492,2016,March,Dallam                                               ,Not Adjusted,3984,4067,83,2.0
11493,2016,June,Dallam                                               ,Not Adjusted,3988,4080,92,2.3
11494,2016,September,Dallam                                               ,Not Adjusted,3845,3936,91,2.3
11495,2016,December,Dallam                                               ,Not Adjusted,3820,3912,92,2.4
11496,2016,March,Dallas                                               ,Not Adjusted,1233142,1284623,51481,4.0
11497,2016,June,Dallas                                               ,Not Adjusted,1242618,1297705,55087,4.2
11498,2016,September,Dallas                                               ,Not Adjusted,1254690,1310263,55573,4.2
11499,2016,December,Dallas                                               ,Not Adjusted,1266628,1317958,51330,3.9
11500,2016,March,Dawson                                               ,Not Adjusted,4408,4636,228,4.9
11501,2016,June,Dawson                                               ,Not Adjusted,4478,4737,259,5.5
11502,2016,September,Dawson                                               ,Not Adjusted,4347,4602,255,5.5
11503,2016,December,Dawson                                               ,Not Adjusted,4424,4641,217,4.7
11504,2016,March,Deaf Smith                                           ,Not Adjusted,8639,8914,275,3.1
11505,2016,June,Deaf Smith                                           ,Not Adjusted,8549,8837,288,3.3
11506,2016,September,Deaf Smith                                           ,Not Adjusted,8217,8507,290,3.4
11507,2016,December,Deaf Smith                                           ,Not Adjusted,8013,8280,267,3.2
11508,2016,March,Delta                                                ,Not Adjusted,2557,2653,96,3.6
11509,2016,June,Delta                                                ,Not Adjusted,2484,2586,102,3.9
11510,2016,September,Delta                                                ,Not Adjusted,2509,2615,106,4.1
11511,2016,December,Delta                                                ,Not Adjusted,2512,2611,99,3.8
11512,2016,March,Denton                                               ,Not Adjusted,431893,447190,15297,3.4
11513,2016,June,Denton                                               ,Not Adjusted,434782,451425,16643,3.7
11514,2016,September,Denton                                               ,Not Adjusted,439748,456322,16574,3.6
11515,2016,December,Denton                                               ,Not Adjusted,443357,458816,15459,3.4
11516,2016,March,DeWitt                                               ,Not Adjusted,9155,9612,457,4.8
11517,2016,June,DeWitt                                               ,Not Adjusted,9045,9623,578,6.0
11518,2016,September,DeWitt                                               ,Not Adjusted,8870,9468,598,6.3
11519,2016,December,DeWitt                                               ,Not Adjusted,8676,9200,524,5.7
11520,2016,March,Dickens                                              ,Not Adjusted,677,714,37,5.2
11521,2016,June,Dickens                                              ,Not Adjusted,697,736,39,5.3
11522,2016,September,Dickens                                              ,Not Adjusted,637,675,38,5.6
11523,2016,December,Dickens                                              ,Not Adjusted,632,663,31,4.7
11524,2016,March,Dimmit                                               ,Not Adjusted,6002,6466,464,7.2
11525,2016,June,Dimmit                                               ,Not Adjusted,5629,6130,501,8.2
11526,2016,September,Dimmit                                               ,Not Adjusted,5561,6011,450,7.5
11527,2016,December,Dimmit                                               ,Not Adjusted,5642,6042,400,6.6
11528,2016,March,Donley                                               ,Not Adjusted,1525,1587,62,3.9
11529,2016,June,Donley                                               ,Not Adjusted,1534,1610,76,4.7
11530,2016,September,Donley                                               ,Not Adjusted,1447,1509,62,4.1
11531,2016,December,Donley                                               ,Not Adjusted,1457,1515,58,3.8
11532,2016,March,Duval                                                ,Not Adjusted,4415,4979,564,11.3
11533,2016,June,Duval                                                ,Not Adjusted,4309,4895,586,12.0
11534,2016,September,Duval                                                ,Not Adjusted,4315,4868,553,11.4
11535,2016,December,Duval                                                ,Not Adjusted,4327,4809,482,10.0
11536,2016,March,Eastland                                             ,Not Adjusted,7092,7511,419,5.6
11537,2016,June,Eastland                                             ,Not Adjusted,7081,7526,445,5.9
11538,2016,September,Eastland                                             ,Not Adjusted,6998,7395,397,5.4
11539,2016,December,Eastland                                             ,Not Adjusted,6982,7373,391,5.3
11540,2016,March,Ector                                                ,Not Adjusted,71995,76897,4902,6.4
11541,2016,June,Ector                                                ,Not Adjusted,70076,75531,5455,7.2
11542,2016,September,Ector                                                ,Not Adjusted,71102,76273,5171,6.8
11543,2016,December,Ector                                                ,Not Adjusted,71617,75877,4260,5.6
11544,2016,March,Edwards                                              ,Not Adjusted,829,870,41,4.7
11545,2016,June,Edwards                                              ,Not Adjusted,842,891,49,5.5
11546,2016,September,Edwards                                              ,Not Adjusted,821,863,42,4.9
11547,2016,December,Edwards                                              ,Not Adjusted,838,875,37,4.2
11548,2016,March,Ellis                                                ,Not Adjusted,81015,84072,3057,3.6
11549,2016,June,Ellis                                                ,Not Adjusted,81618,85089,3471,4.1
11550,2016,September,Ellis                                                ,Not Adjusted,82310,85733,3423,4.0
11551,2016,December,Ellis                                                ,Not Adjusted,83057,86165,3108,3.6
11552,2016,March,El Paso                                              ,Not Adjusted,331352,348218,16866,4.8
11553,2016,June,El Paso                                              ,Not Adjusted,329544,347855,18311,5.3
11554,2016,September,El Paso                                              ,Not Adjusted,335113,353567,18454,5.2
11555,2016,December,El Paso                                              ,Not Adjusted,334948,352083,17135,4.9
11556,2016,March,Erath                                                ,Not Adjusted,19932,20722,790,3.8
11557,2016,June,Erath                                                ,Not Adjusted,19378,20329,951,4.7
11558,2016,September,Erath                                                ,Not Adjusted,19070,19916,846,4.2
11559,2016,December,Erath                                                ,Not Adjusted,19117,19887,770,3.9
11560,2016,March,Falls                                                ,Not Adjusted,6335,6623,288,4.3
11561,2016,June,Falls                                                ,Not Adjusted,6319,6644,325,4.9
11562,2016,September,Falls                                                ,Not Adjusted,6343,6660,317,4.8
11563,2016,December,Falls                                                ,Not Adjusted,6335,6617,282,4.3
11564,2016,March,Fannin                                               ,Not Adjusted,15181,15751,570,3.6
11565,2016,June,Fannin                                               ,Not Adjusted,15124,15758,634,4.0
11566,2016,September,Fannin                                               ,Not Adjusted,15248,15877,629,4.0
11567,2016,December,Fannin                                               ,Not Adjusted,15227,15808,581,3.7
11568,2016,March,Fayette                                              ,Not Adjusted,12174,12622,448,3.5
11569,2016,June,Fayette                                              ,Not Adjusted,12206,12688,482,3.8
11570,2016,September,Fayette                                              ,Not Adjusted,11862,12354,492,4.0
11571,2016,December,Fayette                                              ,Not Adjusted,11845,12304,459,3.7
11572,2016,March,Fisher                                               ,Not Adjusted,1738,1816,78,4.3
11573,2016,June,Fisher                                               ,Not Adjusted,1725,1805,80,4.4
11574,2016,September,Fisher                                               ,Not Adjusted,1628,1711,83,4.9
11575,2016,December,Fisher                                               ,Not Adjusted,1649,1718,69,4.0
11576,2016,March,Floyd                                                ,Not Adjusted,2634,2787,153,5.5
11577,2016,June,Floyd                                                ,Not Adjusted,2692,2840,148,5.2
11578,2016,September,Floyd                                                ,Not Adjusted,2575,2714,139,5.1
11579,2016,December,Floyd                                                ,Not Adjusted,2482,2618,136,5.2
11580,2016,March,Foard                                                ,Not Adjusted,513,531,18,3.4
11581,2016,June,Foard                                                ,Not Adjusted,524,543,19,3.5
11582,2016,September,Foard                                                ,Not Adjusted,524,548,24,4.4
11583,2016,December,Foard                                                ,Not Adjusted,529,553,24,4.3
11584,2016,March,Fort Bend                                            ,Not Adjusted,349456,366600,17144,4.7
11585,2016,June,Fort Bend                                            ,Not Adjusted,347781,367518,19737,5.4
11586,2016,September,Fort Bend                                            ,Not Adjusted,348055,368297,20242,5.5
11587,2016,December,Fort Bend                                            ,Not Adjusted,348709,367223,18514,5.0
11588,2016,March,Franklin                                             ,Not Adjusted,4391,4599,208,4.5
11589,2016,June,Franklin                                             ,Not Adjusted,4355,4594,239,5.2
11590,2016,September,Franklin                                             ,Not Adjusted,4229,4470,241,5.4
11591,2016,December,Franklin                                             ,Not Adjusted,4201,4430,229,5.2
11592,2016,March,Freestone                                            ,Not Adjusted,6553,7009,456,6.5
11593,2016,June,Freestone                                            ,Not Adjusted,6512,7027,515,7.3
11594,2016,September,Freestone                                            ,Not Adjusted,6270,6744,474,7.0
11595,2016,December,Freestone                                            ,Not Adjusted,6168,6609,441,6.7
11596,2016,March,Frio                                                 ,Not Adjusted,8518,8957,439,4.9
11597,2016,June,Frio                                                 ,Not Adjusted,8252,8714,462,5.3
11598,2016,September,Frio                                                 ,Not Adjusted,8267,8707,440,5.1
11599,2016,December,Frio                                                 ,Not Adjusted,8230,8640,410,4.7
11600,2016,March,Gaines                                               ,Not Adjusted,9028,9374,346,3.7
11601,2016,June,Gaines                                               ,Not Adjusted,9082,9458,376,4.0
11602,2016,September,Gaines                                               ,Not Adjusted,8588,8940,352,3.9
11603,2016,December,Gaines                                               ,Not Adjusted,8664,8987,323,3.6
11604,2016,March,Galveston                                            ,Not Adjusted,152054,160041,7987,5.0
11605,2016,June,Galveston                                            ,Not Adjusted,151299,160302,9003,5.6
11606,2016,September,Galveston                                            ,Not Adjusted,151309,160699,9390,5.8
11607,2016,December,Galveston                                            ,Not Adjusted,151536,160563,9027,5.6
11608,2016,March,Garza                                                ,Not Adjusted,2059,2153,94,4.4
11609,2016,June,Garza                                                ,Not Adjusted,2084,2166,82,3.8
11610,2016,September,Garza                                                ,Not Adjusted,2045,2126,81,3.8
11611,2016,December,Garza                                                ,Not Adjusted,2051,2126,75,3.5
11612,2016,March,Gillespie                                            ,Not Adjusted,12674,13034,360,2.8
11613,2016,June,Gillespie                                            ,Not Adjusted,12802,13190,388,2.9
11614,2016,September,Gillespie                                            ,Not Adjusted,12480,12877,397,3.1
11615,2016,December,Gillespie                                            ,Not Adjusted,12658,13023,365,2.8
11616,2016,March,Glasscock                                            ,Not Adjusted,759,785,26,3.3
11617,2016,June,Glasscock                                            ,Not Adjusted,758,793,35,4.4
11618,2016,September,Glasscock                                            ,Not Adjusted,705,734,29,4.0
11619,2016,December,Glasscock                                            ,Not Adjusted,652,675,23,3.4
11620,2016,March,Goliad                                               ,Not Adjusted,3175,3362,187,5.6
11621,2016,June,Goliad                                               ,Not Adjusted,3109,3319,210,6.3
11622,2016,September,Goliad                                               ,Not Adjusted,3098,3301,203,6.1
11623,2016,December,Goliad                                               ,Not Adjusted,3076,3266,190,5.8
11624,2016,March,Gonzales                                             ,Not Adjusted,9390,9805,415,4.2
11625,2016,June,Gonzales                                             ,Not Adjusted,9211,9664,453,4.7
11626,2016,September,Gonzales                                             ,Not Adjusted,9094,9527,433,4.5
11627,2016,December,Gonzales                                             ,Not Adjusted,8998,9374,376,4.0
11628,2016,March,Gray                                                 ,Not Adjusted,8097,8693,596,6.9
11629,2016,June,Gray                                                 ,Not Adjusted,7971,8626,655,7.6
11630,2016,September,Gray                                                 ,Not Adjusted,7773,8387,614,7.3
11631,2016,December,Gray                                                 ,Not Adjusted,7674,8203,529,6.4
11632,2016,March,Grayson                                              ,Not Adjusted,58310,60710,2400,4.0
11633,2016,June,Grayson                                              ,Not Adjusted,58871,61378,2507,4.1
11634,2016,September,Grayson                                              ,Not Adjusted,58785,61243,2458,4.0
11635,2016,December,Grayson                                              ,Not Adjusted,59375,61606,2231,3.6
11636,2016,March,Gregg                                                ,Not Adjusted,55578,58817,3239,5.5
11637,2016,June,Gregg                                                ,Not Adjusted,54514,58548,4034,6.9
11638,2016,September,Gregg                                                ,Not Adjusted,54529,58479,3950,6.8
11639,2016,December,Gregg                                                ,Not Adjusted,54311,57731,3420,5.9
11640,2016,March,Grimes                                               ,Not Adjusted,10609,11253,644,5.7
11641,2016,June,Grimes                                               ,Not Adjusted,10216,11052,836,7.6
11642,2016,September,Grimes                                               ,Not Adjusted,10237,11032,795,7.2
11643,2016,December,Grimes                                               ,Not Adjusted,10125,10823,698,6.4
11644,2016,March,Guadalupe                                            ,Not Adjusted,72899,75503,2604,3.4
11645,2016,June,Guadalupe                                            ,Not Adjusted,72981,75929,2948,3.9
11646,2016,September,Guadalupe                                            ,Not Adjusted,73731,76655,2924,3.8
11647,2016,December,Guadalupe                                            ,Not Adjusted,73953,76665,2712,3.5
11648,2016,March,Hale                                                 ,Not Adjusted,12095,12792,697,5.4
11649,2016,June,Hale                                                 ,Not Adjusted,11928,12768,840,6.6
11650,2016,September,Hale                                                 ,Not Adjusted,11887,12603,716,5.7
11651,2016,December,Hale                                                 ,Not Adjusted,11681,12313,632,5.1
11652,2016,March,Hall                                                 ,Not Adjusted,1133,1208,75,6.2
11653,2016,June,Hall                                                 ,Not Adjusted,1120,1206,86,7.1
11654,2016,September,Hall                                                 ,Not Adjusted,1078,1162,84,7.2
11655,2016,December,Hall                                                 ,Not Adjusted,1019,1096,77,7.0
11656,2016,March,Hamilton                                             ,Not Adjusted,3473,3649,176,4.8
11657,2016,June,Hamilton                                             ,Not Adjusted,3486,3674,188,5.1
11658,2016,September,Hamilton                                             ,Not Adjusted,3416,3602,186,5.2
11659,2016,December,Hamilton                                             ,Not Adjusted,3343,3510,167,4.8
11660,2016,March,Hansford                                             ,Not Adjusted,2961,3050,89,2.9
11661,2016,June,Hansford                                             ,Not Adjusted,2937,3034,97,3.2
11662,2016,September,Hansford                                             ,Not Adjusted,2820,2914,94,3.2
11663,2016,December,Hansford                                             ,Not Adjusted,2708,2799,91,3.3
11664,2016,March,Hardeman                                             ,Not Adjusted,1568,1631,63,3.9
11665,2016,June,Hardeman                                             ,Not Adjusted,1590,1662,72,4.3
11666,2016,September,Hardeman                                             ,Not Adjusted,1564,1626,62,3.8
11667,2016,December,Hardeman                                             ,Not Adjusted,1548,1612,64,4.0
11668,2016,March,Hardin                                               ,Not Adjusted,23838,25299,1461,5.8
11669,2016,June,Hardin                                               ,Not Adjusted,23551,25162,1611,6.4
11670,2016,September,Hardin                                               ,Not Adjusted,23619,25253,1634,6.5
11671,2016,December,Hardin                                               ,Not Adjusted,23425,25061,1636,6.5
11672,2016,March,Harris                                               ,Not Adjusted,2135558,2249146,113588,5.1
11673,2016,June,Harris                                               ,Not Adjusted,2126951,2254951,128000,5.7
11674,2016,September,Harris                                               ,Not Adjusted,2126119,2257506,131387,5.8
11675,2016,December,Harris                                               ,Not Adjusted,2132046,2254500,122454,5.4
11676,2016,March,Harrison                                             ,Not Adjusted,28343,30057,1714,5.7
11677,2016,June,Harrison                                             ,Not Adjusted,28118,30115,1997,6.6
11678,2016,September,Harrison                                             ,Not Adjusted,28041,29982,1941,6.5
11679,2016,December,Harrison                                             ,Not Adjusted,27742,29455,1713,5.8
11680,2016,March,Hartley                                              ,Not Adjusted,2961,3020,59,2.0
11681,2016,June,Hartley                                              ,Not Adjusted,2974,3040,66,2.2
11682,2016,September,Hartley                                              ,Not Adjusted,2860,2922,62,2.1
11683,2016,December,Hartley                                              ,Not Adjusted,2821,2878,57,2.0
11684,2016,March,Haskell                                              ,Not Adjusted,2511,2607,96,3.7
11685,2016,June,Haskell                                              ,Not Adjusted,2452,2556,104,4.1
11686,2016,September,Haskell                                              ,Not Adjusted,2367,2495,128,5.1
11687,2016,December,Haskell                                              ,Not Adjusted,2326,2439,113,4.6
11688,2016,March,Hays                                                 ,Not Adjusted,100750,104096,3346,3.2
11689,2016,June,Hays                                                 ,Not Adjusted,101307,105113,3806,3.6
11690,2016,September,Hays                                                 ,Not Adjusted,101927,105717,3790,3.6
11691,2016,December,Hays                                                 ,Not Adjusted,102613,106086,3473,3.3
11692,2016,March,Hemphill                                             ,Not Adjusted,2011,2105,94,4.5
11693,2016,June,Hemphill                                             ,Not Adjusted,2063,2149,86,4.0
11694,2016,September,Hemphill                                             ,Not Adjusted,2055,2133,78,3.7
11695,2016,December,Hemphill                                             ,Not Adjusted,2063,2130,67,3.1
11696,2016,March,Henderson                                            ,Not Adjusted,33648,35273,1625,4.6
11697,2016,June,Henderson                                            ,Not Adjusted,33931,35723,1792,5.0
11698,2016,September,Henderson                                            ,Not Adjusted,33689,35467,1778,5.0
11699,2016,December,Henderson                                            ,Not Adjusted,33937,35530,1593,4.5
11700,2016,March,Hidalgo                                              ,Not Adjusted,312085,338144,26059,7.7
11701,2016,June,Hidalgo                                              ,Not Adjusted,310829,339227,28398,8.4
11702,2016,September,Hidalgo                                              ,Not Adjusted,309135,335791,26656,7.9
11703,2016,December,Hidalgo                                              ,Not Adjusted,315879,344207,28328,8.2
11704,2016,March,Hill                                                 ,Not Adjusted,15303,15988,685,4.3
11705,2016,June,Hill                                                 ,Not Adjusted,15050,15809,759,4.8
11706,2016,September,Hill                                                 ,Not Adjusted,15077,15800,723,4.6
11707,2016,December,Hill                                                 ,Not Adjusted,15145,15820,675,4.3
11708,2016,March,Hockley                                              ,Not Adjusted,10858,11406,548,4.8
11709,2016,June,Hockley                                              ,Not Adjusted,10655,11236,581,5.2
11710,2016,September,Hockley                                              ,Not Adjusted,10506,11024,518,4.7
11711,2016,December,Hockley                                              ,Not Adjusted,10571,11019,448,4.1
11712,2016,March,Hood                                                 ,Not Adjusted,23998,25183,1185,4.7
11713,2016,June,Hood                                                 ,Not Adjusted,24127,25407,1280,5.0
11714,2016,September,Hood                                                 ,Not Adjusted,24119,25370,1251,4.9
11715,2016,December,Hood                                                 ,Not Adjusted,24297,25476,1179,4.6
11716,2016,March,Hopkins                                              ,Not Adjusted,16720,17394,674,3.9
11717,2016,June,Hopkins                                              ,Not Adjusted,16662,17410,748,4.3
11718,2016,September,Hopkins                                              ,Not Adjusted,16655,17377,722,4.2
11719,2016,December,Hopkins                                              ,Not Adjusted,16560,17233,673,3.9
11720,2016,March,Houston                                              ,Not Adjusted,9531,10010,479,4.8
11721,2016,June,Houston                                              ,Not Adjusted,9661,10134,473,4.7
11722,2016,September,Houston                                              ,Not Adjusted,9619,10111,492,4.9
11723,2016,December,Houston                                              ,Not Adjusted,9510,9984,474,4.7
11724,2016,March,Howard                                               ,Not Adjusted,12721,13456,735,5.5
11725,2016,June,Howard                                               ,Not Adjusted,12470,13254,784,5.9
11726,2016,September,Howard                                               ,Not Adjusted,12257,13023,766,5.9
11727,2016,December,Howard                                               ,Not Adjusted,12267,12974,707,5.4
11728,2016,March,Hudspeth                                             ,Not Adjusted,1482,1572,90,5.7
11729,2016,June,Hudspeth                                             ,Not Adjusted,1464,1566,102,6.5
11730,2016,September,Hudspeth                                             ,Not Adjusted,1442,1534,92,6.0
11731,2016,December,Hudspeth                                             ,Not Adjusted,1420,1512,92,6.1
11732,2016,March,Hunt                                                 ,Not Adjusted,38436,40162,1726,4.3
11733,2016,June,Hunt                                                 ,Not Adjusted,38725,40625,1900,4.7
11734,2016,September,Hunt                                                 ,Not Adjusted,38990,40785,1795,4.4
11735,2016,December,Hunt                                                 ,Not Adjusted,39342,41016,1674,4.1
11736,2016,March,Hutchinson                                           ,Not Adjusted,9154,9634,480,5.0
11737,2016,June,Hutchinson                                           ,Not Adjusted,9139,9739,600,6.2
11738,2016,September,Hutchinson                                           ,Not Adjusted,9073,9704,631,6.5
11739,2016,December,Hutchinson                                           ,Not Adjusted,9037,9637,600,6.2
11740,2016,March,Irion                                                ,Not Adjusted,775,798,23,2.9
11741,2016,June,Irion                                                ,Not Adjusted,773,798,25,3.1
11742,2016,September,Irion                                                ,Not Adjusted,738,766,28,3.7
11743,2016,December,Irion                                                ,Not Adjusted,737,766,29,3.8
11744,2016,March,Jack                                                 ,Not Adjusted,3678,3886,208,5.4
11745,2016,June,Jack                                                 ,Not Adjusted,3651,3862,211,5.5
11746,2016,September,Jack                                                 ,Not Adjusted,3627,3826,199,5.2
11747,2016,December,Jack                                                 ,Not Adjusted,3610,3769,159,4.2
11748,2016,March,Jackson                                              ,Not Adjusted,6932,7247,315,4.3
11749,2016,June,Jackson                                              ,Not Adjusted,6975,7360,385,5.2
11750,2016,September,Jackson                                              ,Not Adjusted,6923,7292,369,5.1
11751,2016,December,Jackson                                              ,Not Adjusted,6955,7282,327,4.5
11752,2016,March,Jasper                                               ,Not Adjusted,12558,13576,1018,7.5
11753,2016,June,Jasper                                               ,Not Adjusted,12480,13553,1073,7.9
11754,2016,September,Jasper                                               ,Not Adjusted,12508,13584,1076,7.9
11755,2016,December,Jasper                                               ,Not Adjusted,12384,13515,1131,8.4
11756,2016,March,Jeff Davis                                           ,Not Adjusted,1099,1135,36,3.2
11757,2016,June,Jeff Davis                                           ,Not Adjusted,1087,1117,30,2.7
11758,2016,September,Jeff Davis                                           ,Not Adjusted,1019,1051,32,3.0
11759,2016,December,Jeff Davis                                           ,Not Adjusted,986,1016,30,3.0
11760,2016,March,Jefferson                                            ,Not Adjusted,100864,108001,7137,6.6
11761,2016,June,Jefferson                                            ,Not Adjusted,99697,107429,7732,7.2
11762,2016,September,Jefferson                                            ,Not Adjusted,99881,107874,7993,7.4
11763,2016,December,Jefferson                                            ,Not Adjusted,99107,107418,8311,7.7
11764,2016,March,Jim Hogg                                             ,Not Adjusted,1800,1988,188,9.5
11765,2016,June,Jim Hogg                                             ,Not Adjusted,1736,1932,196,10.1
11766,2016,September,Jim Hogg                                             ,Not Adjusted,1754,1956,202,10.3
11767,2016,December,Jim Hogg                                             ,Not Adjusted,1745,1935,190,9.8
11768,2016,March,Jim Wells                                            ,Not Adjusted,16292,18213,1921,10.5
11769,2016,June,Jim Wells                                            ,Not Adjusted,15369,17457,2088,12.0
11770,2016,September,Jim Wells                                            ,Not Adjusted,15231,17132,1901,11.1
11771,2016,December,Jim Wells                                            ,Not Adjusted,15314,16960,1646,9.7
11772,2016,March,Johnson                                              ,Not Adjusted,72336,75612,3276,4.3
11773,2016,June,Johnson                                              ,Not Adjusted,72580,76191,3611,4.7
11774,2016,September,Johnson                                              ,Not Adjusted,73110,76561,3451,4.5
11775,2016,December,Johnson                                              ,Not Adjusted,73489,76649,3160,4.1
11776,2016,March,Jones                                                ,Not Adjusted,5374,5710,336,5.9
11777,2016,June,Jones                                                ,Not Adjusted,5307,5649,342,6.1
11778,2016,September,Jones                                                ,Not Adjusted,5287,5656,369,6.5
11779,2016,December,Jones                                                ,Not Adjusted,5246,5562,316,5.7
11780,2016,March,Karnes                                               ,Not Adjusted,5928,6243,315,5.0
11781,2016,June,Karnes                                               ,Not Adjusted,5994,6332,338,5.3
11782,2016,September,Karnes                                               ,Not Adjusted,5962,6272,310,4.9
11783,2016,December,Karnes                                               ,Not Adjusted,5922,6211,289,4.7
11784,2016,March,Kaufman                                              ,Not Adjusted,55158,57374,2216,3.9
11785,2016,June,Kaufman                                              ,Not Adjusted,55516,57865,2349,4.1
11786,2016,September,Kaufman                                              ,Not Adjusted,56140,58431,2291,3.9
11787,2016,December,Kaufman                                              ,Not Adjusted,56581,58716,2135,3.6
11788,2016,March,Kendall                                              ,Not Adjusted,19701,20329,628,3.1
11789,2016,June,Kendall                                              ,Not Adjusted,19780,20482,702,3.4
11790,2016,September,Kendall                                              ,Not Adjusted,19697,20403,706,3.5
11791,2016,December,Kendall                                              ,Not Adjusted,19809,20435,626,3.1
11792,2016,March,Kenedy                                               ,Not Adjusted,229,240,11,4.6
11793,2016,June,Kenedy                                               ,Not Adjusted,214,225,11,4.9
11794,2016,September,Kenedy                                               ,Not Adjusted,186,197,11,5.6
11795,2016,December,Kenedy                                               ,Not Adjusted,198,208,10,4.8
11796,2016,March,Kent                                                 ,Not Adjusted,476,491,15,3.1
11797,2016,June,Kent                                                 ,Not Adjusted,493,506,13,2.6
11798,2016,September,Kent                                                 ,Not Adjusted,439,453,14,3.1
11799,2016,December,Kent                                                 ,Not Adjusted,430,442,12,2.7
11800,2016,March,Kerr                                                 ,Not Adjusted,20722,21481,759,3.5
11801,2016,June,Kerr                                                 ,Not Adjusted,21142,21952,810,3.7
11802,2016,September,Kerr                                                 ,Not Adjusted,20281,21112,831,3.9
11803,2016,December,Kerr                                                 ,Not Adjusted,20454,21179,725,3.4
11804,2016,March,Kimble                                               ,Not Adjusted,1886,1965,79,4.0
11805,2016,June,Kimble                                               ,Not Adjusted,1942,2014,72,3.6
11806,2016,September,Kimble                                               ,Not Adjusted,1818,1896,78,4.1
11807,2016,December,Kimble                                               ,Not Adjusted,1862,1933,71,3.7
11808,2016,March,King                                                 ,Not Adjusted,183,189,6,3.2
11809,2016,June,King                                                 ,Not Adjusted,188,194,6,3.1
11810,2016,September,King                                                 ,Not Adjusted,174,182,8,4.4
11811,2016,December,King                                                 ,Not Adjusted,150,158,8,5.1
11812,2016,March,Kinney                                               ,Not Adjusted,1136,1203,67,5.6
11813,2016,June,Kinney                                               ,Not Adjusted,1112,1178,66,5.6
11814,2016,September,Kinney                                               ,Not Adjusted,1055,1122,67,6.0
11815,2016,December,Kinney                                               ,Not Adjusted,1033,1100,67,6.1
11816,2016,March,Kleberg                                              ,Not Adjusted,13574,14521,947,6.5
11817,2016,June,Kleberg                                              ,Not Adjusted,12985,14039,1054,7.5
11818,2016,September,Kleberg                                              ,Not Adjusted,13001,13982,981,7.0
11819,2016,December,Kleberg                                              ,Not Adjusted,13002,13901,899,6.5
11820,2016,March,Knox                                                 ,Not Adjusted,1568,1633,65,4.0
11821,2016,June,Knox                                                 ,Not Adjusted,1562,1639,77,4.7
11822,2016,September,Knox                                                 ,Not Adjusted,1435,1502,67,4.5
11823,2016,December,Knox                                                 ,Not Adjusted,1407,1465,58,4.0
11824,2016,March,Lamar                                                ,Not Adjusted,22155,23126,971,4.2
11825,2016,June,Lamar                                                ,Not Adjusted,22245,23445,1200,5.1
11826,2016,September,Lamar                                                ,Not Adjusted,22418,23620,1202,5.1
11827,2016,December,Lamar                                                ,Not Adjusted,22159,23222,1063,4.6
11828,2016,March,Lamb                                                 ,Not Adjusted,5065,5430,365,6.7
11829,2016,June,Lamb                                                 ,Not Adjusted,5039,5398,359,6.7
11830,2016,September,Lamb                                                 ,Not Adjusted,4769,5101,332,6.5
11831,2016,December,Lamb                                                 ,Not Adjusted,4797,5093,296,5.8
11832,2016,March,Lampasas                                             ,Not Adjusted,8799,9174,375,4.1
11833,2016,June,Lampasas                                             ,Not Adjusted,8787,9204,417,4.5
11834,2016,September,Lampasas                                             ,Not Adjusted,8760,9172,412,4.5
11835,2016,December,Lampasas                                             ,Not Adjusted,8811,9171,360,3.9
11836,2016,March,La Salle                                             ,Not Adjusted,3779,3977,198,5.0
11837,2016,June,La Salle                                             ,Not Adjusted,3606,3827,221,5.8
11838,2016,September,La Salle                                             ,Not Adjusted,3639,3853,214,5.6
11839,2016,December,La Salle                                             ,Not Adjusted,3579,3762,183,4.9
11840,2016,March,Lavaca                                               ,Not Adjusted,8408,8769,361,4.1
11841,2016,June,Lavaca                                               ,Not Adjusted,8474,8866,392,4.4
11842,2016,September,Lavaca                                               ,Not Adjusted,8310,8715,405,4.6
11843,2016,December,Lavaca                                               ,Not Adjusted,8356,8718,362,4.2
11844,2016,March,Lee                                                  ,Not Adjusted,8996,9326,330,3.5
11845,2016,June,Lee                                                  ,Not Adjusted,9028,9407,379,4.0
11846,2016,September,Lee                                                  ,Not Adjusted,8881,9264,383,4.1
11847,2016,December,Lee                                                  ,Not Adjusted,8902,9247,345,3.7
11848,2016,March,Leon                                                 ,Not Adjusted,6247,6666,419,6.3
11849,2016,June,Leon                                                 ,Not Adjusted,6167,6622,455,6.9
11850,2016,September,Leon                                                 ,Not Adjusted,5939,6385,446,7.0
11851,2016,December,Leon                                                 ,Not Adjusted,5929,6336,407,6.4
11852,2016,March,Liberty                                              ,Not Adjusted,29302,31569,2267,7.2
11853,2016,June,Liberty                                              ,Not Adjusted,29159,31738,2579,8.1
11854,2016,September,Liberty                                              ,Not Adjusted,29084,31637,2553,8.1
11855,2016,December,Liberty                                              ,Not Adjusted,29117,31576,2459,7.8
11856,2016,March,Limestone                                            ,Not Adjusted,7933,8401,468,5.6
11857,2016,June,Limestone                                            ,Not Adjusted,7919,8425,506,6.0
11858,2016,September,Limestone                                            ,Not Adjusted,7797,8286,489,5.9
11859,2016,December,Limestone                                            ,Not Adjusted,7811,8248,437,5.3
11860,2016,March,Lipscomb                                             ,Not Adjusted,1615,1689,74,4.4
11861,2016,June,Lipscomb                                             ,Not Adjusted,1606,1691,85,5.0
11862,2016,September,Lipscomb                                             ,Not Adjusted,1537,1610,73,4.5
11863,2016,December,Lipscomb                                             ,Not Adjusted,1540,1604,64,4.0
11864,2016,March,Live Oak                                             ,Not Adjusted,4977,5281,304,5.8
11865,2016,June,Live Oak                                             ,Not Adjusted,4876,5212,336,6.4
11866,2016,September,Live Oak                                             ,Not Adjusted,4824,5152,328,6.4
11867,2016,December,Live Oak                                             ,Not Adjusted,4774,5062,288,5.7
11868,2016,March,Llano                                                ,Not Adjusted,7880,8227,347,4.2
11869,2016,June,Llano                                                ,Not Adjusted,8188,8554,366,4.3
11870,2016,September,Llano                                                ,Not Adjusted,7903,8265,362,4.4
11871,2016,December,Llano                                                ,Not Adjusted,7889,8213,324,3.9
11872,2016,March,Loving                                               ,Not Adjusted,90,94,4,4.3
11873,2016,June,Loving                                               ,Not Adjusted,80,84,4,4.8
11874,2016,September,Loving                                               ,Not Adjusted,72,76,4,5.3
11875,2016,December,Loving                                               ,Not Adjusted,91,96,5,5.2
11876,2016,March,Lubbock                                              ,Not Adjusted,148091,153135,5044,3.3
11877,2016,June,Lubbock                                              ,Not Adjusted,147931,154009,6078,3.9
11878,2016,September,Lubbock                                              ,Not Adjusted,148331,153747,5416,3.5
11879,2016,December,Lubbock                                              ,Not Adjusted,149904,154782,4878,3.2
11880,2016,March,Lynn                                                 ,Not Adjusted,2688,2793,105,3.8
11881,2016,June,Lynn                                                 ,Not Adjusted,2667,2793,126,4.5
11882,2016,September,Lynn                                                 ,Not Adjusted,2587,2705,118,4.4
11883,2016,December,Lynn                                                 ,Not Adjusted,2571,2669,98,3.7
11884,2016,March,McCulloch                                            ,Not Adjusted,3607,3772,165,4.4
11885,2016,June,McCulloch                                            ,Not Adjusted,3567,3742,175,4.7
11886,2016,September,McCulloch                                            ,Not Adjusted,3468,3642,174,4.8
11887,2016,December,McCulloch                                            ,Not Adjusted,3539,3690,151,4.1
11888,2016,March,McLennan                                             ,Not Adjusted,110662,115116,4454,3.9
11889,2016,June,McLennan                                             ,Not Adjusted,110815,115912,5097,4.4
11890,2016,September,McLennan                                             ,Not Adjusted,112368,117274,4906,4.2
11891,2016,December,McLennan                                             ,Not Adjusted,113020,117457,4437,3.8
11892,2016,March,McMullen                                             ,Not Adjusted,903,925,22,2.4
11893,2016,June,McMullen                                             ,Not Adjusted,865,885,20,2.3
11894,2016,September,McMullen                                             ,Not Adjusted,795,813,18,2.2
11895,2016,December,McMullen                                             ,Not Adjusted,746,762,16,2.1
11896,2016,March,Madison                                              ,Not Adjusted,4634,4874,240,4.9
11897,2016,June,Madison                                              ,Not Adjusted,4509,4791,282,5.9
11898,2016,September,Madison                                              ,Not Adjusted,4440,4688,248,5.3
11899,2016,December,Madison                                              ,Not Adjusted,4458,4697,239,5.1
11900,2016,March,Marion                                               ,Not Adjusted,4120,4408,288,6.5
11901,2016,June,Marion                                               ,Not Adjusted,4016,4360,344,7.9
11902,2016,September,Marion                                               ,Not Adjusted,3976,4308,332,7.7
11903,2016,December,Marion                                               ,Not Adjusted,3975,4259,284,6.7
11904,2016,March,Martin                                               ,Not Adjusted,2433,2538,105,4.1
11905,2016,June,Martin                                               ,Not Adjusted,2374,2499,125,5.0
11906,2016,September,Martin                                               ,Not Adjusted,2330,2441,111,4.5
11907,2016,December,Martin                                               ,Not Adjusted,2345,2454,109,4.4
11908,2016,March,Mason                                                ,Not Adjusted,1754,1818,64,3.5
11909,2016,June,Mason                                                ,Not Adjusted,1800,1870,70,3.7
11910,2016,September,Mason                                                ,Not Adjusted,1674,1750,76,4.3
11911,2016,December,Mason                                                ,Not Adjusted,1696,1760,64,3.6
11912,2016,March,Matagorda                                            ,Not Adjusted,16010,17210,1200,7.0
11913,2016,June,Matagorda                                            ,Not Adjusted,15710,17012,1302,7.7
11914,2016,September,Matagorda                                            ,Not Adjusted,15576,16874,1298,7.7
11915,2016,December,Matagorda                                            ,Not Adjusted,15376,16693,1317,7.9
11916,2016,March,Maverick                                             ,Not Adjusted,21799,24936,3137,12.6
11917,2016,June,Maverick                                             ,Not Adjusted,21440,24273,2833,11.7
11918,2016,September,Maverick                                             ,Not Adjusted,21238,23721,2483,10.5
11919,2016,December,Maverick                                             ,Not Adjusted,21882,24335,2453,10.1
11920,2016,March,Medina                                               ,Not Adjusted,20072,20992,920,4.4
11921,2016,June,Medina                                               ,Not Adjusted,20096,21091,995,4.7
11922,2016,September,Medina                                               ,Not Adjusted,20124,21116,992,4.7
11923,2016,December,Medina                                               ,Not Adjusted,20165,21049,884,4.2
11924,2016,March,Menard                                               ,Not Adjusted,794,830,36,4.3
11925,2016,June,Menard                                               ,Not Adjusted,793,832,39,4.7
11926,2016,September,Menard                                               ,Not Adjusted,773,812,39,4.8
11927,2016,December,Menard                                               ,Not Adjusted,783,816,33,4.0
11928,2016,March,Midland                                              ,Not Adjusted,82015,85855,3840,4.5
11929,2016,June,Midland                                              ,Not Adjusted,80029,84180,4151,4.9
11930,2016,September,Midland                                              ,Not Adjusted,80472,84421,3949,4.7
11931,2016,December,Midland                                              ,Not Adjusted,81915,85273,3358,3.9
11932,2016,March,Milam                                                ,Not Adjusted,9824,10320,496,4.8
11933,2016,June,Milam                                                ,Not Adjusted,9795,10369,574,5.5
11934,2016,September,Milam                                                ,Not Adjusted,9752,10322,570,5.5
11935,2016,December,Milam                                                ,Not Adjusted,9574,10133,559,5.5
11936,2016,March,Mills                                                ,Not Adjusted,1892,1966,74,3.8
11937,2016,June,Mills                                                ,Not Adjusted,1869,1952,83,4.3
11938,2016,September,Mills                                                ,Not Adjusted,1812,1903,91,4.8
11939,2016,December,Mills                                                ,Not Adjusted,1810,1885,75,4.0
11940,2016,March,Mitchell                                             ,Not Adjusted,2480,2681,201,7.5
11941,2016,June,Mitchell                                             ,Not Adjusted,2450,2637,187,7.1
11942,2016,September,Mitchell                                             ,Not Adjusted,2362,2555,193,7.6
11943,2016,December,Mitchell                                             ,Not Adjusted,2397,2567,170,6.6
11944,2016,March,Montague                                             ,Not Adjusted,8601,9062,461,5.1
11945,2016,June,Montague                                             ,Not Adjusted,8753,9236,483,5.2
11946,2016,September,Montague                                             ,Not Adjusted,8466,8949,483,5.4
11947,2016,December,Montague                                             ,Not Adjusted,8503,8917,414,4.6
11948,2016,March,Montgomery                                           ,Not Adjusted,253556,265897,12341,4.6
11949,2016,June,Montgomery                                           ,Not Adjusted,252616,266810,14194,5.3
11950,2016,September,Montgomery                                           ,Not Adjusted,252218,266347,14129,5.3
11951,2016,December,Montgomery                                           ,Not Adjusted,252988,265801,12813,4.8
11952,2016,March,Moore                                                ,Not Adjusted,10670,10994,324,2.9
11953,2016,June,Moore                                                ,Not Adjusted,10912,11275,363,3.2
11954,2016,September,Moore                                                ,Not Adjusted,11063,11412,349,3.1
11955,2016,December,Moore                                                ,Not Adjusted,10895,11228,333,3.0
11956,2016,March,Morris                                               ,Not Adjusted,4511,4921,410,8.3
11957,2016,June,Morris                                               ,Not Adjusted,4321,4945,624,12.6
11958,2016,September,Morris                                               ,Not Adjusted,4343,4955,612,12.4
11959,2016,December,Morris                                               ,Not Adjusted,4173,4696,523,11.1
11960,2016,March,Motley                                               ,Not Adjusted,505,525,20,3.8
11961,2016,June,Motley                                               ,Not Adjusted,506,525,19,3.6
11962,2016,September,Motley                                               ,Not Adjusted,479,497,18,3.6
11963,2016,December,Motley                                               ,Not Adjusted,468,487,19,3.9
11964,2016,March,Nacogdoches                                          ,Not Adjusted,27373,28654,1281,4.5
11965,2016,June,Nacogdoches                                          ,Not Adjusted,27202,28722,1520,5.3
11966,2016,September,Nacogdoches                                          ,Not Adjusted,27436,28855,1419,4.9
11967,2016,December,Nacogdoches                                          ,Not Adjusted,27512,28791,1279,4.4
11968,2016,March,Navarro                                              ,Not Adjusted,21805,22723,918,4.0
11969,2016,June,Navarro                                              ,Not Adjusted,21704,22765,1061,4.7
11970,2016,September,Navarro                                              ,Not Adjusted,21989,23006,1017,4.4
11971,2016,December,Navarro                                              ,Not Adjusted,21977,22884,907,4.0
11972,2016,March,Newton                                               ,Not Adjusted,4986,5390,404,7.5
11973,2016,June,Newton                                               ,Not Adjusted,4921,5371,450,8.4
11974,2016,September,Newton                                               ,Not Adjusted,4920,5375,455,8.5
11975,2016,December,Newton                                               ,Not Adjusted,4869,5330,461,8.6
11976,2016,March,Nolan                                                ,Not Adjusted,6594,6930,336,4.8
11977,2016,June,Nolan                                                ,Not Adjusted,6612,6962,350,5.0
11978,2016,September,Nolan                                                ,Not Adjusted,6492,6848,356,5.2
11979,2016,December,Nolan                                                ,Not Adjusted,6438,6749,311,4.6
11980,2016,March,Nueces                                               ,Not Adjusted,158781,168034,9253,5.5
11981,2016,June,Nueces                                               ,Not Adjusted,158309,168291,9982,5.9
11982,2016,September,Nueces                                               ,Not Adjusted,158107,168199,10092,6.0
11983,2016,December,Nueces                                               ,Not Adjusted,158110,167958,9848,5.9
11984,2016,March,Ochiltree                                            ,Not Adjusted,4646,4902,256,5.2
11985,2016,June,Ochiltree                                            ,Not Adjusted,4497,4770,273,5.7
11986,2016,September,Ochiltree                                            ,Not Adjusted,4262,4507,245,5.4
11987,2016,December,Ochiltree                                            ,Not Adjusted,4126,4336,210,4.8
11988,2016,March,Oldham                                               ,Not Adjusted,903,928,25,2.7
11989,2016,June,Oldham                                               ,Not Adjusted,892,919,27,2.9
11990,2016,September,Oldham                                               ,Not Adjusted,868,900,32,3.6
11991,2016,December,Oldham                                               ,Not Adjusted,862,891,29,3.3
11992,2016,March,Orange                                               ,Not Adjusted,35132,37525,2393,6.4
11993,2016,June,Orange                                               ,Not Adjusted,34743,37341,2598,7.0
11994,2016,September,Orange                                               ,Not Adjusted,34822,37501,2679,7.1
11995,2016,December,Orange                                               ,Not Adjusted,34581,37255,2674,7.2
11996,2016,March,Palo Pinto                                           ,Not Adjusted,12651,13420,769,5.7
11997,2016,June,Palo Pinto                                           ,Not Adjusted,12681,13446,765,5.7
11998,2016,September,Palo Pinto                                           ,Not Adjusted,12520,13249,729,5.5
11999,2016,December,Palo Pinto                                           ,Not Adjusted,12320,12980,660,5.1
12000,2016,March,Panola                                               ,Not Adjusted,9698,10426,728,7.0
12001,2016,June,Panola                                               ,Not Adjusted,9291,10122,831,8.2
12002,2016,September,Panola                                               ,Not Adjusted,9452,10221,769,7.5
12003,2016,December,Panola                                               ,Not Adjusted,9542,10229,687,6.7
12004,2016,March,Parker                                               ,Not Adjusted,58525,61039,2514,4.1
12005,2016,June,Parker                                               ,Not Adjusted,58756,61405,2649,4.3
12006,2016,September,Parker                                               ,Not Adjusted,59005,61621,2616,4.2
12007,2016,December,Parker                                               ,Not Adjusted,59341,61738,2397,3.9
12008,2016,March,Parmer                                               ,Not Adjusted,4953,5069,116,2.3
12009,2016,June,Parmer                                               ,Not Adjusted,4955,5090,135,2.7
12010,2016,September,Parmer                                               ,Not Adjusted,4725,4858,133,2.7
12011,2016,December,Parmer                                               ,Not Adjusted,4703,4824,121,2.5
12012,2016,March,Pecos                                                ,Not Adjusted,6121,6505,384,5.9
12013,2016,June,Pecos                                                ,Not Adjusted,6108,6499,391,6.0
12014,2016,September,Pecos                                                ,Not Adjusted,6096,6532,436,6.7
12015,2016,December,Pecos                                                ,Not Adjusted,5966,6365,399,6.3
12016,2016,March,Polk                                                 ,Not Adjusted,16227,17309,1082,6.3
12017,2016,June,Polk                                                 ,Not Adjusted,16369,17490,1121,6.4
12018,2016,September,Polk                                                 ,Not Adjusted,16301,17456,1155,6.6
12019,2016,December,Polk                                                 ,Not Adjusted,16411,17570,1159,6.6
12020,2016,March,Potter                                               ,Not Adjusted,54549,56329,1780,3.2
12021,2016,June,Potter                                               ,Not Adjusted,54193,56169,1976,3.5
12022,2016,September,Potter                                               ,Not Adjusted,53918,55992,2074,3.7
12023,2016,December,Potter                                               ,Not Adjusted,54230,56129,1899,3.4
12024,2016,March,Presidio                                             ,Not Adjusted,2787,3097,310,10.0
12025,2016,June,Presidio                                             ,Not Adjusted,2775,3127,352,11.3
12026,2016,September,Presidio                                             ,Not Adjusted,2730,3058,328,10.7
12027,2016,December,Presidio                                             ,Not Adjusted,2695,3071,376,12.2
12028,2016,March,Rains                                                ,Not Adjusted,5408,5631,223,4.0
12029,2016,June,Rains                                                ,Not Adjusted,5300,5544,244,4.4
12030,2016,September,Rains                                                ,Not Adjusted,5256,5490,234,4.3
12031,2016,December,Rains                                                ,Not Adjusted,5356,5562,206,3.7
12032,2016,March,Randall                                              ,Not Adjusted,69045,71054,2009,2.8
12033,2016,June,Randall                                              ,Not Adjusted,68414,70646,2232,3.2
12034,2016,September,Randall                                              ,Not Adjusted,68174,70450,2276,3.2
12035,2016,December,Randall                                              ,Not Adjusted,68336,70421,2085,3.0
12036,2016,March,Reagan                                               ,Not Adjusted,1594,1699,105,6.2
12037,2016,June,Reagan                                               ,Not Adjusted,1631,1747,116,6.6
12038,2016,September,Reagan                                               ,Not Adjusted,1569,1681,112,6.7
12039,2016,December,Reagan                                               ,Not Adjusted,1585,1668,83,5.0
12040,2016,March,Real                                                 ,Not Adjusted,983,1035,52,5.0
12041,2016,June,Real                                                 ,Not Adjusted,1144,1203,59,4.9
12042,2016,September,Real                                                 ,Not Adjusted,923,987,64,6.5
12043,2016,December,Real                                                 ,Not Adjusted,943,1001,58,5.8
12044,2016,March,Red River                                            ,Not Adjusted,4684,4961,277,5.6
12045,2016,June,Red River                                            ,Not Adjusted,4740,5047,307,6.1
12046,2016,September,Red River                                            ,Not Adjusted,4784,5094,310,6.1
12047,2016,December,Red River                                            ,Not Adjusted,4845,5142,297,5.8
12048,2016,March,Reeves                                               ,Not Adjusted,5711,6053,342,5.7
12049,2016,June,Reeves                                               ,Not Adjusted,5698,6050,352,5.8
12050,2016,September,Reeves                                               ,Not Adjusted,5762,6088,326,5.4
12051,2016,December,Reeves                                               ,Not Adjusted,5815,6089,274,4.5
12052,2016,March,Refugio                                              ,Not Adjusted,3000,3193,193,6.0
12053,2016,June,Refugio                                              ,Not Adjusted,2940,3165,225,7.1
12054,2016,September,Refugio                                              ,Not Adjusted,2894,3124,230,7.4
12055,2016,December,Refugio                                              ,Not Adjusted,2910,3111,201,6.5
12056,2016,March,Roberts                                              ,Not Adjusted,428,445,17,3.8
12057,2016,June,Roberts                                              ,Not Adjusted,431,458,27,5.9
12058,2016,September,Roberts                                              ,Not Adjusted,416,437,21,4.8
12059,2016,December,Roberts                                              ,Not Adjusted,407,426,19,4.5
12060,2016,March,Robertson                                            ,Not Adjusted,7010,7367,357,4.8
12061,2016,June,Robertson                                            ,Not Adjusted,6728,7134,406,5.7
12062,2016,September,Robertson                                            ,Not Adjusted,6931,7312,381,5.2
12063,2016,December,Robertson                                            ,Not Adjusted,6941,7305,364,5.0
12064,2016,March,Rockwall                                             ,Not Adjusted,45216,46878,1662,3.5
12065,2016,June,Rockwall                                             ,Not Adjusted,45568,47396,1828,3.9
12066,2016,September,Rockwall                                             ,Not Adjusted,45977,47713,1736,3.6
12067,2016,December,Rockwall                                             ,Not Adjusted,46418,48064,1646,3.4
12068,2016,March,Runnels                                              ,Not Adjusted,4548,4728,180,3.8
12069,2016,June,Runnels                                              ,Not Adjusted,4545,4742,197,4.2
12070,2016,September,Runnels                                              ,Not Adjusted,4395,4600,205,4.5
12071,2016,December,Runnels                                              ,Not Adjusted,4301,4475,174,3.9
12072,2016,March,Rusk                                                 ,Not Adjusted,21405,22614,1209,5.3
12073,2016,June,Rusk                                                 ,Not Adjusted,21020,22468,1448,6.4
12074,2016,September,Rusk                                                 ,Not Adjusted,20920,22381,1461,6.5
12075,2016,December,Rusk                                                 ,Not Adjusted,20841,22130,1289,5.8
12076,2016,March,Sabine                                               ,Not Adjusted,3172,3484,312,9.0
12077,2016,June,Sabine                                               ,Not Adjusted,3160,3486,326,9.4
12078,2016,September,Sabine                                               ,Not Adjusted,3146,3494,348,10.0
12079,2016,December,Sabine                                               ,Not Adjusted,3110,3494,384,11.0
12080,2016,March,San Augustine                                        ,Not Adjusted,2570,2818,248,8.8
12081,2016,June,San Augustine                                        ,Not Adjusted,2562,2821,259,9.2
12082,2016,September,San Augustine                                        ,Not Adjusted,2545,2813,268,9.5
12083,2016,December,San Augustine                                        ,Not Adjusted,2524,2772,248,8.9
12084,2016,March,San Jacinto                                          ,Not Adjusted,10839,11524,685,5.9
12085,2016,June,San Jacinto                                          ,Not Adjusted,10728,11511,783,6.8
12086,2016,September,San Jacinto                                          ,Not Adjusted,10627,11371,744,6.5
12087,2016,December,San Jacinto                                          ,Not Adjusted,10667,11416,749,6.6
12088,2016,March,San Patricio                                         ,Not Adjusted,28482,30691,2209,7.2
12089,2016,June,San Patricio                                         ,Not Adjusted,28343,30747,2404,7.8
12090,2016,September,San Patricio                                         ,Not Adjusted,28288,30719,2431,7.9
12091,2016,December,San Patricio                                         ,Not Adjusted,28206,30653,2447,8.0
12092,2016,March,San Saba                                             ,Not Adjusted,2342,2418,76,3.1
12093,2016,June,San Saba                                             ,Not Adjusted,2415,2501,86,3.4
12094,2016,September,San Saba                                             ,Not Adjusted,2438,2532,94,3.7
12095,2016,December,San Saba                                             ,Not Adjusted,2446,2532,86,3.4
12096,2016,March,Schleicher                                           ,Not Adjusted,1499,1574,75,4.8
12097,2016,June,Schleicher                                           ,Not Adjusted,1345,1425,80,5.6
12098,2016,September,Schleicher                                           ,Not Adjusted,1256,1336,80,6.0
12099,2016,December,Schleicher                                           ,Not Adjusted,1272,1336,64,4.8
12100,2016,March,Scurry                                               ,Not Adjusted,7252,7719,467,6.1
12101,2016,June,Scurry                                               ,Not Adjusted,7009,7531,522,6.9
12102,2016,September,Scurry                                               ,Not Adjusted,6713,7153,440,6.2
12103,2016,December,Scurry                                               ,Not Adjusted,6739,7105,366,5.2
12104,2016,March,Shackelford                                          ,Not Adjusted,1835,1921,86,4.5
12105,2016,June,Shackelford                                          ,Not Adjusted,1868,1951,83,4.3
12106,2016,September,Shackelford                                          ,Not Adjusted,1750,1823,73,4.0
12107,2016,December,Shackelford                                          ,Not Adjusted,1769,1833,64,3.5
12108,2016,March,Shelby                                               ,Not Adjusted,10538,11187,649,5.8
12109,2016,June,Shelby                                               ,Not Adjusted,10420,11170,750,6.7
12110,2016,September,Shelby                                               ,Not Adjusted,10139,10817,678,6.3
12111,2016,December,Shelby                                               ,Not Adjusted,10016,10642,626,5.9
12112,2016,March,Sherman                                              ,Not Adjusted,1376,1417,41,2.9
12113,2016,June,Sherman                                              ,Not Adjusted,1380,1420,40,2.8
12114,2016,September,Sherman                                              ,Not Adjusted,1274,1316,42,3.2
12115,2016,December,Sherman                                              ,Not Adjusted,1228,1266,38,3.0
12116,2016,March,Smith                                                ,Not Adjusted,99978,104547,4569,4.4
12117,2016,June,Smith                                                ,Not Adjusted,100829,105972,5143,4.9
12118,2016,September,Smith                                                ,Not Adjusted,100939,106175,5236,4.9
12119,2016,December,Smith                                                ,Not Adjusted,101233,105924,4691,4.4
12120,2016,March,Somervell                                            ,Not Adjusted,3912,4107,195,4.7
12121,2016,June,Somervell                                            ,Not Adjusted,3930,4153,223,5.4
12122,2016,September,Somervell                                            ,Not Adjusted,3949,4147,198,4.8
12123,2016,December,Somervell                                            ,Not Adjusted,3977,4190,213,5.1
12124,2016,March,Starr                                                ,Not Adjusted,23119,26900,3781,14.1
12125,2016,June,Starr                                                ,Not Adjusted,22862,26544,3682,13.9
12126,2016,September,Starr                                                ,Not Adjusted,22518,25972,3454,13.3
12127,2016,December,Starr                                                ,Not Adjusted,22994,26710,3716,13.9
12128,2016,March,Stephens                                             ,Not Adjusted,3866,4077,211,5.2
12129,2016,June,Stephens                                             ,Not Adjusted,3861,4108,247,6.0
12130,2016,September,Stephens                                             ,Not Adjusted,3791,4011,220,5.5
12131,2016,December,Stephens                                             ,Not Adjusted,3754,3949,195,4.9
12132,2016,March,Sterling                                             ,Not Adjusted,700,722,22,3.0
12133,2016,June,Sterling                                             ,Not Adjusted,668,691,23,3.3
12134,2016,September,Sterling                                             ,Not Adjusted,603,634,31,4.9
12135,2016,December,Sterling                                             ,Not Adjusted,590,623,33,5.3
12136,2016,March,Stonewall                                            ,Not Adjusted,613,643,30,4.7
12137,2016,June,Stonewall                                            ,Not Adjusted,637,665,28,4.2
12138,2016,September,Stonewall                                            ,Not Adjusted,609,641,32,5.0
12139,2016,December,Stonewall                                            ,Not Adjusted,592,616,24,3.9
12140,2016,March,Sutton                                               ,Not Adjusted,1497,1642,145,8.8
12141,2016,June,Sutton                                               ,Not Adjusted,1464,1607,143,8.9
12142,2016,September,Sutton                                               ,Not Adjusted,1440,1566,126,8.0
12143,2016,December,Sutton                                               ,Not Adjusted,1409,1504,95,6.3
12144,2016,March,Swisher                                              ,Not Adjusted,2618,2736,118,4.3
12145,2016,June,Swisher                                              ,Not Adjusted,2665,2790,125,4.5
12146,2016,September,Swisher                                              ,Not Adjusted,2591,2714,123,4.5
12147,2016,December,Swisher                                              ,Not Adjusted,2575,2677,102,3.8
12148,2016,March,Tarrant                                              ,Not Adjusted,964455,1004229,39774,4.0
12149,2016,June,Tarrant                                              ,Not Adjusted,968003,1011180,43177,4.3
12150,2016,September,Tarrant                                              ,Not Adjusted,976602,1019132,42530,4.2
12151,2016,December,Tarrant                                              ,Not Adjusted,982291,1021337,39046,3.8
12152,2016,March,Taylor                                               ,Not Adjusted,61177,63489,2312,3.6
12153,2016,June,Taylor                                               ,Not Adjusted,60546,63124,2578,4.1
12154,2016,September,Taylor                                               ,Not Adjusted,61107,63632,2525,4.0
12155,2016,December,Taylor                                               ,Not Adjusted,60988,63290,2302,3.6
12156,2016,March,Terrell                                              ,Not Adjusted,397,412,15,3.6
12157,2016,June,Terrell                                              ,Not Adjusted,407,422,15,3.6
12158,2016,September,Terrell                                              ,Not Adjusted,396,414,18,4.3
12159,2016,December,Terrell                                              ,Not Adjusted,353,373,20,5.4
12160,2016,March,Terry                                                ,Not Adjusted,5134,5393,259,4.8
12161,2016,June,Terry                                                ,Not Adjusted,5239,5525,286,5.2
12162,2016,September,Terry                                                ,Not Adjusted,5117,5383,266,4.9
12163,2016,December,Terry                                                ,Not Adjusted,4958,5189,231,4.5
12164,2016,March,Throckmorton                                         ,Not Adjusted,749,775,26,3.4
12165,2016,June,Throckmorton                                         ,Not Adjusted,744,772,28,3.6
12166,2016,September,Throckmorton                                         ,Not Adjusted,698,725,27,3.7
12167,2016,December,Throckmorton                                         ,Not Adjusted,676,702,26,3.7
12168,2016,March,Titus                                                ,Not Adjusted,12147,12864,717,5.6
12169,2016,June,Titus                                                ,Not Adjusted,12105,13011,906,7.0
12170,2016,September,Titus                                                ,Not Adjusted,12070,12944,874,6.8
12171,2016,December,Titus                                                ,Not Adjusted,12070,12844,774,6.0
12172,2016,March,Tom Green                                            ,Not Adjusted,52489,54955,2466,4.5
12173,2016,June,Tom Green                                            ,Not Adjusted,52181,54801,2620,4.8
12174,2016,September,Tom Green                                            ,Not Adjusted,51358,53873,2515,4.7
12175,2016,December,Tom Green                                            ,Not Adjusted,51151,53416,2265,4.2
12176,2016,March,Travis                                               ,Not Adjusted,652222,673031,20809,3.1
12177,2016,June,Travis                                               ,Not Adjusted,656371,679135,22764,3.4
12178,2016,September,Travis                                               ,Not Adjusted,659909,683334,23425,3.4
12179,2016,December,Travis                                               ,Not Adjusted,665122,686428,21306,3.1
12180,2016,March,Trinity                                              ,Not Adjusted,5182,5518,336,6.1
12181,2016,June,Trinity                                              ,Not Adjusted,5229,5587,358,6.4
12182,2016,September,Trinity                                              ,Not Adjusted,5158,5515,357,6.5
12183,2016,December,Trinity                                              ,Not Adjusted,5082,5391,309,5.7
12184,2016,March,Tyler                                                ,Not Adjusted,6717,7234,517,7.1
12185,2016,June,Tyler                                                ,Not Adjusted,6731,7293,562,7.7
12186,2016,September,Tyler                                                ,Not Adjusted,6622,7185,563,7.8
12187,2016,December,Tyler                                                ,Not Adjusted,6622,7204,582,8.1
12188,2016,March,Upshur                                               ,Not Adjusted,17016,18063,1047,5.8
12189,2016,June,Upshur                                               ,Not Adjusted,16709,17989,1280,7.1
12190,2016,September,Upshur                                               ,Not Adjusted,16630,17914,1284,7.2
12191,2016,December,Upshur                                               ,Not Adjusted,16566,17679,1113,6.3
12192,2016,March,Upton                                                ,Not Adjusted,1526,1618,92,5.7
12193,2016,June,Upton                                                ,Not Adjusted,1490,1585,95,6.0
12194,2016,September,Upton                                                ,Not Adjusted,1467,1557,90,5.8
12195,2016,December,Upton                                                ,Not Adjusted,1443,1516,73,4.8
12196,2016,March,Uvalde                                               ,Not Adjusted,11241,11868,627,5.3
12197,2016,June,Uvalde                                               ,Not Adjusted,11429,12085,656,5.4
12198,2016,September,Uvalde                                               ,Not Adjusted,11197,11837,640,5.4
12199,2016,December,Uvalde                                               ,Not Adjusted,10973,11597,624,5.4
12200,2016,March,Val Verde                                            ,Not Adjusted,18911,20213,1302,6.4
12201,2016,June,Val Verde                                            ,Not Adjusted,18906,20224,1318,6.5
12202,2016,September,Val Verde                                            ,Not Adjusted,18926,20226,1300,6.4
12203,2016,December,Val Verde                                            ,Not Adjusted,18997,20223,1226,6.1
12204,2016,March,Van Zandt                                            ,Not Adjusted,23591,24637,1046,4.2
12205,2016,June,Van Zandt                                            ,Not Adjusted,24172,25367,1195,4.7
12206,2016,September,Van Zandt                                            ,Not Adjusted,23836,24977,1141,4.6
12207,2016,December,Van Zandt                                            ,Not Adjusted,23895,24903,1008,4.0
12208,2016,March,Victoria                                             ,Not Adjusted,41853,44089,2236,5.1
12209,2016,June,Victoria                                             ,Not Adjusted,40897,43523,2626,6.0
12210,2016,September,Victoria                                             ,Not Adjusted,41108,43716,2608,6.0
12211,2016,December,Victoria                                             ,Not Adjusted,40814,43129,2315,5.4
12212,2016,March,Walker                                               ,Not Adjusted,22381,23569,1188,5.0
12213,2016,June,Walker                                               ,Not Adjusted,22491,23889,1398,5.9
12214,2016,September,Walker                                               ,Not Adjusted,22711,24049,1338,5.6
12215,2016,December,Walker                                               ,Not Adjusted,22560,23746,1186,5.0
12216,2016,March,Waller                                               ,Not Adjusted,21072,22244,1172,5.3
12217,2016,June,Waller                                               ,Not Adjusted,20951,22368,1417,6.3
12218,2016,September,Waller                                               ,Not Adjusted,20858,22177,1319,5.9
12219,2016,December,Waller                                               ,Not Adjusted,20850,22028,1178,5.3
12220,2016,March,Ward                                                 ,Not Adjusted,5073,5396,323,6.0
12221,2016,June,Ward                                                 ,Not Adjusted,4951,5290,339,6.4
12222,2016,September,Ward                                                 ,Not Adjusted,5174,5498,324,5.9
12223,2016,December,Ward                                                 ,Not Adjusted,5130,5408,278,5.1
12224,2016,March,Washington                                           ,Not Adjusted,14430,15178,748,4.9
12225,2016,June,Washington                                           ,Not Adjusted,14505,15368,863,5.6
12226,2016,September,Washington                                           ,Not Adjusted,14307,15124,817,5.4
12227,2016,December,Washington                                           ,Not Adjusted,14210,14913,703,4.7
12228,2016,March,Webb                                                 ,Not Adjusted,107873,113517,5644,5.0
12229,2016,June,Webb                                                 ,Not Adjusted,107881,114100,6219,5.5
12230,2016,September,Webb                                                 ,Not Adjusted,108726,114421,5695,5.0
12231,2016,December,Webb                                                 ,Not Adjusted,109255,114539,5284,4.6
12232,2016,March,Wharton                                              ,Not Adjusted,20360,21421,1061,5.0
12233,2016,June,Wharton                                              ,Not Adjusted,20216,21377,1161,5.4
12234,2016,September,Wharton                                              ,Not Adjusted,19873,21000,1127,5.4
12235,2016,December,Wharton                                              ,Not Adjusted,19669,20726,1057,5.1
12236,2016,March,Wheeler                                              ,Not Adjusted,2486,2607,121,4.6
12237,2016,June,Wheeler                                              ,Not Adjusted,2438,2563,125,4.9
12238,2016,September,Wheeler                                              ,Not Adjusted,2244,2363,119,5.0
12239,2016,December,Wheeler                                              ,Not Adjusted,2231,2344,113,4.8
12240,2016,March,Wichita                                              ,Not Adjusted,53197,55673,2476,4.4
12241,2016,June,Wichita                                              ,Not Adjusted,53108,55693,2585,4.6
12242,2016,September,Wichita                                              ,Not Adjusted,52534,55009,2475,4.5
12243,2016,December,Wichita                                              ,Not Adjusted,53519,55807,2288,4.1
12244,2016,March,Wilbarger                                            ,Not Adjusted,4885,5117,232,4.5
12245,2016,June,Wilbarger                                            ,Not Adjusted,4855,5117,262,5.1
12246,2016,September,Wilbarger                                            ,Not Adjusted,4767,5012,245,4.9
12247,2016,December,Wilbarger                                            ,Not Adjusted,4723,4959,236,4.8
12248,2016,March,Willacy                                              ,Not Adjusted,5849,6678,829,12.4
12249,2016,June,Willacy                                              ,Not Adjusted,5733,6627,894,13.5
12250,2016,September,Willacy                                              ,Not Adjusted,5685,6482,797,12.3
12251,2016,December,Willacy                                              ,Not Adjusted,5607,6315,708,11.2
12252,2016,March,Williamson                                           ,Not Adjusted,267461,276430,8969,3.2
12253,2016,June,Williamson                                           ,Not Adjusted,268734,278601,9867,3.5
12254,2016,September,Williamson                                           ,Not Adjusted,271004,281181,10177,3.6
12255,2016,December,Williamson                                           ,Not Adjusted,272586,282081,9495,3.4
12256,2016,March,Wilson                                               ,Not Adjusted,22756,23664,908,3.8
12257,2016,June,Wilson                                               ,Not Adjusted,22804,23830,1026,4.3
12258,2016,September,Wilson                                               ,Not Adjusted,22923,23909,986,4.1
12259,2016,December,Wilson                                               ,Not Adjusted,23013,23916,903,3.8
12260,2016,March,Winkler                                              ,Not Adjusted,2884,3114,230,7.4
12261,2016,June,Winkler                                              ,Not Adjusted,2816,3089,273,8.8
12262,2016,September,Winkler                                              ,Not Adjusted,2744,2999,255,8.5
12263,2016,December,Winkler                                              ,Not Adjusted,2844,3075,231,7.5
12264,2016,March,Wise                                                 ,Not Adjusted,27956,29343,1387,4.7
12265,2016,June,Wise                                                 ,Not Adjusted,28057,29646,1589,5.4
12266,2016,September,Wise                                                 ,Not Adjusted,28118,29556,1438,4.9
12267,2016,December,Wise                                                 ,Not Adjusted,28259,29539,1280,4.3
12268,2016,March,Wood                                                 ,Not Adjusted,16466,17337,871,5.0
12269,2016,June,Wood                                                 ,Not Adjusted,16467,17435,968,5.6
12270,2016,September,Wood                                                 ,Not Adjusted,16315,17313,998,5.8
12271,2016,December,Wood                                                 ,Not Adjusted,16290,17194,904,5.3
12272,2016,March,Yoakum                                               ,Not Adjusted,3640,3836,196,5.1
12273,2016,June,Yoakum                                               ,Not Adjusted,3665,3867,202,5.2
12274,2016,September,Yoakum                                               ,Not Adjusted,3525,3692,167,4.5
12275,2016,December,Yoakum                                               ,Not Adjusted,3537,3697,160,4.3
12276,2016,March,Young                                                ,Not Adjusted,8024,8391,367,4.4
12277,2016,June,Young                                                ,Not Adjusted,8078,8460,382,4.5
12278,2016,September,Young                                                ,Not Adjusted,7873,8268,395,4.8
12279,2016,December,Young                                                ,Not Adjusted,7778,8139,361,4.4
12280,2016,March,Zapata                                               ,Not Adjusted,4855,5434,579,10.7
12281,2016,June,Zapata                                               ,Not Adjusted,4630,5276,646,12.2
12282,2016,September,Zapata                                               ,Not Adjusted,4363,4901,538,11.0
12283,2016,December,Zapata                                               ,Not Adjusted,4602,5096,494,9.7
12284,2016,March,Zavala                                               ,Not Adjusted,3540,4065,525,12.9
12285,2016,June,Zavala                                               ,Not Adjusted,3201,3817,616,16.1
12286,2016,September,Zavala                                               ,Not Adjusted,3166,3766,600,15.9
12287,2016,December,Zavala                                               ,Not Adjusted,3445,3928,483,12.3
12288,2017,March,Texas,Not Adjusted,12931121,13552874,621753,4.6
12289,2017,March,Texas,Adjusted,12895119,13521412,626293,4.6
12290,2017,June,Texas,Not Adjusted,12956787,13576606,619819,4.6
12291,2017,June,Texas,Adjusted,12983477,13567834,584357,4.3
12292,2017,September,Texas,Not Adjusted,13071825,13634311,562486,4.1
12293,2017,September,Texas,Adjusted,13046231,13607109,560878,4.1
12294,2017,December,Texas,Not Adjusted,13115554,13640393,524839,3.8
12295,2017,December,Texas,Adjusted,13109868,13665077,555209,4.1
12296,2017,March,Anderson                                             ,Not Adjusted,22139,23040,901,3.9
12297,2017,June,Anderson                                             ,Not Adjusted,22451,23387,936,4.0
12298,2017,September,Anderson                                             ,Not Adjusted,22563,23357,794,3.4
12299,2017,December,Anderson                                             ,Not Adjusted,22482,23180,698,3.0
12300,2017,March,Andrews                                              ,Not Adjusted,8614,8919,305,3.4
12301,2017,June,Andrews                                              ,Not Adjusted,8747,9043,296,3.3
12302,2017,September,Andrews                                              ,Not Adjusted,8912,9164,252,2.7
12303,2017,December,Andrews                                              ,Not Adjusted,8817,9038,221,2.4
12304,2017,March,Angelina                                             ,Not Adjusted,35031,37090,2059,5.6
12305,2017,June,Angelina                                             ,Not Adjusted,34860,36820,1960,5.3
12306,2017,September,Angelina                                             ,Not Adjusted,34793,36468,1675,4.6
12307,2017,December,Angelina                                             ,Not Adjusted,34492,36060,1568,4.3
12308,2017,March,Aransas                                              ,Not Adjusted,9778,10395,617,5.9
12309,2017,June,Aransas                                              ,Not Adjusted,9702,10261,559,5.4
12310,2017,September,Aransas                                              ,Not Adjusted,9501,10624,1123,10.6
12311,2017,December,Aransas                                              ,Not Adjusted,9637,10450,813,7.8
12312,2017,March,Archer                                               ,Not Adjusted,4038,4188,150,3.6
12313,2017,June,Archer                                               ,Not Adjusted,4013,4164,151,3.6
12314,2017,September,Archer                                               ,Not Adjusted,3972,4103,131,3.2
12315,2017,December,Archer                                               ,Not Adjusted,4022,4142,120,2.9
12316,2017,March,Armstrong                                            ,Not Adjusted,913,936,23,2.5
12317,2017,June,Armstrong                                            ,Not Adjusted,899,923,24,2.6
12318,2017,September,Armstrong                                            ,Not Adjusted,884,907,23,2.5
12319,2017,December,Armstrong                                            ,Not Adjusted,887,911,24,2.6
12320,2017,March,Atascosa                                             ,Not Adjusted,20052,21023,971,4.6
12321,2017,June,Atascosa                                             ,Not Adjusted,20072,21002,930,4.4
12322,2017,September,Atascosa                                             ,Not Adjusted,20180,21005,825,3.9
12323,2017,December,Atascosa                                             ,Not Adjusted,20154,20919,765,3.7
12324,2017,March,Austin                                               ,Not Adjusted,13239,13926,687,4.9
12325,2017,June,Austin                                               ,Not Adjusted,13224,13876,652,4.7
12326,2017,September,Austin                                               ,Not Adjusted,13175,13728,553,4.0
12327,2017,December,Austin                                               ,Not Adjusted,13283,13784,501,3.6
12328,2017,March,Bailey                                               ,Not Adjusted,2678,2810,132,4.7
12329,2017,June,Bailey                                               ,Not Adjusted,2638,2773,135,4.9
12330,2017,September,Bailey                                               ,Not Adjusted,2441,2539,98,3.9
12331,2017,December,Bailey                                               ,Not Adjusted,2488,2579,91,3.5
12332,2017,March,Bandera                                              ,Not Adjusted,9387,9746,359,3.7
12333,2017,June,Bandera                                              ,Not Adjusted,9405,9772,367,3.8
12334,2017,September,Bandera                                              ,Not Adjusted,9439,9791,352,3.6
12335,2017,December,Bandera                                              ,Not Adjusted,9454,9767,313,3.2
12336,2017,March,Bastrop                                              ,Not Adjusted,38514,40095,1581,3.9
12337,2017,June,Bastrop                                              ,Not Adjusted,38724,40316,1592,3.9
12338,2017,September,Bastrop                                              ,Not Adjusted,39044,40405,1361,3.4
12339,2017,December,Bastrop                                              ,Not Adjusted,39236,40507,1271,3.1
12340,2017,March,Baylor                                               ,Not Adjusted,1545,1604,59,3.7
12341,2017,June,Baylor                                               ,Not Adjusted,1581,1640,59,3.6
12342,2017,September,Baylor                                               ,Not Adjusted,1528,1576,48,3.0
12343,2017,December,Baylor                                               ,Not Adjusted,1549,1590,41,2.6
12344,2017,March,Bee                                                  ,Not Adjusted,9522,10219,697,6.8
12345,2017,June,Bee                                                  ,Not Adjusted,9339,9985,646,6.5
12346,2017,September,Bee                                                  ,Not Adjusted,9238,9837,599,6.1
12347,2017,December,Bee                                                  ,Not Adjusted,9302,9859,557,5.6
12348,2017,March,Bell                                                 ,Not Adjusted,135365,141772,6407,4.5
12349,2017,June,Bell                                                 ,Not Adjusted,135956,142314,6358,4.5
12350,2017,September,Bell                                                 ,Not Adjusted,136510,142274,5764,4.1
12351,2017,December,Bell                                                 ,Not Adjusted,136330,141755,5425,3.8
12352,2017,March,Bexar                                                ,Not Adjusted,886076,920376,34300,3.7
12353,2017,June,Bexar                                                ,Not Adjusted,889384,924706,35322,3.8
12354,2017,September,Bexar                                                ,Not Adjusted,902212,933206,30994,3.3
12355,2017,December,Bexar                                                ,Not Adjusted,897224,926476,29252,3.2
12356,2017,March,Blanco                                               ,Not Adjusted,6115,6304,189,3.0
12357,2017,June,Blanco                                               ,Not Adjusted,6104,6278,174,2.8
12358,2017,September,Blanco                                               ,Not Adjusted,6021,6182,161,2.6
12359,2017,December,Blanco                                               ,Not Adjusted,6063,6217,154,2.5
12360,2017,March,Borden                                               ,Not Adjusted,331,342,11,3.2
12361,2017,June,Borden                                               ,Not Adjusted,319,332,13,3.9
12362,2017,September,Borden                                               ,Not Adjusted,290,301,11,3.7
12363,2017,December,Borden                                               ,Not Adjusted,308,320,12,3.8
12364,2017,March,Bosque                                               ,Not Adjusted,7935,8289,354,4.3
12365,2017,June,Bosque                                               ,Not Adjusted,7906,8253,347,4.2
12366,2017,September,Bosque                                               ,Not Adjusted,7881,8182,301,3.7
12367,2017,December,Bosque                                               ,Not Adjusted,7869,8166,297,3.6
12368,2017,March,Bowie                                                ,Not Adjusted,37760,39638,1878,4.7
12369,2017,June,Bowie                                                ,Not Adjusted,37451,39382,1931,4.9
12370,2017,September,Bowie                                                ,Not Adjusted,37706,39365,1659,4.2
12371,2017,December,Bowie                                                ,Not Adjusted,37494,39107,1613,4.1
12372,2017,March,Brazoria                                             ,Not Adjusted,163581,172931,9350,5.4
12373,2017,June,Brazoria                                             ,Not Adjusted,163817,173606,9789,5.6
12374,2017,September,Brazoria                                             ,Not Adjusted,164713,174194,9481,5.4
12375,2017,December,Brazoria                                             ,Not Adjusted,165331,173748,8417,4.8
12376,2017,March,Brazos                                               ,Not Adjusted,111013,114601,3588,3.1
12377,2017,June,Brazos                                               ,Not Adjusted,104723,108657,3934,3.6
12378,2017,September,Brazos                                               ,Not Adjusted,111447,114728,3281,2.9
12379,2017,December,Brazos                                               ,Not Adjusted,112062,115131,3069,2.7
12380,2017,March,Brewster                                             ,Not Adjusted,3879,4030,151,3.7
12381,2017,June,Brewster                                             ,Not Adjusted,3825,3969,144,3.6
12382,2017,September,Brewster                                             ,Not Adjusted,3753,3874,121,3.1
12383,2017,December,Brewster                                             ,Not Adjusted,3882,4009,127,3.2
12384,2017,March,Briscoe                                              ,Not Adjusted,557,584,27,4.6
12385,2017,June,Briscoe                                              ,Not Adjusted,563,589,26,4.4
12386,2017,September,Briscoe                                              ,Not Adjusted,518,541,23,4.3
12387,2017,December,Briscoe                                              ,Not Adjusted,527,546,19,3.5
12388,2017,March,Brooks                                               ,Not Adjusted,2257,2492,235,9.4
12389,2017,June,Brooks                                               ,Not Adjusted,2226,2448,222,9.1
12390,2017,September,Brooks                                               ,Not Adjusted,2231,2403,172,7.2
12391,2017,December,Brooks                                               ,Not Adjusted,2240,2395,155,6.5
12392,2017,March,Brown                                                ,Not Adjusted,15726,16392,666,4.1
12393,2017,June,Brown                                                ,Not Adjusted,15519,16211,692,4.3
12394,2017,September,Brown                                                ,Not Adjusted,15563,16149,586,3.6
12395,2017,December,Brown                                                ,Not Adjusted,15353,15906,553,3.5
12396,2017,March,Burleson                                             ,Not Adjusted,7793,8147,354,4.3
12397,2017,June,Burleson                                             ,Not Adjusted,7364,7721,357,4.6
12398,2017,September,Burleson                                             ,Not Adjusted,7745,8071,326,4.0
12399,2017,December,Burleson                                             ,Not Adjusted,7820,8130,310,3.8
12400,2017,March,Burnet                                               ,Not Adjusted,21313,22060,747,3.4
12401,2017,June,Burnet                                               ,Not Adjusted,21862,22602,740,3.3
12402,2017,September,Burnet                                               ,Not Adjusted,21539,22217,678,3.1
12403,2017,December,Burnet                                               ,Not Adjusted,21810,22425,615,2.7
12404,2017,March,Caldwell                                             ,Not Adjusted,17663,18465,802,4.3
12405,2017,June,Caldwell                                             ,Not Adjusted,17764,18566,802,4.3
12406,2017,September,Caldwell                                             ,Not Adjusted,17925,18592,667,3.6
12407,2017,December,Caldwell                                             ,Not Adjusted,18007,18639,632,3.4
12408,2017,March,Calhoun                                              ,Not Adjusted,9863,10497,634,6.0
12409,2017,June,Calhoun                                              ,Not Adjusted,9931,10532,601,5.7
12410,2017,September,Calhoun                                              ,Not Adjusted,9881,10541,660,6.3
12411,2017,December,Calhoun                                              ,Not Adjusted,9903,10466,563,5.4
12412,2017,March,Callahan                                             ,Not Adjusted,5703,5929,226,3.8
12413,2017,June,Callahan                                             ,Not Adjusted,5676,5896,220,3.7
12414,2017,September,Callahan                                             ,Not Adjusted,5735,5938,203,3.4
12415,2017,December,Callahan                                             ,Not Adjusted,5754,5946,192,3.2
12416,2017,March,Cameron                                              ,Not Adjusted,155678,167784,12106,7.2
12417,2017,June,Cameron                                              ,Not Adjusted,154910,167660,12750,7.6
12418,2017,September,Cameron                                              ,Not Adjusted,154033,164814,10781,6.5
12419,2017,December,Cameron                                              ,Not Adjusted,154999,165159,10160,6.2
12420,2017,March,Camp                                                 ,Not Adjusted,4811,5129,318,6.2
12421,2017,June,Camp                                                 ,Not Adjusted,4753,5057,304,6.0
12422,2017,September,Camp                                                 ,Not Adjusted,4786,5031,245,4.9
12423,2017,December,Camp                                                 ,Not Adjusted,4717,4954,237,4.8
12424,2017,March,Carson                                               ,Not Adjusted,2987,3096,109,3.5
12425,2017,June,Carson                                               ,Not Adjusted,2947,3054,107,3.5
12426,2017,September,Carson                                               ,Not Adjusted,2903,2990,87,2.9
12427,2017,December,Carson                                               ,Not Adjusted,2915,2997,82,2.7
12428,2017,March,Cass                                                 ,Not Adjusted,11661,12488,827,6.6
12429,2017,June,Cass                                                 ,Not Adjusted,11520,12253,733,6.0
12430,2017,September,Cass                                                 ,Not Adjusted,11448,12065,617,5.1
12431,2017,December,Cass                                                 ,Not Adjusted,11438,12072,634,5.3
12432,2017,March,Castro                                               ,Not Adjusted,3438,3560,122,3.4
12433,2017,June,Castro                                               ,Not Adjusted,3335,3460,125,3.6
12434,2017,September,Castro                                               ,Not Adjusted,3206,3310,104,3.1
12435,2017,December,Castro                                               ,Not Adjusted,3239,3335,96,2.9
12436,2017,March,Chambers                                             ,Not Adjusted,17626,18899,1273,6.7
12437,2017,June,Chambers                                             ,Not Adjusted,17659,18928,1269,6.7
12438,2017,September,Chambers                                             ,Not Adjusted,17763,19005,1242,6.5
12439,2017,December,Chambers                                             ,Not Adjusted,17838,18998,1160,6.1
12440,2017,March,Cherokee                                             ,Not Adjusted,20256,21256,1000,4.7
12441,2017,June,Cherokee                                             ,Not Adjusted,19703,20687,984,4.8
12442,2017,September,Cherokee                                             ,Not Adjusted,19579,20448,869,4.2
12443,2017,December,Cherokee                                             ,Not Adjusted,19930,20780,850,4.1
12444,2017,March,Childress                                            ,Not Adjusted,2831,2917,86,2.9
12445,2017,June,Childress                                            ,Not Adjusted,2861,2953,92,3.1
12446,2017,September,Childress                                            ,Not Adjusted,2814,2899,85,2.9
12447,2017,December,Childress                                            ,Not Adjusted,2747,2825,78,2.8
12448,2017,March,Clay                                                 ,Not Adjusted,4787,4981,194,3.9
12449,2017,June,Clay                                                 ,Not Adjusted,4749,4926,177,3.6
12450,2017,September,Clay                                                 ,Not Adjusted,4688,4841,153,3.2
12451,2017,December,Clay                                                 ,Not Adjusted,4745,4895,150,3.1
12452,2017,March,Cochran                                              ,Not Adjusted,1153,1211,58,4.8
12453,2017,June,Cochran                                              ,Not Adjusted,1125,1174,49,4.2
12454,2017,September,Cochran                                              ,Not Adjusted,1016,1068,52,4.9
12455,2017,December,Cochran                                              ,Not Adjusted,1048,1093,45,4.1
12456,2017,March,Coke                                                 ,Not Adjusted,1337,1394,57,4.1
12457,2017,June,Coke                                                 ,Not Adjusted,1380,1433,53,3.7
12458,2017,September,Coke                                                 ,Not Adjusted,1363,1412,49,3.5
12459,2017,December,Coke                                                 ,Not Adjusted,1369,1413,44,3.1
12460,2017,March,Coleman                                              ,Not Adjusted,2961,3111,150,4.8
12461,2017,June,Coleman                                              ,Not Adjusted,2966,3111,145,4.7
12462,2017,September,Coleman                                              ,Not Adjusted,2923,3045,122,4.0
12463,2017,December,Coleman                                              ,Not Adjusted,2899,3018,119,3.9
12464,2017,March,Collin                                               ,Not Adjusted,508462,527658,19196,3.6
12465,2017,June,Collin                                               ,Not Adjusted,511416,531210,19794,3.7
12466,2017,September,Collin                                               ,Not Adjusted,519051,536583,17532,3.3
12467,2017,December,Collin                                               ,Not Adjusted,519948,536786,16838,3.1
12468,2017,March,Collingsworth                                        ,Not Adjusted,1153,1193,40,3.4
12469,2017,June,Collingsworth                                        ,Not Adjusted,1139,1182,43,3.6
12470,2017,September,Collingsworth                                        ,Not Adjusted,1097,1140,43,3.8
12471,2017,December,Collingsworth                                        ,Not Adjusted,1123,1162,39,3.4
12472,2017,March,Colorado                                             ,Not Adjusted,9393,9826,433,4.4
12473,2017,June,Colorado                                             ,Not Adjusted,9560,9957,397,4.0
12474,2017,September,Colorado                                             ,Not Adjusted,9390,9746,356,3.7
12475,2017,December,Colorado                                             ,Not Adjusted,9250,9594,344,3.6
12476,2017,March,Comal                                                ,Not Adjusted,66122,68649,2527,3.7
12477,2017,June,Comal                                                ,Not Adjusted,66401,68841,2440,3.5
12478,2017,September,Comal                                                ,Not Adjusted,67137,69296,2159,3.1
12479,2017,December,Comal                                                ,Not Adjusted,67020,69117,2097,3.0
12480,2017,March,Comanche                                             ,Not Adjusted,5211,5427,216,4.0
12481,2017,June,Comanche                                             ,Not Adjusted,5170,5368,198,3.7
12482,2017,September,Comanche                                             ,Not Adjusted,5045,5231,186,3.6
12483,2017,December,Comanche                                             ,Not Adjusted,5082,5250,168,3.2
12484,2017,March,Concho                                               ,Not Adjusted,1356,1393,37,2.7
12485,2017,June,Concho                                               ,Not Adjusted,1139,1209,70,5.8
12486,2017,September,Concho                                               ,Not Adjusted,1040,1094,54,4.9
12487,2017,December,Concho                                               ,Not Adjusted,1052,1097,45,4.1
12488,2017,March,Cooke                                                ,Not Adjusted,18339,19030,691,3.6
12489,2017,June,Cooke                                                ,Not Adjusted,18291,19031,740,3.9
12490,2017,September,Cooke                                                ,Not Adjusted,18170,18779,609,3.2
12491,2017,December,Cooke                                                ,Not Adjusted,18154,18782,628,3.3
12492,2017,March,Coryell                                              ,Not Adjusted,23227,24379,1152,4.7
12493,2017,June,Coryell                                              ,Not Adjusted,23321,24418,1097,4.5
12494,2017,September,Coryell                                              ,Not Adjusted,23396,24414,1018,4.2
12495,2017,December,Coryell                                              ,Not Adjusted,23374,24327,953,3.9
12496,2017,March,Cottle                                               ,Not Adjusted,506,531,25,4.7
12497,2017,June,Cottle                                               ,Not Adjusted,507,529,22,4.2
12498,2017,September,Cottle                                               ,Not Adjusted,483,505,22,4.4
12499,2017,December,Cottle                                               ,Not Adjusted,490,511,21,4.1
12500,2017,March,Crane                                                ,Not Adjusted,1518,1616,98,6.1
12501,2017,June,Crane                                                ,Not Adjusted,1550,1634,84,5.1
12502,2017,September,Crane                                                ,Not Adjusted,1474,1547,73,4.7
12503,2017,December,Crane                                                ,Not Adjusted,1517,1584,67,4.2
12504,2017,March,Crockett                                             ,Not Adjusted,1611,1689,78,4.6
12505,2017,June,Crockett                                             ,Not Adjusted,1650,1720,70,4.1
12506,2017,September,Crockett                                             ,Not Adjusted,1636,1698,62,3.7
12507,2017,December,Crockett                                             ,Not Adjusted,1552,1604,52,3.2
12508,2017,March,Crosby                                               ,Not Adjusted,2527,2651,124,4.7
12509,2017,June,Crosby                                               ,Not Adjusted,2469,2597,128,4.9
12510,2017,September,Crosby                                               ,Not Adjusted,2387,2478,91,3.7
12511,2017,December,Crosby                                               ,Not Adjusted,2407,2495,88,3.5
12512,2017,March,Culberson                                            ,Not Adjusted,890,932,42,4.5
12513,2017,June,Culberson                                            ,Not Adjusted,890,925,35,3.8
12514,2017,September,Culberson                                            ,Not Adjusted,876,905,29,3.2
12515,2017,December,Culberson                                            ,Not Adjusted,902,929,27,2.9
12516,2017,March,Dallam                                               ,Not Adjusted,4026,4112,86,2.1
12517,2017,June,Dallam                                               ,Not Adjusted,4066,4162,96,2.3
12518,2017,September,Dallam                                               ,Not Adjusted,3934,4016,82,2.0
12519,2017,December,Dallam                                               ,Not Adjusted,3890,3966,76,1.9
12520,2017,March,Dallas                                               ,Not Adjusted,1261601,1316558,54957,4.2
12521,2017,June,Dallas                                               ,Not Adjusted,1269309,1324423,55114,4.2
12522,2017,September,Dallas                                               ,Not Adjusted,1287739,1337451,49712,3.7
12523,2017,December,Dallas                                               ,Not Adjusted,1290992,1338339,47347,3.5
12524,2017,March,Dawson                                               ,Not Adjusted,4520,4760,240,5.0
12525,2017,June,Dawson                                               ,Not Adjusted,4471,4726,255,5.4
12526,2017,September,Dawson                                               ,Not Adjusted,4283,4484,201,4.5
12527,2017,December,Dawson                                               ,Not Adjusted,4364,4548,184,4.0
12528,2017,March,Deaf Smith                                           ,Not Adjusted,8341,8621,280,3.2
12529,2017,June,Deaf Smith                                           ,Not Adjusted,8249,8533,284,3.3
12530,2017,September,Deaf Smith                                           ,Not Adjusted,7910,8135,225,2.8
12531,2017,December,Deaf Smith                                           ,Not Adjusted,7955,8188,233,2.8
12532,2017,March,Delta                                                ,Not Adjusted,2538,2629,91,3.5
12533,2017,June,Delta                                                ,Not Adjusted,2476,2569,93,3.6
12534,2017,September,Delta                                                ,Not Adjusted,2385,2465,80,3.2
12535,2017,December,Delta                                                ,Not Adjusted,2396,2476,80,3.2
12536,2017,March,Denton                                               ,Not Adjusted,450739,467630,16891,3.6
12537,2017,June,Denton                                               ,Not Adjusted,453280,470253,16973,3.6
12538,2017,September,Denton                                               ,Not Adjusted,460301,475192,14891,3.1
12539,2017,December,Denton                                               ,Not Adjusted,460751,474898,14147,3.0
12540,2017,March,DeWitt                                               ,Not Adjusted,9075,9563,488,5.1
12541,2017,June,DeWitt                                               ,Not Adjusted,9203,9628,425,4.4
12542,2017,September,DeWitt                                               ,Not Adjusted,9282,9652,370,3.8
12543,2017,December,DeWitt                                               ,Not Adjusted,9289,9626,337,3.5
12544,2017,March,Dickens                                              ,Not Adjusted,662,697,35,5.0
12545,2017,June,Dickens                                              ,Not Adjusted,668,701,33,4.7
12546,2017,September,Dickens                                              ,Not Adjusted,633,663,30,4.5
12547,2017,December,Dickens                                              ,Not Adjusted,633,660,27,4.1
12548,2017,March,Dimmit                                               ,Not Adjusted,5948,6328,380,6.0
12549,2017,June,Dimmit                                               ,Not Adjusted,5759,6112,353,5.8
12550,2017,September,Dimmit                                               ,Not Adjusted,6513,6802,289,4.2
12551,2017,December,Dimmit                                               ,Not Adjusted,6628,6882,254,3.7
12552,2017,March,Donley                                               ,Not Adjusted,1496,1554,58,3.7
12553,2017,June,Donley                                               ,Not Adjusted,1498,1564,66,4.2
12554,2017,September,Donley                                               ,Not Adjusted,1404,1449,45,3.1
12555,2017,December,Donley                                               ,Not Adjusted,1442,1491,49,3.3
12556,2017,March,Duval                                                ,Not Adjusted,4440,4881,441,9.0
12557,2017,June,Duval                                                ,Not Adjusted,4465,4844,379,7.8
12558,2017,September,Duval                                                ,Not Adjusted,4493,4813,320,6.6
12559,2017,December,Duval                                                ,Not Adjusted,4447,4717,270,5.7
12560,2017,March,Eastland                                             ,Not Adjusted,7594,7962,368,4.6
12561,2017,June,Eastland                                             ,Not Adjusted,7479,7847,368,4.7
12562,2017,September,Eastland                                             ,Not Adjusted,7681,7990,309,3.9
12563,2017,December,Eastland                                             ,Not Adjusted,8109,8384,275,3.3
12564,2017,March,Ector                                                ,Not Adjusted,72830,76618,3788,4.9
12565,2017,June,Ector                                                ,Not Adjusted,74331,77639,3308,4.3
12566,2017,September,Ector                                                ,Not Adjusted,77635,80406,2771,3.4
12567,2017,December,Ector                                                ,Not Adjusted,78712,81189,2477,3.1
12568,2017,March,Edwards                                              ,Not Adjusted,872,906,34,3.8
12569,2017,June,Edwards                                              ,Not Adjusted,889,918,29,3.2
12570,2017,September,Edwards                                              ,Not Adjusted,876,899,23,2.6
12571,2017,December,Edwards                                              ,Not Adjusted,853,877,24,2.7
12572,2017,March,Ellis                                                ,Not Adjusted,83961,87259,3298,3.8
12573,2017,June,Ellis                                                ,Not Adjusted,84426,87746,3320,3.8
12574,2017,September,Ellis                                                ,Not Adjusted,85538,88401,2863,3.2
12575,2017,December,Ellis                                                ,Not Adjusted,85784,88523,2739,3.1
12576,2017,March,El Paso                                              ,Not Adjusted,337066,354340,17274,4.9
12577,2017,June,El Paso                                              ,Not Adjusted,333815,351252,17437,5.0
12578,2017,September,El Paso                                              ,Not Adjusted,340579,356039,15460,4.3
12579,2017,December,El Paso                                              ,Not Adjusted,341274,356209,14935,4.2
12580,2017,March,Erath                                                ,Not Adjusted,20549,21286,737,3.5
12581,2017,June,Erath                                                ,Not Adjusted,20271,21088,817,3.9
12582,2017,September,Erath                                                ,Not Adjusted,19695,20348,653,3.2
12583,2017,December,Erath                                                ,Not Adjusted,20270,20877,607,2.9
12584,2017,March,Falls                                                ,Not Adjusted,6451,6749,298,4.4
12585,2017,June,Falls                                                ,Not Adjusted,6371,6679,308,4.6
12586,2017,September,Falls                                                ,Not Adjusted,6365,6629,264,4.0
12587,2017,December,Falls                                                ,Not Adjusted,6315,6568,253,3.9
12588,2017,March,Fannin                                               ,Not Adjusted,15421,16004,583,3.6
12589,2017,June,Fannin                                               ,Not Adjusted,15377,15935,558,3.5
12590,2017,September,Fannin                                               ,Not Adjusted,15537,16022,485,3.0
12591,2017,December,Fannin                                               ,Not Adjusted,15390,15859,469,3.0
12592,2017,March,Fayette                                              ,Not Adjusted,12265,12692,427,3.4
12593,2017,June,Fayette                                              ,Not Adjusted,12427,12823,396,3.1
12594,2017,September,Fayette                                              ,Not Adjusted,12206,12585,379,3.0
12595,2017,December,Fayette                                              ,Not Adjusted,11843,12219,376,3.1
12596,2017,March,Fisher                                               ,Not Adjusted,1680,1745,65,3.7
12597,2017,June,Fisher                                               ,Not Adjusted,1661,1724,63,3.7
12598,2017,September,Fisher                                               ,Not Adjusted,1612,1670,58,3.5
12599,2017,December,Fisher                                               ,Not Adjusted,1611,1660,49,3.0
12600,2017,March,Floyd                                                ,Not Adjusted,2638,2799,161,5.8
12601,2017,June,Floyd                                                ,Not Adjusted,2610,2766,156,5.6
12602,2017,September,Floyd                                                ,Not Adjusted,2470,2599,129,5.0
12603,2017,December,Floyd                                                ,Not Adjusted,2499,2631,132,5.0
12604,2017,March,Foard                                                ,Not Adjusted,568,591,23,3.9
12605,2017,June,Foard                                                ,Not Adjusted,581,601,20,3.3
12606,2017,September,Foard                                                ,Not Adjusted,594,612,18,2.9
12607,2017,December,Foard                                                ,Not Adjusted,569,584,15,2.6
12608,2017,March,Fort Bend                                            ,Not Adjusted,356898,375476,18578,4.9
12609,2017,June,Fort Bend                                            ,Not Adjusted,357632,375868,18236,4.9
12610,2017,September,Fort Bend                                            ,Not Adjusted,359467,376454,16987,4.5
12611,2017,December,Fort Bend                                            ,Not Adjusted,361258,376691,15433,4.1
12612,2017,March,Franklin                                             ,Not Adjusted,4427,4653,226,4.9
12613,2017,June,Franklin                                             ,Not Adjusted,4366,4586,220,4.8
12614,2017,September,Franklin                                             ,Not Adjusted,4294,4488,194,4.3
12615,2017,December,Franklin                                             ,Not Adjusted,4279,4465,186,4.2
12616,2017,March,Freestone                                            ,Not Adjusted,6449,6944,495,7.1
12617,2017,June,Freestone                                            ,Not Adjusted,6385,6842,457,6.7
12618,2017,September,Freestone                                            ,Not Adjusted,6264,6647,383,5.8
12619,2017,December,Freestone                                            ,Not Adjusted,6222,6574,352,5.4
12620,2017,March,Frio                                                 ,Not Adjusted,9107,9520,413,4.3
12621,2017,June,Frio                                                 ,Not Adjusted,9048,9457,409,4.3
12622,2017,September,Frio                                                 ,Not Adjusted,9058,9367,309,3.3
12623,2017,December,Frio                                                 ,Not Adjusted,8980,9281,301,3.2
12624,2017,March,Gaines                                               ,Not Adjusted,9062,9370,308,3.3
12625,2017,June,Gaines                                               ,Not Adjusted,9095,9398,303,3.2
12626,2017,September,Gaines                                               ,Not Adjusted,8928,9178,250,2.7
12627,2017,December,Gaines                                               ,Not Adjusted,8943,9178,235,2.6
12628,2017,March,Galveston                                            ,Not Adjusted,153030,161782,8752,5.4
12629,2017,June,Galveston                                            ,Not Adjusted,153280,162200,8920,5.5
12630,2017,September,Galveston                                            ,Not Adjusted,153935,162631,8696,5.3
12631,2017,December,Galveston                                            ,Not Adjusted,154722,162605,7883,4.8
12632,2017,March,Garza                                                ,Not Adjusted,2076,2155,79,3.7
12633,2017,June,Garza                                                ,Not Adjusted,2028,2102,74,3.5
12634,2017,September,Garza                                                ,Not Adjusted,2054,2116,62,2.9
12635,2017,December,Garza                                                ,Not Adjusted,2057,2116,59,2.8
12636,2017,March,Gillespie                                            ,Not Adjusted,12800,13165,365,2.8
12637,2017,June,Gillespie                                            ,Not Adjusted,12975,13325,350,2.6
12638,2017,September,Gillespie                                            ,Not Adjusted,12720,13046,326,2.5
12639,2017,December,Gillespie                                            ,Not Adjusted,13020,13321,301,2.3
12640,2017,March,Glasscock                                            ,Not Adjusted,715,735,20,2.7
12641,2017,June,Glasscock                                            ,Not Adjusted,700,721,21,2.9
12642,2017,September,Glasscock                                            ,Not Adjusted,666,682,16,2.3
12643,2017,December,Glasscock                                            ,Not Adjusted,715,731,16,2.2
12644,2017,March,Goliad                                               ,Not Adjusted,3144,3331,187,5.6
12645,2017,June,Goliad                                               ,Not Adjusted,3129,3287,158,4.8
12646,2017,September,Goliad                                               ,Not Adjusted,3087,3235,148,4.6
12647,2017,December,Goliad                                               ,Not Adjusted,3120,3246,126,3.9
12648,2017,March,Gonzales                                             ,Not Adjusted,9379,9738,359,3.7
12649,2017,June,Gonzales                                             ,Not Adjusted,9105,9452,347,3.7
12650,2017,September,Gonzales                                             ,Not Adjusted,8865,9169,304,3.3
12651,2017,December,Gonzales                                             ,Not Adjusted,8959,9234,275,3.0
12652,2017,March,Gray                                                 ,Not Adjusted,7867,8368,501,6.0
12653,2017,June,Gray                                                 ,Not Adjusted,7902,8351,449,5.4
12654,2017,September,Gray                                                 ,Not Adjusted,7768,8143,375,4.6
12655,2017,December,Gray                                                 ,Not Adjusted,7769,8121,352,4.3
12656,2017,March,Grayson                                              ,Not Adjusted,59727,62096,2369,3.8
12657,2017,June,Grayson                                              ,Not Adjusted,59546,61884,2338,3.8
12658,2017,September,Grayson                                              ,Not Adjusted,59980,62043,2063,3.3
12659,2017,December,Grayson                                              ,Not Adjusted,60011,61950,1939,3.1
12660,2017,March,Gregg                                                ,Not Adjusted,54430,57750,3320,5.7
12661,2017,June,Gregg                                                ,Not Adjusted,54339,57465,3126,5.4
12662,2017,September,Gregg                                                ,Not Adjusted,54831,57456,2625,4.6
12663,2017,December,Gregg                                                ,Not Adjusted,54726,57148,2422,4.2
12664,2017,March,Grimes                                               ,Not Adjusted,10355,11014,659,6.0
12665,2017,June,Grimes                                               ,Not Adjusted,10182,10802,620,5.7
12666,2017,September,Grimes                                               ,Not Adjusted,10366,10876,510,4.7
12667,2017,December,Grimes                                               ,Not Adjusted,10346,10823,477,4.4
12668,2017,March,Guadalupe                                            ,Not Adjusted,75434,78208,2774,3.5
12669,2017,June,Guadalupe                                            ,Not Adjusted,75656,78428,2772,3.5
12670,2017,September,Guadalupe                                            ,Not Adjusted,76726,79234,2508,3.2
12671,2017,December,Guadalupe                                            ,Not Adjusted,76228,78584,2356,3.0
12672,2017,March,Hale                                                 ,Not Adjusted,12083,12820,737,5.7
12673,2017,June,Hale                                                 ,Not Adjusted,11701,12476,775,6.2
12674,2017,September,Hale                                                 ,Not Adjusted,11784,12357,573,4.6
12675,2017,December,Hale                                                 ,Not Adjusted,11980,12492,512,4.1
12676,2017,March,Hall                                                 ,Not Adjusted,1083,1164,81,7.0
12677,2017,June,Hall                                                 ,Not Adjusted,1085,1155,70,6.1
12678,2017,September,Hall                                                 ,Not Adjusted,1043,1105,62,5.6
12679,2017,December,Hall                                                 ,Not Adjusted,1053,1106,53,4.8
12680,2017,March,Hamilton                                             ,Not Adjusted,3528,3682,154,4.2
12681,2017,June,Hamilton                                             ,Not Adjusted,3510,3665,155,4.2
12682,2017,September,Hamilton                                             ,Not Adjusted,3434,3563,129,3.6
12683,2017,December,Hamilton                                             ,Not Adjusted,3449,3576,127,3.6
12684,2017,March,Hansford                                             ,Not Adjusted,2817,2898,81,2.8
12685,2017,June,Hansford                                             ,Not Adjusted,2829,2903,74,2.5
12686,2017,September,Hansford                                             ,Not Adjusted,2757,2819,62,2.2
12687,2017,December,Hansford                                             ,Not Adjusted,2787,2852,65,2.3
12688,2017,March,Hardeman                                             ,Not Adjusted,1617,1686,69,4.1
12689,2017,June,Hardeman                                             ,Not Adjusted,1610,1677,67,4.0
12690,2017,September,Hardeman                                             ,Not Adjusted,1586,1653,67,4.1
12691,2017,December,Hardeman                                             ,Not Adjusted,1551,1614,63,3.9
12692,2017,March,Hardin                                               ,Not Adjusted,23993,25581,1588,6.2
12693,2017,June,Hardin                                               ,Not Adjusted,23780,25346,1566,6.2
12694,2017,September,Hardin                                               ,Not Adjusted,23491,25177,1686,6.7
12695,2017,December,Hardin                                               ,Not Adjusted,23603,25069,1466,5.8
12696,2017,March,Harris                                               ,Not Adjusted,2143152,2263728,120576,5.3
12697,2017,June,Harris                                               ,Not Adjusted,2148188,2267297,119109,5.3
12698,2017,September,Harris                                               ,Not Adjusted,2157703,2271916,114213,5.0
12699,2017,December,Harris                                               ,Not Adjusted,2170750,2274452,103702,4.6
12700,2017,March,Harrison                                             ,Not Adjusted,27862,29570,1708,5.8
12701,2017,June,Harrison                                             ,Not Adjusted,27956,29579,1623,5.5
12702,2017,September,Harrison                                             ,Not Adjusted,28046,29437,1391,4.7
12703,2017,December,Harrison                                             ,Not Adjusted,28012,29326,1314,4.5
12704,2017,March,Hartley                                              ,Not Adjusted,2944,3005,61,2.0
12705,2017,June,Hartley                                              ,Not Adjusted,2949,3009,60,2.0
12706,2017,September,Hartley                                              ,Not Adjusted,2847,2901,54,1.9
12707,2017,December,Hartley                                              ,Not Adjusted,2844,2896,52,1.8
12708,2017,March,Haskell                                              ,Not Adjusted,2442,2557,115,4.5
12709,2017,June,Haskell                                              ,Not Adjusted,2330,2458,128,5.2
12710,2017,September,Haskell                                              ,Not Adjusted,2270,2383,113,4.7
12711,2017,December,Haskell                                              ,Not Adjusted,2275,2373,98,4.1
12712,2017,March,Hays                                                 ,Not Adjusted,106283,109900,3617,3.3
12713,2017,June,Hays                                                 ,Not Adjusted,106994,110770,3776,3.4
12714,2017,September,Hays                                                 ,Not Adjusted,108265,111606,3341,3.0
12715,2017,December,Hays                                                 ,Not Adjusted,108647,111843,3196,2.9
12716,2017,March,Hemphill                                             ,Not Adjusted,2263,2325,62,2.7
12717,2017,June,Hemphill                                             ,Not Adjusted,2234,2300,66,2.9
12718,2017,September,Hemphill                                             ,Not Adjusted,2340,2395,55,2.3
12719,2017,December,Hemphill                                             ,Not Adjusted,2262,2306,44,1.9
12720,2017,March,Henderson                                            ,Not Adjusted,34026,35641,1615,4.5
12721,2017,June,Henderson                                            ,Not Adjusted,34239,35831,1592,4.4
12722,2017,September,Henderson                                            ,Not Adjusted,34277,35678,1401,3.9
12723,2017,December,Henderson                                            ,Not Adjusted,34410,35716,1306,3.7
12724,2017,March,Hidalgo                                              ,Not Adjusted,317859,344794,26935,7.8
12725,2017,June,Hidalgo                                              ,Not Adjusted,316905,344754,27849,8.1
12726,2017,September,Hidalgo                                              ,Not Adjusted,316515,340109,23594,6.9
12727,2017,December,Hidalgo                                              ,Not Adjusted,324169,348100,23931,6.9
12728,2017,March,Hill                                                 ,Not Adjusted,15486,16186,700,4.3
12729,2017,June,Hill                                                 ,Not Adjusted,15399,16091,692,4.3
12730,2017,September,Hill                                                 ,Not Adjusted,15805,16393,588,3.6
12731,2017,December,Hill                                                 ,Not Adjusted,15594,16163,569,3.5
12732,2017,March,Hockley                                              ,Not Adjusted,10868,11316,448,4.0
12733,2017,June,Hockley                                              ,Not Adjusted,10863,11330,467,4.1
12734,2017,September,Hockley                                              ,Not Adjusted,10870,11269,399,3.5
12735,2017,December,Hockley                                              ,Not Adjusted,10956,11305,349,3.1
12736,2017,March,Hood                                                 ,Not Adjusted,24671,25823,1152,4.5
12737,2017,June,Hood                                                 ,Not Adjusted,24790,25936,1146,4.4
12738,2017,September,Hood                                                 ,Not Adjusted,25033,26060,1027,3.9
12739,2017,December,Hood                                                 ,Not Adjusted,25189,26149,960,3.7
12740,2017,March,Hopkins                                              ,Not Adjusted,16843,17523,680,3.9
12741,2017,June,Hopkins                                              ,Not Adjusted,16467,17121,654,3.8
12742,2017,September,Hopkins                                              ,Not Adjusted,16537,17099,562,3.3
12743,2017,December,Hopkins                                              ,Not Adjusted,16550,17095,545,3.2
12744,2017,March,Houston                                              ,Not Adjusted,9995,10428,433,4.2
12745,2017,June,Houston                                              ,Not Adjusted,10217,10666,449,4.2
12746,2017,September,Houston                                              ,Not Adjusted,10110,10555,445,4.2
12747,2017,December,Houston                                              ,Not Adjusted,9728,10150,422,4.2
12748,2017,March,Howard                                               ,Not Adjusted,12644,13276,632,4.8
12749,2017,June,Howard                                               ,Not Adjusted,12582,13176,594,4.5
12750,2017,September,Howard                                               ,Not Adjusted,12688,13191,503,3.8
12751,2017,December,Howard                                               ,Not Adjusted,12891,13331,440,3.3
12752,2017,March,Hudspeth                                             ,Not Adjusted,1614,1717,103,6.0
12753,2017,June,Hudspeth                                             ,Not Adjusted,1574,1677,103,6.1
12754,2017,September,Hudspeth                                             ,Not Adjusted,1548,1635,87,5.3
12755,2017,December,Hudspeth                                             ,Not Adjusted,1561,1640,79,4.8
12756,2017,March,Hunt                                                 ,Not Adjusted,39399,41209,1810,4.4
12757,2017,June,Hunt                                                 ,Not Adjusted,39602,41384,1782,4.3
12758,2017,September,Hunt                                                 ,Not Adjusted,40064,41631,1567,3.8
12759,2017,December,Hunt                                                 ,Not Adjusted,40210,41692,1482,3.6
12760,2017,March,Hutchinson                                           ,Not Adjusted,9133,9718,585,6.0
12761,2017,June,Hutchinson                                           ,Not Adjusted,8924,9570,646,6.8
12762,2017,September,Hutchinson                                           ,Not Adjusted,8575,9086,511,5.6
12763,2017,December,Hutchinson                                           ,Not Adjusted,8530,9019,489,5.4
12764,2017,March,Irion                                                ,Not Adjusted,746,771,25,3.2
12765,2017,June,Irion                                                ,Not Adjusted,741,765,24,3.1
12766,2017,September,Irion                                                ,Not Adjusted,724,743,19,2.6
12767,2017,December,Irion                                                ,Not Adjusted,737,760,23,3.0
12768,2017,March,Jack                                                 ,Not Adjusted,3723,3898,175,4.5
12769,2017,June,Jack                                                 ,Not Adjusted,3823,3979,156,3.9
12770,2017,September,Jack                                                 ,Not Adjusted,3823,3956,133,3.4
12771,2017,December,Jack                                                 ,Not Adjusted,3956,4068,112,2.8
12772,2017,March,Jackson                                              ,Not Adjusted,7124,7442,318,4.3
12773,2017,June,Jackson                                              ,Not Adjusted,7087,7415,328,4.4
12774,2017,September,Jackson                                              ,Not Adjusted,7088,7382,294,4.0
12775,2017,December,Jackson                                              ,Not Adjusted,7135,7386,251,3.4
12776,2017,March,Jasper                                               ,Not Adjusted,12632,13685,1053,7.7
12777,2017,June,Jasper                                               ,Not Adjusted,12514,13539,1025,7.6
12778,2017,September,Jasper                                               ,Not Adjusted,12337,13285,948,7.1
12779,2017,December,Jasper                                               ,Not Adjusted,12548,13506,958,7.1
12780,2017,March,Jeff Davis                                           ,Not Adjusted,1075,1110,35,3.2
12781,2017,June,Jeff Davis                                           ,Not Adjusted,1079,1114,35,3.1
12782,2017,September,Jeff Davis                                           ,Not Adjusted,1004,1037,33,3.2
12783,2017,December,Jeff Davis                                           ,Not Adjusted,1004,1033,29,2.8
12784,2017,March,Jefferson                                            ,Not Adjusted,100705,108743,8038,7.4
12785,2017,June,Jefferson                                            ,Not Adjusted,99823,107583,7760,7.2
12786,2017,September,Jefferson                                            ,Not Adjusted,98548,107879,9331,8.6
12787,2017,December,Jefferson                                            ,Not Adjusted,99087,106741,7654,7.2
12788,2017,March,Jim Hogg                                             ,Not Adjusted,1763,1917,154,8.0
12789,2017,June,Jim Hogg                                             ,Not Adjusted,1780,1925,145,7.5
12790,2017,September,Jim Hogg                                             ,Not Adjusted,1802,1920,118,6.1
12791,2017,December,Jim Hogg                                             ,Not Adjusted,1798,1908,110,5.8
12792,2017,March,Jim Wells                                            ,Not Adjusted,15544,16989,1445,8.5
12793,2017,June,Jim Wells                                            ,Not Adjusted,15703,17004,1301,7.7
12794,2017,September,Jim Wells                                            ,Not Adjusted,15389,16476,1087,6.6
12795,2017,December,Jim Wells                                            ,Not Adjusted,15460,16473,1013,6.1
12796,2017,March,Johnson                                              ,Not Adjusted,74420,77719,3299,4.2
12797,2017,June,Johnson                                              ,Not Adjusted,74809,77993,3184,4.1
12798,2017,September,Johnson                                              ,Not Adjusted,76021,78733,2712,3.4
12799,2017,December,Johnson                                              ,Not Adjusted,76125,78721,2596,3.3
12800,2017,March,Jones                                                ,Not Adjusted,5409,5697,288,5.1
12801,2017,June,Jones                                                ,Not Adjusted,5344,5660,316,5.6
12802,2017,September,Jones                                                ,Not Adjusted,5364,5643,279,4.9
12803,2017,December,Jones                                                ,Not Adjusted,5360,5633,273,4.8
12804,2017,March,Karnes                                               ,Not Adjusted,6236,6482,246,3.8
12805,2017,June,Karnes                                               ,Not Adjusted,6208,6444,236,3.7
12806,2017,September,Karnes                                               ,Not Adjusted,6233,6439,206,3.2
12807,2017,December,Karnes                                               ,Not Adjusted,6264,6440,176,2.7
12808,2017,March,Kaufman                                              ,Not Adjusted,57615,59903,2288,3.8
12809,2017,June,Kaufman                                              ,Not Adjusted,57925,60260,2335,3.9
12810,2017,September,Kaufman                                              ,Not Adjusted,58804,60819,2015,3.3
12811,2017,December,Kaufman                                              ,Not Adjusted,58855,60781,1926,3.2
12812,2017,March,Kendall                                              ,Not Adjusted,20467,21160,693,3.3
12813,2017,June,Kendall                                              ,Not Adjusted,20495,21196,701,3.3
12814,2017,September,Kendall                                              ,Not Adjusted,20531,21151,620,2.9
12815,2017,December,Kendall                                              ,Not Adjusted,20583,21159,576,2.7
12816,2017,March,Kenedy                                               ,Not Adjusted,241,252,11,4.4
12817,2017,June,Kenedy                                               ,Not Adjusted,244,251,7,2.8
12818,2017,September,Kenedy                                               ,Not Adjusted,232,239,7,2.9
12819,2017,December,Kenedy                                               ,Not Adjusted,222,229,7,3.1
12820,2017,March,Kent                                                 ,Not Adjusted,447,461,14,3.0
12821,2017,June,Kent                                                 ,Not Adjusted,456,467,11,2.4
12822,2017,September,Kent                                                 ,Not Adjusted,457,469,12,2.6
12823,2017,December,Kent                                                 ,Not Adjusted,426,437,11,2.5
12824,2017,March,Kerr                                                 ,Not Adjusted,20508,21260,752,3.5
12825,2017,June,Kerr                                                 ,Not Adjusted,20920,21674,754,3.5
12826,2017,September,Kerr                                                 ,Not Adjusted,20590,21303,713,3.3
12827,2017,December,Kerr                                                 ,Not Adjusted,20864,21539,675,3.1
12828,2017,March,Kimble                                               ,Not Adjusted,1870,1944,74,3.8
12829,2017,June,Kimble                                               ,Not Adjusted,1866,1938,72,3.7
12830,2017,September,Kimble                                               ,Not Adjusted,1801,1868,67,3.6
12831,2017,December,Kimble                                               ,Not Adjusted,1820,1875,55,2.9
12832,2017,March,King                                                 ,Not Adjusted,174,180,6,3.3
12833,2017,June,King                                                 ,Not Adjusted,170,177,7,4.0
12834,2017,September,King                                                 ,Not Adjusted,155,160,5,3.1
12835,2017,December,King                                                 ,Not Adjusted,154,159,5,3.1
12836,2017,March,Kinney                                               ,Not Adjusted,1103,1174,71,6.0
12837,2017,June,Kinney                                               ,Not Adjusted,1159,1223,64,5.2
12838,2017,September,Kinney                                               ,Not Adjusted,1079,1137,58,5.1
12839,2017,December,Kinney                                               ,Not Adjusted,1079,1139,60,5.3
12840,2017,March,Kleberg                                              ,Not Adjusted,13053,13918,865,6.2
12841,2017,June,Kleberg                                              ,Not Adjusted,12369,13231,862,6.5
12842,2017,September,Kleberg                                              ,Not Adjusted,12423,13124,701,5.3
12843,2017,December,Kleberg                                              ,Not Adjusted,12756,13420,664,4.9
12844,2017,March,Knox                                                 ,Not Adjusted,1483,1540,57,3.7
12845,2017,June,Knox                                                 ,Not Adjusted,1437,1504,67,4.5
12846,2017,September,Knox                                                 ,Not Adjusted,1392,1450,58,4.0
12847,2017,December,Knox                                                 ,Not Adjusted,1423,1471,48,3.3
12848,2017,March,Lamar                                                ,Not Adjusted,22722,23800,1078,4.5
12849,2017,June,Lamar                                                ,Not Adjusted,22850,23862,1012,4.2
12850,2017,September,Lamar                                                ,Not Adjusted,22726,23655,929,3.9
12851,2017,December,Lamar                                                ,Not Adjusted,22935,23877,942,3.9
12852,2017,March,Lamb                                                 ,Not Adjusted,5032,5335,303,5.7
12853,2017,June,Lamb                                                 ,Not Adjusted,5012,5310,298,5.6
12854,2017,September,Lamb                                                 ,Not Adjusted,4873,5116,243,4.7
12855,2017,December,Lamb                                                 ,Not Adjusted,4947,5146,199,3.9
12856,2017,March,Lampasas                                             ,Not Adjusted,8863,9225,362,3.9
12857,2017,June,Lampasas                                             ,Not Adjusted,8887,9234,347,3.8
12858,2017,September,Lampasas                                             ,Not Adjusted,8861,9195,334,3.6
12859,2017,December,Lampasas                                             ,Not Adjusted,8888,9213,325,3.5
12860,2017,March,La Salle                                             ,Not Adjusted,3792,3967,175,4.4
12861,2017,June,La Salle                                             ,Not Adjusted,4376,4535,159,3.5
12862,2017,September,La Salle                                             ,Not Adjusted,4175,4306,131,3.0
12863,2017,December,La Salle                                             ,Not Adjusted,4138,4253,115,2.7
12864,2017,March,Lavaca                                               ,Not Adjusted,8420,8757,337,3.8
12865,2017,June,Lavaca                                               ,Not Adjusted,8599,8922,323,3.6
12866,2017,September,Lavaca                                               ,Not Adjusted,8297,8593,296,3.4
12867,2017,December,Lavaca                                               ,Not Adjusted,8362,8636,274,3.2
12868,2017,March,Lee                                                  ,Not Adjusted,8990,9332,342,3.7
12869,2017,June,Lee                                                  ,Not Adjusted,9604,9929,325,3.3
12870,2017,September,Lee                                                  ,Not Adjusted,9531,9807,276,2.8
12871,2017,December,Lee                                                  ,Not Adjusted,8908,9201,293,3.2
12872,2017,March,Leon                                                 ,Not Adjusted,5961,6381,420,6.6
12873,2017,June,Leon                                                 ,Not Adjusted,5759,6165,406,6.6
12874,2017,September,Leon                                                 ,Not Adjusted,5705,6058,353,5.8
12875,2017,December,Leon                                                 ,Not Adjusted,5848,6192,344,5.6
12876,2017,March,Liberty                                              ,Not Adjusted,29676,32114,2438,7.6
12877,2017,June,Liberty                                              ,Not Adjusted,29699,32069,2370,7.4
12878,2017,September,Liberty                                              ,Not Adjusted,29746,31995,2249,7.0
12879,2017,December,Liberty                                              ,Not Adjusted,29929,31970,2041,6.4
12880,2017,March,Limestone                                            ,Not Adjusted,7925,8427,502,6.0
12881,2017,June,Limestone                                            ,Not Adjusted,7943,8427,484,5.7
12882,2017,September,Limestone                                            ,Not Adjusted,7838,8283,445,5.4
12883,2017,December,Limestone                                            ,Not Adjusted,7796,8205,409,5.0
12884,2017,March,Lipscomb                                             ,Not Adjusted,1590,1648,58,3.5
12885,2017,June,Lipscomb                                             ,Not Adjusted,1593,1646,53,3.2
12886,2017,September,Lipscomb                                             ,Not Adjusted,1548,1595,47,2.9
12887,2017,December,Lipscomb                                             ,Not Adjusted,1571,1614,43,2.7
12888,2017,March,Live Oak                                             ,Not Adjusted,5031,5295,264,5.0
12889,2017,June,Live Oak                                             ,Not Adjusted,5265,5529,264,4.8
12890,2017,September,Live Oak                                             ,Not Adjusted,5259,5494,235,4.3
12891,2017,December,Live Oak                                             ,Not Adjusted,5228,5449,221,4.1
12892,2017,March,Llano                                                ,Not Adjusted,8003,8342,339,4.1
12893,2017,June,Llano                                                ,Not Adjusted,8229,8548,319,3.7
12894,2017,September,Llano                                                ,Not Adjusted,8031,8339,308,3.7
12895,2017,December,Llano                                                ,Not Adjusted,7996,8291,295,3.6
12896,2017,March,Loving                                               ,Not Adjusted,105,111,6,5.4
12897,2017,June,Loving                                               ,Not Adjusted,94,98,4,4.1
12898,2017,September,Loving                                               ,Not Adjusted,86,90,4,4.4
12899,2017,December,Loving                                               ,Not Adjusted,90,94,4,4.3
12900,2017,March,Lubbock                                              ,Not Adjusted,150486,156043,5557,3.6
12901,2017,June,Lubbock                                              ,Not Adjusted,149787,155558,5771,3.7
12902,2017,September,Lubbock                                              ,Not Adjusted,151915,156497,4582,2.9
12903,2017,December,Lubbock                                              ,Not Adjusted,151507,155824,4317,2.8
12904,2017,March,Lynn                                                 ,Not Adjusted,2748,2858,110,3.8
12905,2017,June,Lynn                                                 ,Not Adjusted,2692,2811,119,4.2
12906,2017,September,Lynn                                                 ,Not Adjusted,2625,2724,99,3.6
12907,2017,December,Lynn                                                 ,Not Adjusted,2641,2731,90,3.3
12908,2017,March,McCulloch                                            ,Not Adjusted,3624,3758,134,3.6
12909,2017,June,McCulloch                                            ,Not Adjusted,3565,3704,139,3.8
12910,2017,September,McCulloch                                            ,Not Adjusted,3557,3683,126,3.4
12911,2017,December,McCulloch                                            ,Not Adjusted,3623,3737,114,3.1
12912,2017,March,McLennan                                             ,Not Adjusted,113678,118254,4576,3.9
12913,2017,June,McLennan                                             ,Not Adjusted,112992,118364,5372,4.5
12914,2017,September,McLennan                                             ,Not Adjusted,114286,118756,4470,3.8
12915,2017,December,McLennan                                             ,Not Adjusted,113271,117270,3999,3.4
12916,2017,March,McMullen                                             ,Not Adjusted,752,765,13,1.7
12917,2017,June,McMullen                                             ,Not Adjusted,735,750,15,2.0
12918,2017,September,McMullen                                             ,Not Adjusted,691,702,11,1.6
12919,2017,December,McMullen                                             ,Not Adjusted,761,773,12,1.6
12920,2017,March,Madison                                              ,Not Adjusted,4587,4827,240,5.0
12921,2017,June,Madison                                              ,Not Adjusted,4416,4661,245,5.3
12922,2017,September,Madison                                              ,Not Adjusted,4486,4691,205,4.4
12923,2017,December,Madison                                              ,Not Adjusted,4462,4652,190,4.1
12924,2017,March,Marion                                               ,Not Adjusted,3975,4245,270,6.4
12925,2017,June,Marion                                               ,Not Adjusted,4040,4295,255,5.9
12926,2017,September,Marion                                               ,Not Adjusted,4208,4431,223,5.0
12927,2017,December,Marion                                               ,Not Adjusted,4148,4354,206,4.7
12928,2017,March,Martin                                               ,Not Adjusted,2392,2487,95,3.8
12929,2017,June,Martin                                               ,Not Adjusted,2445,2533,88,3.5
12930,2017,September,Martin                                               ,Not Adjusted,2474,2544,70,2.8
12931,2017,December,Martin                                               ,Not Adjusted,2559,2619,60,2.3
12932,2017,March,Mason                                                ,Not Adjusted,1829,1894,65,3.4
12933,2017,June,Mason                                                ,Not Adjusted,1817,1883,66,3.5
12934,2017,September,Mason                                                ,Not Adjusted,1679,1733,54,3.1
12935,2017,December,Mason                                                ,Not Adjusted,1719,1771,52,2.9
12936,2017,March,Matagorda                                            ,Not Adjusted,16237,17498,1261,7.2
12937,2017,June,Matagorda                                            ,Not Adjusted,15866,17136,1270,7.4
12938,2017,September,Matagorda                                            ,Not Adjusted,15563,16845,1282,7.6
12939,2017,December,Matagorda                                            ,Not Adjusted,15596,16746,1150,6.9
12940,2017,March,Maverick                                             ,Not Adjusted,21878,24607,2729,11.1
12941,2017,June,Maverick                                             ,Not Adjusted,21593,23965,2372,9.9
12942,2017,September,Maverick                                             ,Not Adjusted,21516,23216,1700,7.3
12943,2017,December,Maverick                                             ,Not Adjusted,21830,23791,1961,8.2
12944,2017,March,Medina                                               ,Not Adjusted,20472,21347,875,4.1
12945,2017,June,Medina                                               ,Not Adjusted,20480,21347,867,4.1
12946,2017,September,Medina                                               ,Not Adjusted,20590,21375,785,3.7
12947,2017,December,Medina                                               ,Not Adjusted,20538,21252,714,3.4
12948,2017,March,Menard                                               ,Not Adjusted,770,805,35,4.3
12949,2017,June,Menard                                               ,Not Adjusted,768,818,50,6.1
12950,2017,September,Menard                                               ,Not Adjusted,763,801,38,4.7
12951,2017,December,Menard                                               ,Not Adjusted,777,813,36,4.4
12952,2017,March,Midland                                              ,Not Adjusted,83983,87050,3067,3.5
12953,2017,June,Midland                                              ,Not Adjusted,87105,89952,2847,3.2
12954,2017,September,Midland                                              ,Not Adjusted,90702,93137,2435,2.6
12955,2017,December,Midland                                              ,Not Adjusted,93473,95642,2169,2.3
12956,2017,March,Milam                                                ,Not Adjusted,9796,10340,544,5.3
12957,2017,June,Milam                                                ,Not Adjusted,9696,10224,528,5.2
12958,2017,September,Milam                                                ,Not Adjusted,9510,9987,477,4.8
12959,2017,December,Milam                                                ,Not Adjusted,9393,9841,448,4.6
12960,2017,March,Mills                                                ,Not Adjusted,1875,1949,74,3.8
12961,2017,June,Mills                                                ,Not Adjusted,1853,1924,71,3.7
12962,2017,September,Mills                                                ,Not Adjusted,1841,1904,63,3.3
12963,2017,December,Mills                                                ,Not Adjusted,1853,1908,55,2.9
12964,2017,March,Mitchell                                             ,Not Adjusted,2456,2609,153,5.9
12965,2017,June,Mitchell                                             ,Not Adjusted,2400,2544,144,5.7
12966,2017,September,Mitchell                                             ,Not Adjusted,2322,2437,115,4.7
12967,2017,December,Mitchell                                             ,Not Adjusted,2230,2344,114,4.9
12968,2017,March,Montague                                             ,Not Adjusted,8611,9004,393,4.4
12969,2017,June,Montague                                             ,Not Adjusted,8848,9226,378,4.1
12970,2017,September,Montague                                             ,Not Adjusted,8791,9118,327,3.6
12971,2017,December,Montague                                             ,Not Adjusted,8704,9007,303,3.4
12972,2017,March,Montgomery                                           ,Not Adjusted,257642,270287,12645,4.7
12973,2017,June,Montgomery                                           ,Not Adjusted,258218,270515,12297,4.5
12974,2017,September,Montgomery                                           ,Not Adjusted,259101,270299,11198,4.1
12975,2017,December,Montgomery                                           ,Not Adjusted,260854,271204,10350,3.8
12976,2017,March,Moore                                                ,Not Adjusted,10937,11258,321,2.9
12977,2017,June,Moore                                                ,Not Adjusted,10709,11059,350,3.2
12978,2017,September,Moore                                                ,Not Adjusted,10582,10886,304,2.8
12979,2017,December,Moore                                                ,Not Adjusted,10714,11003,289,2.6
12980,2017,March,Morris                                               ,Not Adjusted,4178,4667,489,10.5
12981,2017,June,Morris                                               ,Not Adjusted,4234,4631,397,8.6
12982,2017,September,Morris                                               ,Not Adjusted,4371,4693,322,6.9
12983,2017,December,Morris                                               ,Not Adjusted,4313,4615,302,6.5
12984,2017,March,Motley                                               ,Not Adjusted,507,525,18,3.4
12985,2017,June,Motley                                               ,Not Adjusted,502,522,20,3.8
12986,2017,September,Motley                                               ,Not Adjusted,458,474,16,3.4
12987,2017,December,Motley                                               ,Not Adjusted,450,467,17,3.6
12988,2017,March,Nacogdoches                                          ,Not Adjusted,27441,28746,1305,4.5
12989,2017,June,Nacogdoches                                          ,Not Adjusted,27289,28650,1361,4.8
12990,2017,September,Nacogdoches                                          ,Not Adjusted,27408,28514,1106,3.9
12991,2017,December,Nacogdoches                                          ,Not Adjusted,27309,28345,1036,3.7
12992,2017,March,Navarro                                              ,Not Adjusted,21610,22693,1083,4.8
12993,2017,June,Navarro                                              ,Not Adjusted,21604,22574,970,4.3
12994,2017,September,Navarro                                              ,Not Adjusted,22075,22894,819,3.6
12995,2017,December,Navarro                                              ,Not Adjusted,22001,22741,740,3.3
12996,2017,March,Newton                                               ,Not Adjusted,4924,5347,423,7.9
12997,2017,June,Newton                                               ,Not Adjusted,4871,5323,452,8.5
12998,2017,September,Newton                                               ,Not Adjusted,4792,5211,419,8.0
12999,2017,December,Newton                                               ,Not Adjusted,4817,5225,408,7.8
13000,2017,March,Nolan                                                ,Not Adjusted,6509,6817,308,4.5
13001,2017,June,Nolan                                                ,Not Adjusted,6513,6816,303,4.4
13002,2017,September,Nolan                                                ,Not Adjusted,6510,6755,245,3.6
13003,2017,December,Nolan                                                ,Not Adjusted,6506,6731,225,3.3
13004,2017,March,Nueces                                               ,Not Adjusted,160918,170414,9496,5.6
13005,2017,June,Nueces                                               ,Not Adjusted,159700,168941,9241,5.5
13006,2017,September,Nueces                                               ,Not Adjusted,157389,166415,9026,5.4
13007,2017,December,Nueces                                               ,Not Adjusted,158790,167025,8235,4.9
13008,2017,March,Ochiltree                                            ,Not Adjusted,4377,4566,189,4.1
13009,2017,June,Ochiltree                                            ,Not Adjusted,4378,4547,169,3.7
13010,2017,September,Ochiltree                                            ,Not Adjusted,4352,4495,143,3.2
13011,2017,December,Ochiltree                                            ,Not Adjusted,4349,4480,131,2.9
13012,2017,March,Oldham                                               ,Not Adjusted,902,926,24,2.6
13013,2017,June,Oldham                                               ,Not Adjusted,885,909,24,2.6
13014,2017,September,Oldham                                               ,Not Adjusted,868,891,23,2.6
13015,2017,December,Oldham                                               ,Not Adjusted,870,890,20,2.2
13016,2017,March,Orange                                               ,Not Adjusted,34901,37421,2520,6.7
13017,2017,June,Orange                                               ,Not Adjusted,34617,37111,2494,6.7
13018,2017,September,Orange                                               ,Not Adjusted,34201,37403,3202,8.6
13019,2017,December,Orange                                               ,Not Adjusted,34399,36896,2497,6.8
13020,2017,March,Palo Pinto                                           ,Not Adjusted,12662,13271,609,4.6
13021,2017,June,Palo Pinto                                           ,Not Adjusted,13031,13594,563,4.1
13022,2017,September,Palo Pinto                                           ,Not Adjusted,13056,13566,510,3.8
13023,2017,December,Palo Pinto                                           ,Not Adjusted,12896,13348,452,3.4
13024,2017,March,Panola                                               ,Not Adjusted,10024,10665,641,6.0
13025,2017,June,Panola                                               ,Not Adjusted,9688,10296,608,5.9
13026,2017,September,Panola                                               ,Not Adjusted,10010,10494,484,4.6
13027,2017,December,Panola                                               ,Not Adjusted,9973,10435,462,4.4
13028,2017,March,Parker                                               ,Not Adjusted,60559,62916,2357,3.7
13029,2017,June,Parker                                               ,Not Adjusted,60851,63163,2312,3.7
13030,2017,September,Parker                                               ,Not Adjusted,61670,63707,2037,3.2
13031,2017,December,Parker                                               ,Not Adjusted,61862,63752,1890,3.0
13032,2017,March,Parmer                                               ,Not Adjusted,4960,5093,133,2.6
13033,2017,June,Parmer                                               ,Not Adjusted,4845,4979,134,2.7
13034,2017,September,Parmer                                               ,Not Adjusted,4691,4808,117,2.4
13035,2017,December,Parmer                                               ,Not Adjusted,4751,4857,106,2.2
13036,2017,March,Pecos                                                ,Not Adjusted,6001,6350,349,5.5
13037,2017,June,Pecos                                                ,Not Adjusted,5937,6238,301,4.8
13038,2017,September,Pecos                                                ,Not Adjusted,5985,6235,250,4.0
13039,2017,December,Pecos                                                ,Not Adjusted,6055,6268,213,3.4
13040,2017,March,Polk                                                 ,Not Adjusted,16708,17875,1167,6.5
13041,2017,June,Polk                                                 ,Not Adjusted,16464,17547,1083,6.2
13042,2017,September,Polk                                                 ,Not Adjusted,16338,17345,1007,5.8
13043,2017,December,Polk                                                 ,Not Adjusted,16515,17468,953,5.5
13044,2017,March,Potter                                               ,Not Adjusted,53711,55640,1929,3.5
13045,2017,June,Potter                                               ,Not Adjusted,53467,55416,1949,3.5
13046,2017,September,Potter                                               ,Not Adjusted,53767,55442,1675,3.0
13047,2017,December,Potter                                               ,Not Adjusted,53755,55304,1549,2.8
13048,2017,March,Presidio                                             ,Not Adjusted,2810,3132,322,10.3
13049,2017,June,Presidio                                             ,Not Adjusted,2805,3113,308,9.9
13050,2017,September,Presidio                                             ,Not Adjusted,2751,2997,246,8.2
13051,2017,December,Presidio                                             ,Not Adjusted,2730,2957,227,7.7
13052,2017,March,Rains                                                ,Not Adjusted,5525,5739,214,3.7
13053,2017,June,Rains                                                ,Not Adjusted,5439,5650,211,3.7
13054,2017,September,Rains                                                ,Not Adjusted,5498,5697,199,3.5
13055,2017,December,Rains                                                ,Not Adjusted,5569,5757,188,3.3
13056,2017,March,Randall                                              ,Not Adjusted,69123,71299,2176,3.1
13057,2017,June,Randall                                              ,Not Adjusted,68675,70858,2183,3.1
13058,2017,September,Randall                                              ,Not Adjusted,69061,70908,1847,2.6
13059,2017,December,Randall                                              ,Not Adjusted,68850,70562,1712,2.4
13060,2017,March,Reagan                                               ,Not Adjusted,1716,1799,83,4.6
13061,2017,June,Reagan                                               ,Not Adjusted,1743,1815,72,4.0
13062,2017,September,Reagan                                               ,Not Adjusted,1739,1799,60,3.3
13063,2017,December,Reagan                                               ,Not Adjusted,1759,1812,53,2.9
13064,2017,March,Real                                                 ,Not Adjusted,1007,1068,61,5.7
13065,2017,June,Real                                                 ,Not Adjusted,1087,1151,64,5.6
13066,2017,September,Real                                                 ,Not Adjusted,952,1007,55,5.5
13067,2017,December,Real                                                 ,Not Adjusted,967,1020,53,5.2
13068,2017,March,Red River                                            ,Not Adjusted,4978,5266,288,5.5
13069,2017,June,Red River                                            ,Not Adjusted,5023,5307,284,5.4
13070,2017,September,Red River                                            ,Not Adjusted,4916,5166,250,4.8
13071,2017,December,Red River                                            ,Not Adjusted,4886,5141,255,5.0
13072,2017,March,Reeves                                               ,Not Adjusted,6170,6425,255,4.0
13073,2017,June,Reeves                                               ,Not Adjusted,6706,6944,238,3.4
13074,2017,September,Reeves                                               ,Not Adjusted,7154,7407,253,3.4
13075,2017,December,Reeves                                               ,Not Adjusted,7454,7668,214,2.8
13076,2017,March,Refugio                                              ,Not Adjusted,3034,3201,167,5.2
13077,2017,June,Refugio                                              ,Not Adjusted,3167,3334,167,5.0
13078,2017,September,Refugio                                              ,Not Adjusted,3009,3244,235,7.2
13079,2017,December,Refugio                                              ,Not Adjusted,2974,3157,183,5.8
13080,2017,March,Roberts                                              ,Not Adjusted,430,450,20,4.4
13081,2017,June,Roberts                                              ,Not Adjusted,443,460,17,3.7
13082,2017,September,Roberts                                              ,Not Adjusted,423,437,14,3.2
13083,2017,December,Roberts                                              ,Not Adjusted,416,428,12,2.8
13084,2017,March,Robertson                                            ,Not Adjusted,7252,7622,370,4.9
13085,2017,June,Robertson                                            ,Not Adjusted,6836,7221,385,5.3
13086,2017,September,Robertson                                            ,Not Adjusted,7160,7476,316,4.2
13087,2017,December,Robertson                                            ,Not Adjusted,7229,7547,318,4.2
13088,2017,March,Rockwall                                             ,Not Adjusted,46851,48578,1727,3.6
13089,2017,June,Rockwall                                             ,Not Adjusted,47132,48876,1744,3.6
13090,2017,September,Rockwall                                             ,Not Adjusted,47788,49373,1585,3.2
13091,2017,December,Rockwall                                             ,Not Adjusted,47926,49451,1525,3.1
13092,2017,March,Runnels                                              ,Not Adjusted,4526,4703,177,3.8
13093,2017,June,Runnels                                              ,Not Adjusted,4455,4647,192,4.1
13094,2017,September,Runnels                                              ,Not Adjusted,4352,4503,151,3.4
13095,2017,December,Runnels                                              ,Not Adjusted,4453,4595,142,3.1
13096,2017,March,Rusk                                                 ,Not Adjusted,21060,22293,1233,5.5
13097,2017,June,Rusk                                                 ,Not Adjusted,21003,22174,1171,5.3
13098,2017,September,Rusk                                                 ,Not Adjusted,21090,22133,1043,4.7
13099,2017,December,Rusk                                                 ,Not Adjusted,21105,22062,957,4.3
13100,2017,March,Sabine                                               ,Not Adjusted,3197,3528,331,9.4
13101,2017,June,Sabine                                               ,Not Adjusted,3291,3598,307,8.5
13102,2017,September,Sabine                                               ,Not Adjusted,3294,3561,267,7.5
13103,2017,December,Sabine                                               ,Not Adjusted,3317,3626,309,8.5
13104,2017,March,San Augustine                                        ,Not Adjusted,2641,2874,233,8.1
13105,2017,June,San Augustine                                        ,Not Adjusted,2661,2874,213,7.4
13106,2017,September,San Augustine                                        ,Not Adjusted,2735,2930,195,6.7
13107,2017,December,San Augustine                                        ,Not Adjusted,2701,2911,210,7.2
13108,2017,March,San Jacinto                                          ,Not Adjusted,10790,11481,691,6.0
13109,2017,June,San Jacinto                                          ,Not Adjusted,10880,11548,668,5.8
13110,2017,September,San Jacinto                                          ,Not Adjusted,10804,11435,631,5.5
13111,2017,December,San Jacinto                                          ,Not Adjusted,10861,11468,607,5.3
13112,2017,March,San Patricio                                         ,Not Adjusted,28660,31106,2446,7.9
13113,2017,June,San Patricio                                         ,Not Adjusted,28385,30653,2268,7.4
13114,2017,September,San Patricio                                         ,Not Adjusted,27916,30541,2625,8.6
13115,2017,December,San Patricio                                         ,Not Adjusted,28129,30367,2238,7.4
13116,2017,March,San Saba                                             ,Not Adjusted,2410,2489,79,3.2
13117,2017,June,San Saba                                             ,Not Adjusted,2312,2393,81,3.4
13118,2017,September,San Saba                                             ,Not Adjusted,2289,2360,71,3.0
13119,2017,December,San Saba                                             ,Not Adjusted,2375,2446,71,2.9
13120,2017,March,Schleicher                                           ,Not Adjusted,1306,1360,54,4.0
13121,2017,June,Schleicher                                           ,Not Adjusted,1335,1388,53,3.8
13122,2017,September,Schleicher                                           ,Not Adjusted,1236,1285,49,3.8
13123,2017,December,Schleicher                                           ,Not Adjusted,1243,1280,37,2.9
13124,2017,March,Scurry                                               ,Not Adjusted,6724,7086,362,5.1
13125,2017,June,Scurry                                               ,Not Adjusted,6766,7096,330,4.7
13126,2017,September,Scurry                                               ,Not Adjusted,6549,6802,253,3.7
13127,2017,December,Scurry                                               ,Not Adjusted,6583,6816,233,3.4
13128,2017,March,Shackelford                                          ,Not Adjusted,1863,1924,61,3.2
13129,2017,June,Shackelford                                          ,Not Adjusted,1900,1957,57,2.9
13130,2017,September,Shackelford                                          ,Not Adjusted,1797,1848,51,2.8
13131,2017,December,Shackelford                                          ,Not Adjusted,1842,1890,48,2.5
13132,2017,March,Shelby                                               ,Not Adjusted,10298,10902,604,5.5
13133,2017,June,Shelby                                               ,Not Adjusted,10339,10923,584,5.3
13134,2017,September,Shelby                                               ,Not Adjusted,10258,10758,500,4.6
13135,2017,December,Shelby                                               ,Not Adjusted,10190,10689,499,4.7
13136,2017,March,Sherman                                              ,Not Adjusted,1303,1343,40,3.0
13137,2017,June,Sherman                                              ,Not Adjusted,1267,1314,47,3.6
13138,2017,September,Sherman                                              ,Not Adjusted,1237,1273,36,2.8
13139,2017,December,Sherman                                              ,Not Adjusted,1240,1276,36,2.8
13140,2017,March,Smith                                                ,Not Adjusted,100452,105025,4573,4.4
13141,2017,June,Smith                                                ,Not Adjusted,101296,105757,4461,4.2
13142,2017,September,Smith                                                ,Not Adjusted,102427,106563,4136,3.9
13143,2017,December,Smith                                                ,Not Adjusted,103662,107533,3871,3.6
13144,2017,March,Somervell                                            ,Not Adjusted,3961,4145,184,4.4
13145,2017,June,Somervell                                            ,Not Adjusted,3982,4198,216,5.1
13146,2017,September,Somervell                                            ,Not Adjusted,4041,4224,183,4.3
13147,2017,December,Somervell                                            ,Not Adjusted,4054,4228,174,4.1
13148,2017,March,Starr                                                ,Not Adjusted,23398,27055,3657,13.5
13149,2017,June,Starr                                                ,Not Adjusted,23119,26288,3169,12.1
13150,2017,September,Starr                                                ,Not Adjusted,22679,25156,2477,9.8
13151,2017,December,Starr                                                ,Not Adjusted,23065,25782,2717,10.5
13152,2017,March,Stephens                                             ,Not Adjusted,3840,4049,209,5.2
13153,2017,June,Stephens                                             ,Not Adjusted,3825,4036,211,5.2
13154,2017,September,Stephens                                             ,Not Adjusted,3853,4015,162,4.0
13155,2017,December,Stephens                                             ,Not Adjusted,3842,3994,152,3.8
13156,2017,March,Sterling                                             ,Not Adjusted,614,645,31,4.8
13157,2017,June,Sterling                                             ,Not Adjusted,597,617,20,3.2
13158,2017,September,Sterling                                             ,Not Adjusted,545,561,16,2.9
13159,2017,December,Sterling                                             ,Not Adjusted,547,564,17,3.0
13160,2017,March,Stonewall                                            ,Not Adjusted,605,626,21,3.4
13161,2017,June,Stonewall                                            ,Not Adjusted,614,636,22,3.5
13162,2017,September,Stonewall                                            ,Not Adjusted,589,610,21,3.4
13163,2017,December,Stonewall                                            ,Not Adjusted,570,589,19,3.2
13164,2017,March,Sutton                                               ,Not Adjusted,1423,1515,92,6.1
13165,2017,June,Sutton                                               ,Not Adjusted,1436,1520,84,5.5
13166,2017,September,Sutton                                               ,Not Adjusted,1450,1512,62,4.1
13167,2017,December,Sutton                                               ,Not Adjusted,1419,1483,64,4.3
13168,2017,March,Swisher                                              ,Not Adjusted,2663,2789,126,4.5
13169,2017,June,Swisher                                              ,Not Adjusted,2610,2727,117,4.3
13170,2017,September,Swisher                                              ,Not Adjusted,2526,2632,106,4.0
13171,2017,December,Swisher                                              ,Not Adjusted,2555,2649,94,3.5
13172,2017,March,Tarrant                                              ,Not Adjusted,986931,1028197,41266,4.0
13173,2017,June,Tarrant                                              ,Not Adjusted,992860,1033882,41022,4.0
13174,2017,September,Tarrant                                              ,Not Adjusted,1010693,1047202,36509,3.5
13175,2017,December,Tarrant                                              ,Not Adjusted,1011687,1046342,34655,3.3
13176,2017,March,Taylor                                               ,Not Adjusted,61865,64187,2322,3.6
13177,2017,June,Taylor                                               ,Not Adjusted,61518,64047,2529,3.9
13178,2017,September,Taylor                                               ,Not Adjusted,62676,64839,2163,3.3
13179,2017,December,Taylor                                               ,Not Adjusted,62433,64406,1973,3.1
13180,2017,March,Terrell                                              ,Not Adjusted,381,405,24,5.9
13181,2017,June,Terrell                                              ,Not Adjusted,379,399,20,5.0
13182,2017,September,Terrell                                              ,Not Adjusted,366,380,14,3.7
13183,2017,December,Terrell                                              ,Not Adjusted,378,391,13,3.3
13184,2017,March,Terry                                                ,Not Adjusted,5099,5387,288,5.3
13185,2017,June,Terry                                                ,Not Adjusted,5062,5360,298,5.6
13186,2017,September,Terry                                                ,Not Adjusted,4855,5108,253,5.0
13187,2017,December,Terry                                                ,Not Adjusted,4903,5130,227,4.4
13188,2017,March,Throckmorton                                         ,Not Adjusted,683,713,30,4.2
13189,2017,June,Throckmorton                                         ,Not Adjusted,683,715,32,4.5
13190,2017,September,Throckmorton                                         ,Not Adjusted,639,669,30,4.5
13191,2017,December,Throckmorton                                         ,Not Adjusted,637,657,20,3.0
13192,2017,March,Titus                                                ,Not Adjusted,12316,13115,799,6.1
13193,2017,June,Titus                                                ,Not Adjusted,12207,12958,751,5.8
13194,2017,September,Titus                                                ,Not Adjusted,12331,12944,613,4.7
13195,2017,December,Titus                                                ,Not Adjusted,12230,12829,599,4.7
13196,2017,March,Tom Green                                            ,Not Adjusted,51936,54132,2196,4.1
13197,2017,June,Tom Green                                            ,Not Adjusted,52115,54276,2161,4.0
13198,2017,September,Tom Green                                            ,Not Adjusted,52694,54486,1792,3.3
13199,2017,December,Tom Green                                            ,Not Adjusted,52577,54217,1640,3.0
13200,2017,March,Travis                                               ,Not Adjusted,671029,693681,22652,3.3
13201,2017,June,Travis                                               ,Not Adjusted,675899,698336,22437,3.2
13202,2017,September,Travis                                               ,Not Adjusted,683834,704324,20490,2.9
13203,2017,December,Travis                                               ,Not Adjusted,686925,706159,19234,2.7
13204,2017,March,Trinity                                              ,Not Adjusted,5205,5530,325,5.9
13205,2017,June,Trinity                                              ,Not Adjusted,5192,5485,293,5.3
13206,2017,September,Trinity                                              ,Not Adjusted,4983,5279,296,5.6
13207,2017,December,Trinity                                              ,Not Adjusted,4969,5234,265,5.1
13208,2017,March,Tyler                                                ,Not Adjusted,6785,7331,546,7.4
13209,2017,June,Tyler                                                ,Not Adjusted,6657,7197,540,7.5
13210,2017,September,Tyler                                                ,Not Adjusted,6363,6876,513,7.5
13211,2017,December,Tyler                                                ,Not Adjusted,6381,6881,500,7.3
13212,2017,March,Upshur                                               ,Not Adjusted,16837,17898,1061,5.9
13213,2017,June,Upshur                                               ,Not Adjusted,16792,17743,951,5.4
13214,2017,September,Upshur                                               ,Not Adjusted,16862,17676,814,4.6
13215,2017,December,Upshur                                               ,Not Adjusted,16873,17639,766,4.3
13216,2017,March,Upton                                                ,Not Adjusted,1510,1575,65,4.1
13217,2017,June,Upton                                                ,Not Adjusted,1518,1575,57,3.6
13218,2017,September,Upton                                                ,Not Adjusted,1474,1525,51,3.3
13219,2017,December,Upton                                                ,Not Adjusted,1500,1549,49,3.2
13220,2017,March,Uvalde                                               ,Not Adjusted,11307,11884,577,4.9
13221,2017,June,Uvalde                                               ,Not Adjusted,11479,12067,588,4.9
13222,2017,September,Uvalde                                               ,Not Adjusted,11062,11562,500,4.3
13223,2017,December,Uvalde                                               ,Not Adjusted,10819,11299,480,4.2
13224,2017,March,Val Verde                                            ,Not Adjusted,19064,20185,1121,5.6
13225,2017,June,Val Verde                                            ,Not Adjusted,19226,20237,1011,5.0
13226,2017,September,Val Verde                                            ,Not Adjusted,19175,20071,896,4.5
13227,2017,December,Val Verde                                            ,Not Adjusted,19231,20102,871,4.3
13228,2017,March,Van Zandt                                            ,Not Adjusted,24381,25367,986,3.9
13229,2017,June,Van Zandt                                            ,Not Adjusted,24764,25778,1014,3.9
13230,2017,September,Van Zandt                                            ,Not Adjusted,24423,25342,919,3.6
13231,2017,December,Van Zandt                                            ,Not Adjusted,24533,25396,863,3.4
13232,2017,March,Victoria                                             ,Not Adjusted,41065,43270,2205,5.1
13233,2017,June,Victoria                                             ,Not Adjusted,40930,43076,2146,5.0
13234,2017,September,Victoria                                             ,Not Adjusted,40673,42739,2066,4.8
13235,2017,December,Victoria                                             ,Not Adjusted,40951,42685,1734,4.1
13236,2017,March,Walker                                               ,Not Adjusted,22876,24010,1134,4.7
13237,2017,June,Walker                                               ,Not Adjusted,22393,23612,1219,5.2
13238,2017,September,Walker                                               ,Not Adjusted,22635,23674,1039,4.4
13239,2017,December,Walker                                               ,Not Adjusted,22519,23469,950,4.0
13240,2017,March,Waller                                               ,Not Adjusted,21323,22484,1161,5.2
13241,2017,June,Waller                                               ,Not Adjusted,21309,22519,1210,5.4
13242,2017,September,Waller                                               ,Not Adjusted,21289,22338,1049,4.7
13243,2017,December,Waller                                               ,Not Adjusted,21423,22371,948,4.2
13244,2017,March,Ward                                                 ,Not Adjusted,5336,5579,243,4.4
13245,2017,June,Ward                                                 ,Not Adjusted,5333,5569,236,4.2
13246,2017,September,Ward                                                 ,Not Adjusted,5410,5615,205,3.7
13247,2017,December,Ward                                                 ,Not Adjusted,5526,5718,192,3.4
13248,2017,March,Washington                                           ,Not Adjusted,14280,15000,720,4.8
13249,2017,June,Washington                                           ,Not Adjusted,14315,14995,680,4.5
13250,2017,September,Washington                                           ,Not Adjusted,14222,14786,564,3.8
13251,2017,December,Washington                                           ,Not Adjusted,14242,14777,535,3.6
13252,2017,March,Webb                                                 ,Not Adjusted,109975,115315,5340,4.6
13253,2017,June,Webb                                                 ,Not Adjusted,109930,115270,5340,4.6
13254,2017,September,Webb                                                 ,Not Adjusted,111361,115640,4279,3.7
13255,2017,December,Webb                                                 ,Not Adjusted,111187,115276,4089,3.5
13256,2017,March,Wharton                                              ,Not Adjusted,20261,21259,998,4.7
13257,2017,June,Wharton                                              ,Not Adjusted,20169,21180,1011,4.8
13258,2017,September,Wharton                                              ,Not Adjusted,20069,21019,950,4.5
13259,2017,December,Wharton                                              ,Not Adjusted,20205,21036,831,4.0
13260,2017,March,Wheeler                                              ,Not Adjusted,2247,2350,103,4.4
13261,2017,June,Wheeler                                              ,Not Adjusted,2316,2408,92,3.8
13262,2017,September,Wheeler                                              ,Not Adjusted,2223,2308,85,3.7
13263,2017,December,Wheeler                                              ,Not Adjusted,2314,2396,82,3.4
13264,2017,March,Wichita                                              ,Not Adjusted,53951,56222,2271,4.0
13265,2017,June,Wichita                                              ,Not Adjusted,53889,56086,2197,3.9
13266,2017,September,Wichita                                              ,Not Adjusted,53952,55854,1902,3.4
13267,2017,December,Wichita                                              ,Not Adjusted,54527,56331,1804,3.2
13268,2017,March,Wilbarger                                            ,Not Adjusted,4865,5135,270,5.3
13269,2017,June,Wilbarger                                            ,Not Adjusted,4680,4920,240,4.9
13270,2017,September,Wilbarger                                            ,Not Adjusted,4669,4879,210,4.3
13271,2017,December,Wilbarger                                            ,Not Adjusted,4691,4898,207,4.2
13272,2017,March,Willacy                                              ,Not Adjusted,5762,6560,798,12.2
13273,2017,June,Willacy                                              ,Not Adjusted,5703,6468,765,11.8
13274,2017,September,Willacy                                              ,Not Adjusted,5509,6107,598,9.8
13275,2017,December,Willacy                                              ,Not Adjusted,5559,6122,563,9.2
13276,2017,March,Williamson                                           ,Not Adjusted,278619,288714,10095,3.5
13277,2017,June,Williamson                                           ,Not Adjusted,280480,290516,10036,3.5
13278,2017,September,Williamson                                           ,Not Adjusted,284309,293382,9073,3.1
13279,2017,December,Williamson                                           ,Not Adjusted,284857,293411,8554,2.9
13280,2017,March,Wilson                                               ,Not Adjusted,23268,24177,909,3.8
13281,2017,June,Wilson                                               ,Not Adjusted,23325,24237,912,3.8
13282,2017,September,Wilson                                               ,Not Adjusted,23554,24337,783,3.2
13283,2017,December,Wilson                                               ,Not Adjusted,23475,24207,732,3.0
13284,2017,March,Winkler                                              ,Not Adjusted,2966,3168,202,6.4
13285,2017,June,Winkler                                              ,Not Adjusted,3053,3223,170,5.3
13286,2017,September,Winkler                                              ,Not Adjusted,3128,3271,143,4.4
13287,2017,December,Winkler                                              ,Not Adjusted,3371,3497,126,3.6
13288,2017,March,Wise                                                 ,Not Adjusted,28787,30176,1389,4.6
13289,2017,June,Wise                                                 ,Not Adjusted,28899,30261,1362,4.5
13290,2017,September,Wise                                                 ,Not Adjusted,29222,30305,1083,3.6
13291,2017,December,Wise                                                 ,Not Adjusted,29331,30344,1013,3.3
13292,2017,March,Wood                                                 ,Not Adjusted,16592,17455,863,4.9
13293,2017,June,Wood                                                 ,Not Adjusted,16567,17410,843,4.8
13294,2017,September,Wood                                                 ,Not Adjusted,16530,17285,755,4.4
13295,2017,December,Wood                                                 ,Not Adjusted,16570,17276,706,4.1
13296,2017,March,Yoakum                                               ,Not Adjusted,3803,3959,156,3.9
13297,2017,June,Yoakum                                               ,Not Adjusted,3766,3910,144,3.7
13298,2017,September,Yoakum                                               ,Not Adjusted,3647,3765,118,3.1
13299,2017,December,Yoakum                                               ,Not Adjusted,3592,3699,107,2.9
13300,2017,March,Young                                                ,Not Adjusted,7681,8010,329,4.1
13301,2017,June,Young                                                ,Not Adjusted,7902,8224,322,3.9
13302,2017,September,Young                                                ,Not Adjusted,7822,8101,279,3.4
13303,2017,December,Young                                                ,Not Adjusted,7783,8041,258,3.2
13304,2017,March,Zapata                                               ,Not Adjusted,4891,5373,482,9.0
13305,2017,June,Zapata                                               ,Not Adjusted,5056,5483,427,7.8
13306,2017,September,Zapata                                               ,Not Adjusted,5026,5360,334,6.2
13307,2017,December,Zapata                                               ,Not Adjusted,5046,5384,338,6.3
13308,2017,March,Zavala                                               ,Not Adjusted,3538,3978,440,11.1
13309,2017,June,Zavala                                               ,Not Adjusted,3287,3750,463,12.3
13310,2017,September,Zavala                                               ,Not Adjusted,3099,3485,386,11.1
13311,2017,December,Zavala                                               ,Not Adjusted,3339,3685,346,9.4
13312,2018,March,Texas,Not Adjusted,13223076,13777441,554365,4.0
13313,2018,March,Texas,Adjusted,13207711,13760252,552541,4.0
13314,2018,June,Texas,Not Adjusted,13254146,13844380,590234,4.3
13315,2018,June,Texas,Adjusted,13276750,13813952,537202,3.9
13316,2018,September,Texas,Not Adjusted,13287913,13809959,522046,3.8
13317,2018,September,Texas,Adjusted,13316200,13843885,527685,3.8
13318,2018,December,Texas,Not Adjusted,13407635,13915434,507799,3.6
13319,2018,December,Texas,Adjusted,13382106,13910127,528021,3.8
13320,2018,March,Anderson                                             ,Not Adjusted,22475,23228,753,3.2
13321,2018,June,Anderson                                             ,Not Adjusted,22775,23585,810,3.4
13322,2018,September,Anderson                                             ,Not Adjusted,22733,23421,688,2.9
13323,2018,December,Anderson                                             ,Not Adjusted,22774,23500,726,3.1
13324,2018,March,Andrews                                              ,Not Adjusted,8949,9188,239,2.6
13325,2018,June,Andrews                                              ,Not Adjusted,9301,9554,253,2.6
13326,2018,September,Andrews                                              ,Not Adjusted,9368,9587,219,2.3
13327,2018,December,Andrews                                              ,Not Adjusted,9433,9646,213,2.2
13328,2018,March,Angelina                                             ,Not Adjusted,34625,36222,1597,4.4
13329,2018,June,Angelina                                             ,Not Adjusted,34496,36190,1694,4.7
13330,2018,September,Angelina                                             ,Not Adjusted,34402,35947,1545,4.3
13331,2018,December,Angelina                                             ,Not Adjusted,34336,35859,1523,4.2
13332,2018,March,Aransas                                              ,Not Adjusted,9086,9747,661,6.8
13333,2018,June,Aransas                                              ,Not Adjusted,9021,9613,592,6.2
13334,2018,September,Aransas                                              ,Not Adjusted,8890,9391,501,5.3
13335,2018,December,Aransas                                              ,Not Adjusted,8985,9435,450,4.8
13336,2018,March,Archer                                               ,Not Adjusted,4040,4172,132,3.2
13337,2018,June,Archer                                               ,Not Adjusted,4030,4168,138,3.3
13338,2018,September,Archer                                               ,Not Adjusted,3987,4120,133,3.2
13339,2018,December,Archer                                               ,Not Adjusted,3997,4116,119,2.9
13340,2018,March,Armstrong                                            ,Not Adjusted,915,940,25,2.7
13341,2018,June,Armstrong                                            ,Not Adjusted,899,928,29,3.1
13342,2018,September,Armstrong                                            ,Not Adjusted,895,922,27,2.9
13343,2018,December,Armstrong                                            ,Not Adjusted,880,902,22,2.4
13344,2018,March,Atascosa                                             ,Not Adjusted,20612,21431,819,3.8
13345,2018,June,Atascosa                                             ,Not Adjusted,20641,21543,902,4.2
13346,2018,September,Atascosa                                             ,Not Adjusted,20626,21418,792,3.7
13347,2018,December,Atascosa                                             ,Not Adjusted,20647,21441,794,3.7
13348,2018,March,Austin                                               ,Not Adjusted,13381,13912,531,3.8
13349,2018,June,Austin                                               ,Not Adjusted,13352,13922,570,4.1
13350,2018,September,Austin                                               ,Not Adjusted,13354,13837,483,3.5
13351,2018,December,Austin                                               ,Not Adjusted,13429,13909,480,3.5
13352,2018,March,Bailey                                               ,Not Adjusted,2587,2713,126,4.6
13353,2018,June,Bailey                                               ,Not Adjusted,2538,2685,147,5.5
13354,2018,September,Bailey                                               ,Not Adjusted,2522,2630,108,4.1
13355,2018,December,Bailey                                               ,Not Adjusted,2372,2465,93,3.8
13356,2018,March,Bandera                                              ,Not Adjusted,9617,9974,357,3.6
13357,2018,June,Bandera                                              ,Not Adjusted,9612,9964,352,3.5
13358,2018,September,Bandera                                              ,Not Adjusted,9598,9942,344,3.5
13359,2018,December,Bandera                                              ,Not Adjusted,9626,9956,330,3.3
13360,2018,March,Bastrop                                              ,Not Adjusted,40008,41534,1526,3.7
13361,2018,June,Bastrop                                              ,Not Adjusted,40281,41930,1649,3.9
13362,2018,September,Bastrop                                              ,Not Adjusted,40326,41688,1362,3.3
13363,2018,December,Bastrop                                              ,Not Adjusted,40748,42088,1340,3.2
13364,2018,March,Baylor                                               ,Not Adjusted,1493,1542,49,3.2
13365,2018,June,Baylor                                               ,Not Adjusted,1547,1602,55,3.4
13366,2018,September,Baylor                                               ,Not Adjusted,1520,1573,53,3.4
13367,2018,December,Baylor                                               ,Not Adjusted,1505,1547,42,2.7
13368,2018,March,Bee                                                  ,Not Adjusted,9590,10131,541,5.3
13369,2018,June,Bee                                                  ,Not Adjusted,9404,9951,547,5.5
13370,2018,September,Bee                                                  ,Not Adjusted,9399,9872,473,4.8
13371,2018,December,Bee                                                  ,Not Adjusted,9340,9803,463,4.7
13372,2018,March,Bell                                                 ,Not Adjusted,136157,142016,5859,4.1
13373,2018,June,Bell                                                 ,Not Adjusted,135806,142314,6508,4.6
13374,2018,September,Bell                                                 ,Not Adjusted,136613,142548,5935,4.2
13375,2018,December,Bell                                                 ,Not Adjusted,137445,143255,5810,4.1
13376,2018,March,Bexar                                                ,Not Adjusted,899634,931472,31838,3.4
13377,2018,June,Bexar                                                ,Not Adjusted,905142,939907,34765,3.7
13378,2018,September,Bexar                                                ,Not Adjusted,906084,937328,31244,3.3
13379,2018,December,Bexar                                                ,Not Adjusted,911076,941233,30157,3.2
13380,2018,March,Blanco                                               ,Not Adjusted,6083,6252,169,2.7
13381,2018,June,Blanco                                               ,Not Adjusted,6088,6268,180,2.9
13382,2018,September,Blanco                                               ,Not Adjusted,6038,6198,160,2.6
13383,2018,December,Blanco                                               ,Not Adjusted,6154,6315,161,2.5
13384,2018,March,Borden                                               ,Not Adjusted,356,370,14,3.8
13385,2018,June,Borden                                               ,Not Adjusted,309,320,11,3.4
13386,2018,September,Borden                                               ,Not Adjusted,339,349,10,2.9
13387,2018,December,Borden                                               ,Not Adjusted,314,324,10,3.1
13388,2018,March,Bosque                                               ,Not Adjusted,7996,8316,320,3.8
13389,2018,June,Bosque                                               ,Not Adjusted,7917,8255,338,4.1
13390,2018,September,Bosque                                               ,Not Adjusted,7908,8209,301,3.7
13391,2018,December,Bosque                                               ,Not Adjusted,7813,8097,284,3.5
13392,2018,March,Bowie                                                ,Not Adjusted,37611,39388,1777,4.5
13393,2018,June,Bowie                                                ,Not Adjusted,37487,39728,2241,5.6
13394,2018,September,Bowie                                                ,Not Adjusted,37656,39779,2123,5.3
13395,2018,December,Bowie                                                ,Not Adjusted,37848,39804,1956,4.9
13396,2018,March,Brazoria                                             ,Not Adjusted,167776,176019,8243,4.7
13397,2018,June,Brazoria                                             ,Not Adjusted,168271,176957,8686,4.9
13398,2018,September,Brazoria                                             ,Not Adjusted,168620,176486,7866,4.5
13399,2018,December,Brazoria                                             ,Not Adjusted,170370,177867,7497,4.2
13400,2018,March,Brazos                                               ,Not Adjusted,114391,117733,3342,2.8
13401,2018,June,Brazos                                               ,Not Adjusted,108793,112691,3898,3.5
13402,2018,September,Brazos                                               ,Not Adjusted,114663,117950,3287,2.8
13403,2018,December,Brazos                                               ,Not Adjusted,115126,118322,3196,2.7
13404,2018,March,Brewster                                             ,Not Adjusted,3968,4108,140,3.4
13405,2018,June,Brewster                                             ,Not Adjusted,3841,3990,149,3.7
13406,2018,September,Brewster                                             ,Not Adjusted,3947,4083,136,3.3
13407,2018,December,Brewster                                             ,Not Adjusted,3914,4040,126,3.1
13408,2018,March,Briscoe                                              ,Not Adjusted,562,584,22,3.8
13409,2018,June,Briscoe                                              ,Not Adjusted,548,572,24,4.2
13410,2018,September,Briscoe                                              ,Not Adjusted,538,559,21,3.8
13411,2018,December,Briscoe                                              ,Not Adjusted,523,543,20,3.7
13412,2018,March,Brooks                                               ,Not Adjusted,2263,2439,176,7.2
13413,2018,June,Brooks                                               ,Not Adjusted,2257,2441,184,7.5
13414,2018,September,Brooks                                               ,Not Adjusted,2327,2473,146,5.9
13415,2018,December,Brooks                                               ,Not Adjusted,2410,2542,132,5.2
13416,2018,March,Brown                                                ,Not Adjusted,15697,16316,619,3.8
13417,2018,June,Brown                                                ,Not Adjusted,15406,16067,661,4.1
13418,2018,September,Brown                                                ,Not Adjusted,15370,15951,581,3.6
13419,2018,December,Brown                                                ,Not Adjusted,15234,15778,544,3.4
13420,2018,March,Burleson                                             ,Not Adjusted,8054,8370,316,3.8
13421,2018,June,Burleson                                             ,Not Adjusted,7648,7983,335,4.2
13422,2018,September,Burleson                                             ,Not Adjusted,8021,8305,284,3.4
13423,2018,December,Burleson                                             ,Not Adjusted,8028,8291,263,3.2
13424,2018,March,Burnet                                               ,Not Adjusted,22313,23009,696,3.0
13425,2018,June,Burnet                                               ,Not Adjusted,22459,23176,717,3.1
13426,2018,September,Burnet                                               ,Not Adjusted,22134,22802,668,2.9
13427,2018,December,Burnet                                               ,Not Adjusted,22155,22793,638,2.8
13428,2018,March,Caldwell                                             ,Not Adjusted,18266,19017,751,3.9
13429,2018,June,Caldwell                                             ,Not Adjusted,18399,19182,783,4.1
13430,2018,September,Caldwell                                             ,Not Adjusted,18423,19114,691,3.6
13431,2018,December,Caldwell                                             ,Not Adjusted,18623,19297,674,3.5
13432,2018,March,Calhoun                                              ,Not Adjusted,10750,11254,504,4.5
13433,2018,June,Calhoun                                              ,Not Adjusted,10708,11211,503,4.5
13434,2018,September,Calhoun                                              ,Not Adjusted,10819,11224,405,3.6
13435,2018,December,Calhoun                                              ,Not Adjusted,11113,11525,412,3.6
13436,2018,March,Callahan                                             ,Not Adjusted,5792,6007,215,3.6
13437,2018,June,Callahan                                             ,Not Adjusted,5773,5983,210,3.5
13438,2018,September,Callahan                                             ,Not Adjusted,5768,5963,195,3.3
13439,2018,December,Callahan                                             ,Not Adjusted,5814,6012,198,3.3
13440,2018,March,Cameron                                              ,Not Adjusted,156330,166930,10600,6.3
13441,2018,June,Cameron                                              ,Not Adjusted,155561,167271,11710,7.0
13442,2018,September,Cameron                                              ,Not Adjusted,154276,163741,9465,5.8
13443,2018,December,Cameron                                              ,Not Adjusted,156440,166072,9632,5.8
13444,2018,March,Camp                                                 ,Not Adjusted,4831,5083,252,5.0
13445,2018,June,Camp                                                 ,Not Adjusted,4745,5009,264,5.3
13446,2018,September,Camp                                                 ,Not Adjusted,4716,4963,247,5.0
13447,2018,December,Camp                                                 ,Not Adjusted,4698,4925,227,4.6
13448,2018,March,Carson                                               ,Not Adjusted,2962,3050,88,2.9
13449,2018,June,Carson                                               ,Not Adjusted,2916,3012,96,3.2
13450,2018,September,Carson                                               ,Not Adjusted,2905,2986,81,2.7
13451,2018,December,Carson                                               ,Not Adjusted,2864,2938,74,2.5
13452,2018,March,Cass                                                 ,Not Adjusted,11713,12343,630,5.1
13453,2018,June,Cass                                                 ,Not Adjusted,11804,12482,678,5.4
13454,2018,September,Cass                                                 ,Not Adjusted,11719,12329,610,4.9
13455,2018,December,Cass                                                 ,Not Adjusted,11654,12228,574,4.7
13456,2018,March,Castro                                               ,Not Adjusted,3509,3612,103,2.9
13457,2018,June,Castro                                               ,Not Adjusted,3514,3625,111,3.1
13458,2018,September,Castro                                               ,Not Adjusted,3343,3438,95,2.8
13459,2018,December,Castro                                               ,Not Adjusted,3182,3280,98,3.0
13460,2018,March,Chambers                                             ,Not Adjusted,18145,19230,1085,5.6
13461,2018,June,Chambers                                             ,Not Adjusted,18198,19327,1129,5.8
13462,2018,September,Chambers                                             ,Not Adjusted,18235,19226,991,5.2
13463,2018,December,Chambers                                             ,Not Adjusted,18441,19396,955,4.9
13464,2018,March,Cherokee                                             ,Not Adjusted,20195,21077,882,4.2
13465,2018,June,Cherokee                                             ,Not Adjusted,20026,20964,938,4.5
13466,2018,September,Cherokee                                             ,Not Adjusted,19922,20746,824,4.0
13467,2018,December,Cherokee                                             ,Not Adjusted,20143,20985,842,4.0
13468,2018,March,Childress                                            ,Not Adjusted,2857,2942,85,2.9
13469,2018,June,Childress                                            ,Not Adjusted,2932,3015,83,2.8
13470,2018,September,Childress                                            ,Not Adjusted,2903,2980,77,2.6
13471,2018,December,Childress                                            ,Not Adjusted,2794,2862,68,2.4
13472,2018,March,Clay                                                 ,Not Adjusted,4809,4981,172,3.5
13473,2018,June,Clay                                                 ,Not Adjusted,4792,4969,177,3.6
13474,2018,September,Clay                                                 ,Not Adjusted,4741,4883,142,2.9
13475,2018,December,Clay                                                 ,Not Adjusted,4736,4889,153,3.1
13476,2018,March,Cochran                                              ,Not Adjusted,1103,1159,56,4.8
13477,2018,June,Cochran                                              ,Not Adjusted,1090,1149,59,5.1
13478,2018,September,Cochran                                              ,Not Adjusted,1074,1118,44,3.9
13479,2018,December,Cochran                                              ,Not Adjusted,979,1017,38,3.7
13480,2018,March,Coke                                                 ,Not Adjusted,1398,1445,47,3.3
13481,2018,June,Coke                                                 ,Not Adjusted,1425,1481,56,3.8
13482,2018,September,Coke                                                 ,Not Adjusted,1428,1477,49,3.3
13483,2018,December,Coke                                                 ,Not Adjusted,1391,1434,43,3.0
13484,2018,March,Coleman                                              ,Not Adjusted,2916,3034,118,3.9
13485,2018,June,Coleman                                              ,Not Adjusted,2867,2991,124,4.1
13486,2018,September,Coleman                                              ,Not Adjusted,2786,2903,117,4.0
13487,2018,December,Coleman                                              ,Not Adjusted,2755,2871,116,4.0
13488,2018,March,Collin                                               ,Not Adjusted,528455,547595,19140,3.5
13489,2018,June,Collin                                               ,Not Adjusted,531749,552007,20258,3.7
13490,2018,September,Collin                                               ,Not Adjusted,533721,551897,18176,3.3
13491,2018,December,Collin                                               ,Not Adjusted,539610,557206,17596,3.2
13492,2018,March,Collingsworth                                        ,Not Adjusted,1161,1197,36,3.0
13493,2018,June,Collingsworth                                        ,Not Adjusted,1164,1203,39,3.2
13494,2018,September,Collingsworth                                        ,Not Adjusted,1155,1195,40,3.3
13495,2018,December,Collingsworth                                        ,Not Adjusted,1112,1147,35,3.1
13496,2018,March,Colorado                                             ,Not Adjusted,9341,9684,343,3.5
13497,2018,June,Colorado                                             ,Not Adjusted,9521,9861,340,3.4
13498,2018,September,Colorado                                             ,Not Adjusted,9339,9648,309,3.2
13499,2018,December,Colorado                                             ,Not Adjusted,9330,9628,298,3.1
13500,2018,March,Comal                                                ,Not Adjusted,69835,72265,2430,3.4
13501,2018,June,Comal                                                ,Not Adjusted,70071,72638,2567,3.5
13502,2018,September,Comal                                                ,Not Adjusted,70062,72344,2282,3.2
13503,2018,December,Comal                                                ,Not Adjusted,70548,72772,2224,3.1
13504,2018,March,Comanche                                             ,Not Adjusted,5247,5451,204,3.7
13505,2018,June,Comanche                                             ,Not Adjusted,5235,5446,211,3.9
13506,2018,September,Comanche                                             ,Not Adjusted,5178,5361,183,3.4
13507,2018,December,Comanche                                             ,Not Adjusted,5120,5304,184,3.5
13508,2018,March,Concho                                               ,Not Adjusted,1138,1178,40,3.4
13509,2018,June,Concho                                               ,Not Adjusted,1071,1114,43,3.9
13510,2018,September,Concho                                               ,Not Adjusted,1068,1109,41,3.7
13511,2018,December,Concho                                               ,Not Adjusted,981,1017,36,3.5
13512,2018,March,Cooke                                                ,Not Adjusted,18470,19107,637,3.3
13513,2018,June,Cooke                                                ,Not Adjusted,18582,19234,652,3.4
13514,2018,September,Cooke                                                ,Not Adjusted,18642,19217,575,3.0
13515,2018,December,Cooke                                                ,Not Adjusted,18791,19339,548,2.8
13516,2018,March,Coryell                                              ,Not Adjusted,22819,23822,1003,4.2
13517,2018,June,Coryell                                              ,Not Adjusted,22750,23866,1116,4.7
13518,2018,September,Coryell                                              ,Not Adjusted,22879,23861,982,4.1
13519,2018,December,Coryell                                              ,Not Adjusted,23009,23999,990,4.1
13520,2018,March,Cottle                                               ,Not Adjusted,510,536,26,4.9
13521,2018,June,Cottle                                               ,Not Adjusted,516,540,24,4.4
13522,2018,September,Cottle                                               ,Not Adjusted,504,526,22,4.2
13523,2018,December,Cottle                                               ,Not Adjusted,517,539,22,4.1
13524,2018,March,Crane                                                ,Not Adjusted,1643,1718,75,4.4
13525,2018,June,Crane                                                ,Not Adjusted,1749,1827,78,4.3
13526,2018,September,Crane                                                ,Not Adjusted,1758,1820,62,3.4
13527,2018,December,Crane                                                ,Not Adjusted,1754,1813,59,3.3
13528,2018,March,Crockett                                             ,Not Adjusted,1592,1644,52,3.2
13529,2018,June,Crockett                                             ,Not Adjusted,1600,1652,52,3.1
13530,2018,September,Crockett                                             ,Not Adjusted,1584,1630,46,2.8
13531,2018,December,Crockett                                             ,Not Adjusted,1563,1605,42,2.6
13532,2018,March,Crosby                                               ,Not Adjusted,2438,2560,122,4.8
13533,2018,June,Crosby                                               ,Not Adjusted,2389,2523,134,5.3
13534,2018,September,Crosby                                               ,Not Adjusted,2380,2498,118,4.7
13535,2018,December,Crosby                                               ,Not Adjusted,2294,2395,101,4.2
13536,2018,March,Culberson                                            ,Not Adjusted,940,972,32,3.3
13537,2018,June,Culberson                                            ,Not Adjusted,943,975,32,3.3
13538,2018,September,Culberson                                            ,Not Adjusted,942,972,30,3.1
13539,2018,December,Culberson                                            ,Not Adjusted,955,990,35,3.5
13540,2018,March,Dallam                                               ,Not Adjusted,4046,4132,86,2.1
13541,2018,June,Dallam                                               ,Not Adjusted,4038,4134,96,2.3
13542,2018,September,Dallam                                               ,Not Adjusted,3935,4013,78,1.9
13543,2018,December,Dallam                                               ,Not Adjusted,3773,3858,85,2.2
13544,2018,March,Dallas                                               ,Not Adjusted,1275286,1326902,51616,3.9
13545,2018,June,Dallas                                               ,Not Adjusted,1282582,1338570,55988,4.2
13546,2018,September,Dallas                                               ,Not Adjusted,1287007,1337275,50268,3.8
13547,2018,December,Dallas                                               ,Not Adjusted,1302071,1350401,48330,3.6
13548,2018,March,Dawson                                               ,Not Adjusted,4406,4598,192,4.2
13549,2018,June,Dawson                                               ,Not Adjusted,4426,4647,221,4.8
13550,2018,September,Dawson                                               ,Not Adjusted,4287,4497,210,4.7
13551,2018,December,Dawson                                               ,Not Adjusted,4315,4493,178,4.0
13552,2018,March,Deaf Smith                                           ,Not Adjusted,8416,8664,248,2.9
13553,2018,June,Deaf Smith                                           ,Not Adjusted,8294,8568,274,3.2
13554,2018,September,Deaf Smith                                           ,Not Adjusted,8208,8438,230,2.7
13555,2018,December,Deaf Smith                                           ,Not Adjusted,7938,8164,226,2.8
13556,2018,March,Delta                                                ,Not Adjusted,2383,2468,85,3.4
13557,2018,June,Delta                                                ,Not Adjusted,2366,2455,89,3.6
13558,2018,September,Delta                                                ,Not Adjusted,2353,2443,90,3.7
13559,2018,December,Delta                                                ,Not Adjusted,2342,2427,85,3.5
13560,2018,March,Denton                                               ,Not Adjusted,463968,480277,16309,3.4
13561,2018,June,Denton                                               ,Not Adjusted,467109,484195,17086,3.5
13562,2018,September,Denton                                               ,Not Adjusted,468960,484368,15408,3.2
13563,2018,December,Denton                                               ,Not Adjusted,473933,488596,14663,3.0
13564,2018,March,DeWitt                                               ,Not Adjusted,9499,9816,317,3.2
13565,2018,June,DeWitt                                               ,Not Adjusted,9475,9807,332,3.4
13566,2018,September,DeWitt                                               ,Not Adjusted,9349,9646,297,3.1
13567,2018,December,DeWitt                                               ,Not Adjusted,9219,9497,278,2.9
13568,2018,March,Dickens                                              ,Not Adjusted,660,690,30,4.3
13569,2018,June,Dickens                                              ,Not Adjusted,669,701,32,4.6
13570,2018,September,Dickens                                              ,Not Adjusted,642,670,28,4.2
13571,2018,December,Dickens                                              ,Not Adjusted,613,640,27,4.2
13572,2018,March,Dimmit                                               ,Not Adjusted,6896,7124,228,3.2
13573,2018,June,Dimmit                                               ,Not Adjusted,7181,7467,286,3.8
13574,2018,September,Dimmit                                               ,Not Adjusted,7329,7521,192,2.6
13575,2018,December,Dimmit                                               ,Not Adjusted,7213,7403,190,2.6
13576,2018,March,Donley                                               ,Not Adjusted,1471,1519,48,3.2
13577,2018,June,Donley                                               ,Not Adjusted,1685,1753,68,3.9
13578,2018,September,Donley                                               ,Not Adjusted,1477,1532,55,3.6
13579,2018,December,Donley                                               ,Not Adjusted,1422,1477,55,3.7
13580,2018,March,Duval                                                ,Not Adjusted,4784,5058,274,5.4
13581,2018,June,Duval                                                ,Not Adjusted,4789,5085,296,5.8
13582,2018,September,Duval                                                ,Not Adjusted,4812,5084,272,5.4
13583,2018,December,Duval                                                ,Not Adjusted,4855,5089,234,4.6
13584,2018,March,Eastland                                             ,Not Adjusted,8333,8633,300,3.5
13585,2018,June,Eastland                                             ,Not Adjusted,8419,8765,346,3.9
13586,2018,September,Eastland                                             ,Not Adjusted,8569,8847,278,3.1
13587,2018,December,Eastland                                             ,Not Adjusted,8581,8849,268,3.0
13588,2018,March,Ector                                                ,Not Adjusted,81156,83613,2457,2.9
13589,2018,June,Ector                                                ,Not Adjusted,82976,85532,2556,3.0
13590,2018,September,Ector                                                ,Not Adjusted,84994,87201,2207,2.5
13591,2018,December,Ector                                                ,Not Adjusted,86280,88418,2138,2.4
13592,2018,March,Edwards                                              ,Not Adjusted,874,900,26,2.9
13593,2018,June,Edwards                                              ,Not Adjusted,870,897,27,3.0
13594,2018,September,Edwards                                              ,Not Adjusted,862,886,24,2.7
13595,2018,December,Edwards                                              ,Not Adjusted,849,875,26,3.0
13596,2018,March,Ellis                                                ,Not Adjusted,87031,90162,3131,3.5
13597,2018,June,Ellis                                                ,Not Adjusted,87476,90904,3428,3.8
13598,2018,September,Ellis                                                ,Not Adjusted,87759,90725,2966,3.3
13599,2018,December,Ellis                                                ,Not Adjusted,88696,91592,2896,3.2
13600,2018,March,El Paso                                              ,Not Adjusted,341736,357262,15526,4.3
13601,2018,June,El Paso                                              ,Not Adjusted,338604,355164,16560,4.7
13602,2018,September,El Paso                                              ,Not Adjusted,343575,358590,15015,4.2
13603,2018,December,El Paso                                              ,Not Adjusted,347165,361523,14358,4.0
13604,2018,March,Erath                                                ,Not Adjusted,20762,21397,635,3.0
13605,2018,June,Erath                                                ,Not Adjusted,19854,20604,750,3.6
13606,2018,September,Erath                                                ,Not Adjusted,20031,20663,632,3.1
13607,2018,December,Erath                                                ,Not Adjusted,20269,20898,629,3.0
13608,2018,March,Falls                                                ,Not Adjusted,6271,6529,258,4.0
13609,2018,June,Falls                                                ,Not Adjusted,6279,6574,295,4.5
13610,2018,September,Falls                                                ,Not Adjusted,6281,6526,245,3.8
13611,2018,December,Falls                                                ,Not Adjusted,6238,6464,226,3.5
13612,2018,March,Fannin                                               ,Not Adjusted,15684,16205,521,3.2
13613,2018,June,Fannin                                               ,Not Adjusted,15777,16326,549,3.4
13614,2018,September,Fannin                                               ,Not Adjusted,16215,16716,501,3.0
13615,2018,December,Fannin                                               ,Not Adjusted,16265,16751,486,2.9
13616,2018,March,Fayette                                              ,Not Adjusted,12319,12698,379,3.0
13617,2018,June,Fayette                                              ,Not Adjusted,12256,12645,389,3.1
13618,2018,September,Fayette                                              ,Not Adjusted,12235,12578,343,2.7
13619,2018,December,Fayette                                              ,Not Adjusted,12201,12521,320,2.6
13620,2018,March,Fisher                                               ,Not Adjusted,1638,1693,55,3.2
13621,2018,June,Fisher                                               ,Not Adjusted,1596,1653,57,3.4
13622,2018,September,Fisher                                               ,Not Adjusted,1598,1650,52,3.2
13623,2018,December,Fisher                                               ,Not Adjusted,1531,1579,48,3.0
13624,2018,March,Floyd                                                ,Not Adjusted,2630,2786,156,5.6
13625,2018,June,Floyd                                                ,Not Adjusted,2565,2716,151,5.6
13626,2018,September,Floyd                                                ,Not Adjusted,2483,2619,136,5.2
13627,2018,December,Floyd                                                ,Not Adjusted,2389,2509,120,4.8
13628,2018,March,Foard                                                ,Not Adjusted,571,587,16,2.7
13629,2018,June,Foard                                                ,Not Adjusted,580,602,22,3.7
13630,2018,September,Foard                                                ,Not Adjusted,546,562,16,2.8
13631,2018,December,Foard                                                ,Not Adjusted,551,568,17,3.0
13632,2018,March,Fort Bend                                            ,Not Adjusted,369649,385514,15865,4.1
13633,2018,June,Fort Bend                                            ,Not Adjusted,370485,387248,16763,4.3
13634,2018,September,Fort Bend                                            ,Not Adjusted,371115,386049,14934,3.9
13635,2018,December,Fort Bend                                            ,Not Adjusted,375435,389667,14232,3.7
13636,2018,March,Franklin                                             ,Not Adjusted,4439,4641,202,4.4
13637,2018,June,Franklin                                             ,Not Adjusted,4418,4619,201,4.4
13638,2018,September,Franklin                                             ,Not Adjusted,4354,4543,189,4.2
13639,2018,December,Franklin                                             ,Not Adjusted,4308,4484,176,3.9
13640,2018,March,Freestone                                            ,Not Adjusted,6366,6793,427,6.3
13641,2018,June,Freestone                                            ,Not Adjusted,6185,6616,431,6.5
13642,2018,September,Freestone                                            ,Not Adjusted,6113,6493,380,5.9
13643,2018,December,Freestone                                            ,Not Adjusted,6068,6401,333,5.2
13644,2018,March,Frio                                                 ,Not Adjusted,9616,9914,298,3.0
13645,2018,June,Frio                                                 ,Not Adjusted,10053,10371,318,3.1
13646,2018,September,Frio                                                 ,Not Adjusted,10157,10444,287,2.7
13647,2018,December,Frio                                                 ,Not Adjusted,9895,10171,276,2.7
13648,2018,March,Gaines                                               ,Not Adjusted,9340,9584,244,2.5
13649,2018,June,Gaines                                               ,Not Adjusted,9067,9353,286,3.1
13650,2018,September,Gaines                                               ,Not Adjusted,9246,9482,236,2.5
13651,2018,December,Gaines                                               ,Not Adjusted,9103,9334,231,2.5
13652,2018,March,Galveston                                            ,Not Adjusted,155118,162812,7694,4.7
13653,2018,June,Galveston                                            ,Not Adjusted,155418,163698,8280,5.1
13654,2018,September,Galveston                                            ,Not Adjusted,155665,163048,7383,4.5
13655,2018,December,Galveston                                            ,Not Adjusted,157351,164606,7255,4.4
13656,2018,March,Garza                                                ,Not Adjusted,2111,2180,69,3.2
13657,2018,June,Garza                                                ,Not Adjusted,2074,2144,70,3.3
13658,2018,September,Garza                                                ,Not Adjusted,2041,2103,62,2.9
13659,2018,December,Garza                                                ,Not Adjusted,2076,2131,55,2.6
13660,2018,March,Gillespie                                            ,Not Adjusted,13088,13442,354,2.6
13661,2018,June,Gillespie                                            ,Not Adjusted,13193,13555,362,2.7
13662,2018,September,Gillespie                                            ,Not Adjusted,12915,13258,343,2.6
13663,2018,December,Gillespie                                            ,Not Adjusted,13045,13388,343,2.6
13664,2018,March,Glasscock                                            ,Not Adjusted,854,872,18,2.1
13665,2018,June,Glasscock                                            ,Not Adjusted,837,856,19,2.2
13666,2018,September,Glasscock                                            ,Not Adjusted,886,904,18,2.0
13667,2018,December,Glasscock                                            ,Not Adjusted,788,804,16,2.0
13668,2018,March,Goliad                                               ,Not Adjusted,3170,3310,140,4.2
13669,2018,June,Goliad                                               ,Not Adjusted,3155,3289,134,4.1
13670,2018,September,Goliad                                               ,Not Adjusted,3157,3275,118,3.6
13671,2018,December,Goliad                                               ,Not Adjusted,3156,3266,110,3.4
13672,2018,March,Gonzales                                             ,Not Adjusted,9361,9668,307,3.2
13673,2018,June,Gonzales                                             ,Not Adjusted,9209,9534,325,3.4
13674,2018,September,Gonzales                                             ,Not Adjusted,9372,9651,279,2.9
13675,2018,December,Gonzales                                             ,Not Adjusted,8968,9228,260,2.8
13676,2018,March,Gray                                                 ,Not Adjusted,7836,8175,339,4.1
13677,2018,June,Gray                                                 ,Not Adjusted,7966,8296,330,4.0
13678,2018,September,Gray                                                 ,Not Adjusted,7809,8113,304,3.7
13679,2018,December,Gray                                                 ,Not Adjusted,7718,8002,284,3.5
13680,2018,March,Grayson                                              ,Not Adjusted,60520,62682,2162,3.4
13681,2018,June,Grayson                                              ,Not Adjusted,60997,63316,2319,3.7
13682,2018,September,Grayson                                              ,Not Adjusted,61124,63168,2044,3.2
13683,2018,December,Grayson                                              ,Not Adjusted,61709,63665,1956,3.1
13684,2018,March,Gregg                                                ,Not Adjusted,55132,57596,2464,4.3
13685,2018,June,Gregg                                                ,Not Adjusted,55101,57661,2560,4.4
13686,2018,September,Gregg                                                ,Not Adjusted,55167,57454,2287,4.0
13687,2018,December,Gregg                                                ,Not Adjusted,55217,57445,2228,3.9
13688,2018,March,Grimes                                               ,Not Adjusted,10685,11180,495,4.4
13689,2018,June,Grimes                                               ,Not Adjusted,10543,11069,526,4.8
13690,2018,September,Grimes                                               ,Not Adjusted,10698,11138,440,4.0
13691,2018,December,Grimes                                               ,Not Adjusted,10683,11078,395,3.6
13692,2018,March,Guadalupe                                            ,Not Adjusted,77337,79878,2541,3.2
13693,2018,June,Guadalupe                                            ,Not Adjusted,77837,80620,2783,3.5
13694,2018,September,Guadalupe                                            ,Not Adjusted,77934,80444,2510,3.1
13695,2018,December,Guadalupe                                            ,Not Adjusted,78236,80704,2468,3.1
13696,2018,March,Hale                                                 ,Not Adjusted,12154,12814,660,5.2
13697,2018,June,Hale                                                 ,Not Adjusted,11852,12606,754,6.0
13698,2018,September,Hale                                                 ,Not Adjusted,11860,12443,583,4.7
13699,2018,December,Hale                                                 ,Not Adjusted,11599,12144,545,4.5
13700,2018,March,Hall                                                 ,Not Adjusted,1081,1140,59,5.2
13701,2018,June,Hall                                                 ,Not Adjusted,1081,1134,53,4.7
13702,2018,September,Hall                                                 ,Not Adjusted,1071,1115,44,3.9
13703,2018,December,Hall                                                 ,Not Adjusted,1013,1055,42,4.0
13704,2018,March,Hamilton                                             ,Not Adjusted,3487,3612,125,3.5
13705,2018,June,Hamilton                                             ,Not Adjusted,3513,3652,139,3.8
13706,2018,September,Hamilton                                             ,Not Adjusted,3557,3665,108,2.9
13707,2018,December,Hamilton                                             ,Not Adjusted,3534,3641,107,2.9
13708,2018,March,Hansford                                             ,Not Adjusted,2858,2925,67,2.3
13709,2018,June,Hansford                                             ,Not Adjusted,2834,2907,73,2.5
13710,2018,September,Hansford                                             ,Not Adjusted,2807,2869,62,2.2
13711,2018,December,Hansford                                             ,Not Adjusted,2686,2754,68,2.5
13712,2018,March,Hardeman                                             ,Not Adjusted,1624,1693,69,4.1
13713,2018,June,Hardeman                                             ,Not Adjusted,1618,1681,63,3.7
13714,2018,September,Hardeman                                             ,Not Adjusted,1634,1696,62,3.7
13715,2018,December,Hardeman                                             ,Not Adjusted,1590,1644,54,3.3
13716,2018,March,Hardin                                               ,Not Adjusted,24032,25434,1402,5.5
13717,2018,June,Hardin                                               ,Not Adjusted,24112,25520,1408,5.5
13718,2018,September,Hardin                                               ,Not Adjusted,24066,25295,1229,4.9
13719,2018,December,Hardin                                               ,Not Adjusted,24016,25249,1233,4.9
13720,2018,March,Harris                                               ,Not Adjusted,2177800,2282561,104761,4.6
13721,2018,June,Harris                                               ,Not Adjusted,2181147,2290245,109098,4.8
13722,2018,September,Harris                                               ,Not Adjusted,2184100,2281540,97440,4.3
13723,2018,December,Harris                                               ,Not Adjusted,2210877,2304211,93334,4.1
13724,2018,March,Harrison                                             ,Not Adjusted,28716,30073,1357,4.5
13725,2018,June,Harrison                                             ,Not Adjusted,28784,30221,1437,4.8
13726,2018,September,Harrison                                             ,Not Adjusted,28718,29981,1263,4.2
13727,2018,December,Harrison                                             ,Not Adjusted,28294,29514,1220,4.1
13728,2018,March,Hartley                                              ,Not Adjusted,2884,2938,54,1.8
13729,2018,June,Hartley                                              ,Not Adjusted,2861,2917,56,1.9
13730,2018,September,Hartley                                              ,Not Adjusted,2788,2846,58,2.0
13731,2018,December,Hartley                                              ,Not Adjusted,2682,2731,49,1.8
13732,2018,March,Haskell                                              ,Not Adjusted,2357,2456,99,4.0
13733,2018,June,Haskell                                              ,Not Adjusted,2290,2392,102,4.3
13734,2018,September,Haskell                                              ,Not Adjusted,2254,2338,84,3.6
13735,2018,December,Haskell                                              ,Not Adjusted,2181,2259,78,3.5
13736,2018,March,Hays                                                 ,Not Adjusted,111749,115212,3463,3.0
13737,2018,June,Hays                                                 ,Not Adjusted,112721,116607,3886,3.3
13738,2018,September,Hays                                                 ,Not Adjusted,112923,116354,3431,2.9
13739,2018,December,Hays                                                 ,Not Adjusted,114341,117694,3353,2.8
13740,2018,March,Hemphill                                             ,Not Adjusted,2353,2407,54,2.2
13741,2018,June,Hemphill                                             ,Not Adjusted,2115,2168,53,2.4
13742,2018,September,Hemphill                                             ,Not Adjusted,2257,2300,43,1.9
13743,2018,December,Hemphill                                             ,Not Adjusted,2153,2195,42,1.9
13744,2018,March,Henderson                                            ,Not Adjusted,35009,36439,1430,3.9
13745,2018,June,Henderson                                            ,Not Adjusted,34903,36447,1544,4.2
13746,2018,September,Henderson                                            ,Not Adjusted,34726,36055,1329,3.7
13747,2018,December,Henderson                                            ,Not Adjusted,34649,35971,1322,3.7
13748,2018,March,Hidalgo                                              ,Not Adjusted,327417,350967,23550,6.7
13749,2018,June,Hidalgo                                              ,Not Adjusted,323230,348504,25274,7.3
13750,2018,September,Hidalgo                                              ,Not Adjusted,321875,343180,21305,6.2
13751,2018,December,Hidalgo                                              ,Not Adjusted,328773,352429,23656,6.7
13752,2018,March,Hill                                                 ,Not Adjusted,15804,16404,600,3.7
13753,2018,June,Hill                                                 ,Not Adjusted,15647,16315,668,4.1
13754,2018,September,Hill                                                 ,Not Adjusted,15796,16385,589,3.6
13755,2018,December,Hill                                                 ,Not Adjusted,15657,16221,564,3.5
13756,2018,March,Hockley                                              ,Not Adjusted,11189,11584,395,3.4
13757,2018,June,Hockley                                              ,Not Adjusted,11079,11486,407,3.5
13758,2018,September,Hockley                                              ,Not Adjusted,11098,11438,340,3.0
13759,2018,December,Hockley                                              ,Not Adjusted,10869,11199,330,2.9
13760,2018,March,Hood                                                 ,Not Adjusted,25965,27012,1047,3.9
13761,2018,June,Hood                                                 ,Not Adjusted,26024,27126,1102,4.1
13762,2018,September,Hood                                                 ,Not Adjusted,26088,27042,954,3.5
13763,2018,December,Hood                                                 ,Not Adjusted,26315,27244,929,3.4
13764,2018,March,Hopkins                                              ,Not Adjusted,16869,17491,622,3.6
13765,2018,June,Hopkins                                              ,Not Adjusted,16794,17439,645,3.7
13766,2018,September,Hopkins                                              ,Not Adjusted,16751,17326,575,3.3
13767,2018,December,Hopkins                                              ,Not Adjusted,16728,17273,545,3.2
13768,2018,March,Houston                                              ,Not Adjusted,9824,10253,429,4.2
13769,2018,June,Houston                                              ,Not Adjusted,9883,10305,422,4.1
13770,2018,September,Houston                                              ,Not Adjusted,9810,10157,347,3.4
13771,2018,December,Houston                                              ,Not Adjusted,9893,10227,334,3.3
13772,2018,March,Howard                                               ,Not Adjusted,13189,13702,513,3.7
13773,2018,June,Howard                                               ,Not Adjusted,13108,13621,513,3.8
13774,2018,September,Howard                                               ,Not Adjusted,13234,13656,422,3.1
13775,2018,December,Howard                                               ,Not Adjusted,13286,13685,399,2.9
13776,2018,March,Hudspeth                                             ,Not Adjusted,1753,1841,88,4.8
13777,2018,June,Hudspeth                                             ,Not Adjusted,1715,1804,89,4.9
13778,2018,September,Hudspeth                                             ,Not Adjusted,1729,1807,78,4.3
13779,2018,December,Hudspeth                                             ,Not Adjusted,1692,1767,75,4.2
13780,2018,March,Hunt                                                 ,Not Adjusted,40623,42274,1651,3.9
13781,2018,June,Hunt                                                 ,Not Adjusted,40797,42609,1812,4.3
13782,2018,September,Hunt                                                 ,Not Adjusted,40913,42526,1613,3.8
13783,2018,December,Hunt                                                 ,Not Adjusted,41327,42901,1574,3.7
13784,2018,March,Hutchinson                                           ,Not Adjusted,8749,9207,458,5.0
13785,2018,June,Hutchinson                                           ,Not Adjusted,8599,9105,506,5.6
13786,2018,September,Hutchinson                                           ,Not Adjusted,8446,8870,424,4.8
13787,2018,December,Hutchinson                                           ,Not Adjusted,8419,8823,404,4.6
13788,2018,March,Irion                                                ,Not Adjusted,760,786,26,3.3
13789,2018,June,Irion                                                ,Not Adjusted,744,773,29,3.8
13790,2018,September,Irion                                                ,Not Adjusted,743,765,22,2.9
13791,2018,December,Irion                                                ,Not Adjusted,729,751,22,2.9
13792,2018,March,Jack                                                 ,Not Adjusted,4194,4308,114,2.6
13793,2018,June,Jack                                                 ,Not Adjusted,4460,4581,121,2.6
13794,2018,September,Jack                                                 ,Not Adjusted,4316,4419,103,2.3
13795,2018,December,Jack                                                 ,Not Adjusted,4126,4224,98,2.3
13796,2018,March,Jackson                                              ,Not Adjusted,7131,7392,261,3.5
13797,2018,June,Jackson                                              ,Not Adjusted,7174,7440,266,3.6
13798,2018,September,Jackson                                              ,Not Adjusted,7140,7373,233,3.2
13799,2018,December,Jackson                                              ,Not Adjusted,7097,7320,223,3.0
13800,2018,March,Jasper                                               ,Not Adjusted,12590,13489,899,6.7
13801,2018,June,Jasper                                               ,Not Adjusted,12550,13457,907,6.7
13802,2018,September,Jasper                                               ,Not Adjusted,12346,13138,792,6.0
13803,2018,December,Jasper                                               ,Not Adjusted,12078,12934,856,6.6
13804,2018,March,Jeff Davis                                           ,Not Adjusted,1069,1101,32,2.9
13805,2018,June,Jeff Davis                                           ,Not Adjusted,1080,1113,33,3.0
13806,2018,September,Jeff Davis                                           ,Not Adjusted,1047,1078,31,2.9
13807,2018,December,Jeff Davis                                           ,Not Adjusted,977,1006,29,2.9
13808,2018,March,Jefferson                                            ,Not Adjusted,100282,107502,7220,6.7
13809,2018,June,Jefferson                                            ,Not Adjusted,100560,107647,7087,6.6
13810,2018,September,Jefferson                                            ,Not Adjusted,100342,106824,6482,6.1
13811,2018,December,Jefferson                                            ,Not Adjusted,100157,106677,6520,6.1
13812,2018,March,Jim Hogg                                             ,Not Adjusted,1758,1865,107,5.7
13813,2018,June,Jim Hogg                                             ,Not Adjusted,1755,1868,113,6.0
13814,2018,September,Jim Hogg                                             ,Not Adjusted,1776,1884,108,5.7
13815,2018,December,Jim Hogg                                             ,Not Adjusted,1819,1923,104,5.4
13816,2018,March,Jim Wells                                            ,Not Adjusted,16085,17082,997,5.8
13817,2018,June,Jim Wells                                            ,Not Adjusted,16120,17140,1020,6.0
13818,2018,September,Jim Wells                                            ,Not Adjusted,16158,17009,851,5.0
13819,2018,December,Jim Wells                                            ,Not Adjusted,16030,16839,809,4.8
13820,2018,March,Johnson                                              ,Not Adjusted,77082,79925,2843,3.6
13821,2018,June,Johnson                                              ,Not Adjusted,77590,80672,3082,3.8
13822,2018,September,Johnson                                              ,Not Adjusted,77927,80623,2696,3.3
13823,2018,December,Johnson                                              ,Not Adjusted,78610,81269,2659,3.3
13824,2018,March,Jones                                                ,Not Adjusted,5380,5653,273,4.8
13825,2018,June,Jones                                                ,Not Adjusted,5361,5645,284,5.0
13826,2018,September,Jones                                                ,Not Adjusted,5357,5627,270,4.8
13827,2018,December,Jones                                                ,Not Adjusted,5330,5583,253,4.5
13828,2018,March,Karnes                                               ,Not Adjusted,6462,6672,210,3.1
13829,2018,June,Karnes                                               ,Not Adjusted,6680,6900,220,3.2
13830,2018,September,Karnes                                               ,Not Adjusted,6710,6899,189,2.7
13831,2018,December,Karnes                                               ,Not Adjusted,6798,6977,179,2.6
13832,2018,March,Kaufman                                              ,Not Adjusted,60404,62642,2238,3.6
13833,2018,June,Kaufman                                              ,Not Adjusted,60811,63256,2445,3.9
13834,2018,September,Kaufman                                              ,Not Adjusted,61054,63249,2195,3.5
13835,2018,December,Kaufman                                              ,Not Adjusted,61669,63807,2138,3.4
13836,2018,March,Kendall                                              ,Not Adjusted,21284,21934,650,3.0
13837,2018,June,Kendall                                              ,Not Adjusted,21254,21948,694,3.2
13838,2018,September,Kendall                                              ,Not Adjusted,21213,21850,637,2.9
13839,2018,December,Kendall                                              ,Not Adjusted,21258,21883,625,2.9
13840,2018,March,Kenedy                                               ,Not Adjusted,244,254,10,3.9
13841,2018,June,Kenedy                                               ,Not Adjusted,241,254,13,5.1
13842,2018,September,Kenedy                                               ,Not Adjusted,243,252,9,3.6
13843,2018,December,Kenedy                                               ,Not Adjusted,233,243,10,4.1
13844,2018,March,Kent                                                 ,Not Adjusted,431,445,14,3.1
13845,2018,June,Kent                                                 ,Not Adjusted,472,482,10,2.1
13846,2018,September,Kent                                                 ,Not Adjusted,450,460,10,2.2
13847,2018,December,Kent                                                 ,Not Adjusted,404,414,10,2.4
13848,2018,March,Kerr                                                 ,Not Adjusted,20850,21591,741,3.4
13849,2018,June,Kerr                                                 ,Not Adjusted,21468,22245,777,3.5
13850,2018,September,Kerr                                                 ,Not Adjusted,20940,21649,709,3.3
13851,2018,December,Kerr                                                 ,Not Adjusted,21255,21902,647,3.0
13852,2018,March,Kimble                                               ,Not Adjusted,1860,1918,58,3.0
13853,2018,June,Kimble                                               ,Not Adjusted,1871,1933,62,3.2
13854,2018,September,Kimble                                               ,Not Adjusted,1789,1841,52,2.8
13855,2018,December,Kimble                                               ,Not Adjusted,1760,1818,58,3.2
13856,2018,March,King                                                 ,Not Adjusted,204,209,5,2.4
13857,2018,June,King                                                 ,Not Adjusted,222,228,6,2.6
13858,2018,September,King                                                 ,Not Adjusted,205,211,6,2.8
13859,2018,December,King                                                 ,Not Adjusted,195,199,4,2.0
13860,2018,March,Kinney                                               ,Not Adjusted,1326,1396,70,5.0
13861,2018,June,Kinney                                               ,Not Adjusted,1337,1402,65,4.6
13862,2018,September,Kinney                                               ,Not Adjusted,1291,1341,50,3.7
13863,2018,December,Kinney                                               ,Not Adjusted,1212,1264,52,4.1
13864,2018,March,Kleberg                                              ,Not Adjusted,13090,13764,674,4.9
13865,2018,June,Kleberg                                              ,Not Adjusted,12474,13207,733,5.6
13866,2018,September,Kleberg                                              ,Not Adjusted,12451,13086,635,4.9
13867,2018,December,Kleberg                                              ,Not Adjusted,12649,13267,618,4.7
13868,2018,March,Knox                                                 ,Not Adjusted,1449,1503,54,3.6
13869,2018,June,Knox                                                 ,Not Adjusted,1451,1513,62,4.1
13870,2018,September,Knox                                                 ,Not Adjusted,1398,1448,50,3.5
13871,2018,December,Knox                                                 ,Not Adjusted,1328,1371,43,3.1
13872,2018,March,Lamar                                                ,Not Adjusted,23004,24011,1007,4.2
13873,2018,June,Lamar                                                ,Not Adjusted,22895,23872,977,4.1
13874,2018,September,Lamar                                                ,Not Adjusted,22829,23658,829,3.5
13875,2018,December,Lamar                                                ,Not Adjusted,22664,23513,849,3.6
13876,2018,March,Lamb                                                 ,Not Adjusted,5183,5431,248,4.6
13877,2018,June,Lamb                                                 ,Not Adjusted,5057,5321,264,5.0
13878,2018,September,Lamb                                                 ,Not Adjusted,4978,5207,229,4.4
13879,2018,December,Lamb                                                 ,Not Adjusted,4715,4929,214,4.3
13880,2018,March,Lampasas                                             ,Not Adjusted,8820,9162,342,3.7
13881,2018,June,Lampasas                                             ,Not Adjusted,8762,9134,372,4.1
13882,2018,September,Lampasas                                             ,Not Adjusted,8795,9145,350,3.8
13883,2018,December,Lampasas                                             ,Not Adjusted,8827,9161,334,3.6
13884,2018,March,La Salle                                             ,Not Adjusted,4403,4516,113,2.5
13885,2018,June,La Salle                                             ,Not Adjusted,4519,4640,121,2.6
13886,2018,September,La Salle                                             ,Not Adjusted,4555,4655,100,2.1
13887,2018,December,La Salle                                             ,Not Adjusted,4443,4536,93,2.1
13888,2018,March,Lavaca                                               ,Not Adjusted,8489,8777,288,3.3
13889,2018,June,Lavaca                                               ,Not Adjusted,8625,8921,296,3.3
13890,2018,September,Lavaca                                               ,Not Adjusted,8484,8750,266,3.0
13891,2018,December,Lavaca                                               ,Not Adjusted,8371,8623,252,2.9
13892,2018,March,Lee                                                  ,Not Adjusted,9271,9602,331,3.4
13893,2018,June,Lee                                                  ,Not Adjusted,8944,9256,312,3.4
13894,2018,September,Lee                                                  ,Not Adjusted,9155,9425,270,2.9
13895,2018,December,Lee                                                  ,Not Adjusted,9431,9700,269,2.8
13896,2018,March,Leon                                                 ,Not Adjusted,5820,6170,350,5.7
13897,2018,June,Leon                                                 ,Not Adjusted,5834,6169,335,5.4
13898,2018,September,Leon                                                 ,Not Adjusted,5869,6142,273,4.4
13899,2018,December,Leon                                                 ,Not Adjusted,5847,6128,281,4.6
13900,2018,March,Liberty                                              ,Not Adjusted,30766,32761,1995,6.1
13901,2018,June,Liberty                                              ,Not Adjusted,30784,32856,2072,6.3
13902,2018,September,Liberty                                              ,Not Adjusted,30818,32622,1804,5.5
13903,2018,December,Liberty                                              ,Not Adjusted,31100,32846,1746,5.3
13904,2018,March,Limestone                                            ,Not Adjusted,8085,8506,421,4.9
13905,2018,June,Limestone                                            ,Not Adjusted,8147,8571,424,4.9
13906,2018,September,Limestone                                            ,Not Adjusted,7898,8272,374,4.5
13907,2018,December,Limestone                                            ,Not Adjusted,7973,8332,359,4.3
13908,2018,March,Lipscomb                                             ,Not Adjusted,1628,1676,48,2.9
13909,2018,June,Lipscomb                                             ,Not Adjusted,1628,1678,50,3.0
13910,2018,September,Lipscomb                                             ,Not Adjusted,1580,1623,43,2.6
13911,2018,December,Lipscomb                                             ,Not Adjusted,1584,1627,43,2.6
13912,2018,March,Live Oak                                             ,Not Adjusted,5069,5273,204,3.9
13913,2018,June,Live Oak                                             ,Not Adjusted,4898,5115,217,4.2
13914,2018,September,Live Oak                                             ,Not Adjusted,4917,5103,186,3.6
13915,2018,December,Live Oak                                             ,Not Adjusted,5047,5218,171,3.3
13916,2018,March,Llano                                                ,Not Adjusted,8165,8497,332,3.9
13917,2018,June,Llano                                                ,Not Adjusted,8398,8737,339,3.9
13918,2018,September,Llano                                                ,Not Adjusted,8194,8515,321,3.8
13919,2018,December,Llano                                                ,Not Adjusted,8033,8347,314,3.8
13920,2018,March,Loving                                               ,Not Adjusted,295,299,4,1.3
13921,2018,June,Loving                                               ,Not Adjusted,255,259,4,1.5
13922,2018,September,Loving                                               ,Not Adjusted,246,250,4,1.6
13923,2018,December,Loving                                               ,Not Adjusted,310,314,4,1.3
13924,2018,March,Lubbock                                              ,Not Adjusted,151449,156792,5343,3.4
13925,2018,June,Lubbock                                              ,Not Adjusted,151076,156765,5689,3.6
13926,2018,September,Lubbock                                              ,Not Adjusted,151544,156225,4681,3.0
13927,2018,December,Lubbock                                              ,Not Adjusted,151865,156302,4437,2.8
13928,2018,March,Lynn                                                 ,Not Adjusted,2720,2820,100,3.5
13929,2018,June,Lynn                                                 ,Not Adjusted,2673,2778,105,3.8
13930,2018,September,Lynn                                                 ,Not Adjusted,2668,2751,83,3.0
13931,2018,December,Lynn                                                 ,Not Adjusted,2586,2661,75,2.8
13932,2018,March,McCulloch                                            ,Not Adjusted,3666,3784,118,3.1
13933,2018,June,McCulloch                                            ,Not Adjusted,3632,3761,129,3.4
13934,2018,September,McCulloch                                            ,Not Adjusted,3614,3748,134,3.6
13935,2018,December,McCulloch                                            ,Not Adjusted,3585,3712,127,3.4
13936,2018,March,McLennan                                             ,Not Adjusted,113261,117566,4305,3.7
13937,2018,June,McLennan                                             ,Not Adjusted,113904,118868,4964,4.2
13938,2018,September,McLennan                                             ,Not Adjusted,114082,118156,4074,3.4
13939,2018,December,McLennan                                             ,Not Adjusted,114793,118755,3962,3.3
13940,2018,March,McMullen                                             ,Not Adjusted,731,743,12,1.6
13941,2018,June,McMullen                                             ,Not Adjusted,685,698,13,1.9
13942,2018,September,McMullen                                             ,Not Adjusted,692,707,15,2.1
13943,2018,December,McMullen                                             ,Not Adjusted,687,699,12,1.7
13944,2018,March,Madison                                              ,Not Adjusted,4461,4674,213,4.6
13945,2018,June,Madison                                              ,Not Adjusted,4348,4579,231,5.0
13946,2018,September,Madison                                              ,Not Adjusted,4315,4507,192,4.3
13947,2018,December,Madison                                              ,Not Adjusted,4348,4533,185,4.1
13948,2018,March,Marion                                               ,Not Adjusted,4091,4295,204,4.7
13949,2018,June,Marion                                               ,Not Adjusted,4070,4270,200,4.7
13950,2018,September,Marion                                               ,Not Adjusted,4017,4197,180,4.3
13951,2018,December,Marion                                               ,Not Adjusted,4022,4214,192,4.6
13952,2018,March,Martin                                               ,Not Adjusted,2658,2721,63,2.3
13953,2018,June,Martin                                               ,Not Adjusted,2705,2784,79,2.8
13954,2018,September,Martin                                               ,Not Adjusted,2756,2834,78,2.8
13955,2018,December,Martin                                               ,Not Adjusted,2752,2826,74,2.6
13956,2018,March,Mason                                                ,Not Adjusted,1769,1823,54,3.0
13957,2018,June,Mason                                                ,Not Adjusted,1759,1821,62,3.4
13958,2018,September,Mason                                                ,Not Adjusted,1666,1719,53,3.1
13959,2018,December,Mason                                                ,Not Adjusted,1652,1708,56,3.3
13960,2018,March,Matagorda                                            ,Not Adjusted,16238,17310,1072,6.2
13961,2018,June,Matagorda                                            ,Not Adjusted,15821,16944,1123,6.6
13962,2018,September,Matagorda                                            ,Not Adjusted,15739,16714,975,5.8
13963,2018,December,Matagorda                                            ,Not Adjusted,15384,16316,932,5.7
13964,2018,March,Maverick                                             ,Not Adjusted,21850,24182,2332,9.6
13965,2018,June,Maverick                                             ,Not Adjusted,21710,23754,2044,8.6
13966,2018,September,Maverick                                             ,Not Adjusted,21828,23323,1495,6.4
13967,2018,December,Maverick                                             ,Not Adjusted,21797,23618,1821,7.7
13968,2018,March,Medina                                               ,Not Adjusted,20811,21579,768,3.6
13969,2018,June,Medina                                               ,Not Adjusted,20852,21678,826,3.8
13970,2018,September,Medina                                               ,Not Adjusted,20844,21587,743,3.4
13971,2018,December,Medina                                               ,Not Adjusted,20831,21537,706,3.3
13972,2018,March,Menard                                               ,Not Adjusted,791,831,40,4.8
13973,2018,June,Menard                                               ,Not Adjusted,819,856,37,4.3
13974,2018,September,Menard                                               ,Not Adjusted,806,837,31,3.7
13975,2018,December,Menard                                               ,Not Adjusted,779,809,30,3.7
13976,2018,March,Midland                                              ,Not Adjusted,97263,99552,2289,2.3
13977,2018,June,Midland                                              ,Not Adjusted,100275,102681,2406,2.3
13978,2018,September,Midland                                              ,Not Adjusted,102806,104957,2151,2.0
13979,2018,December,Midland                                              ,Not Adjusted,104595,106694,2099,2.0
13980,2018,March,Milam                                                ,Not Adjusted,9424,10015,591,5.9
13981,2018,June,Milam                                                ,Not Adjusted,9302,9904,602,6.1
13982,2018,September,Milam                                                ,Not Adjusted,9335,9842,507,5.2
13983,2018,December,Milam                                                ,Not Adjusted,9292,9781,489,5.0
13984,2018,March,Mills                                                ,Not Adjusted,1876,1946,70,3.6
13985,2018,June,Mills                                                ,Not Adjusted,1792,1861,69,3.7
13986,2018,September,Mills                                                ,Not Adjusted,1800,1866,66,3.5
13987,2018,December,Mills                                                ,Not Adjusted,1759,1823,64,3.5
13988,2018,March,Mitchell                                             ,Not Adjusted,2262,2372,110,4.6
13989,2018,June,Mitchell                                             ,Not Adjusted,2261,2366,105,4.4
13990,2018,September,Mitchell                                             ,Not Adjusted,2215,2302,87,3.8
13991,2018,December,Mitchell                                             ,Not Adjusted,2209,2291,82,3.6
13992,2018,March,Montague                                             ,Not Adjusted,8802,9094,292,3.2
13993,2018,June,Montague                                             ,Not Adjusted,8897,9220,323,3.5
13994,2018,September,Montague                                             ,Not Adjusted,8883,9175,292,3.2
13995,2018,December,Montague                                             ,Not Adjusted,8913,9178,265,2.9
13996,2018,March,Montgomery                                           ,Not Adjusted,268410,279266,10856,3.9
13997,2018,June,Montgomery                                           ,Not Adjusted,268645,280061,11416,4.1
13998,2018,September,Montgomery                                           ,Not Adjusted,268932,279189,10257,3.7
13999,2018,December,Montgomery                                           ,Not Adjusted,272179,281979,9800,3.5
14000,2018,March,Moore                                                ,Not Adjusted,10546,10852,306,2.8
14001,2018,June,Moore                                                ,Not Adjusted,10535,10861,326,3.0
14002,2018,September,Moore                                                ,Not Adjusted,10765,11047,282,2.6
14003,2018,December,Moore                                                ,Not Adjusted,10329,10600,271,2.6
14004,2018,March,Morris                                               ,Not Adjusted,4394,4712,318,6.7
14005,2018,June,Morris                                               ,Not Adjusted,4393,4735,342,7.2
14006,2018,September,Morris                                               ,Not Adjusted,4419,4704,285,6.1
14007,2018,December,Morris                                               ,Not Adjusted,4372,4653,281,6.0
14008,2018,March,Motley                                               ,Not Adjusted,462,481,19,4.0
14009,2018,June,Motley                                               ,Not Adjusted,447,464,17,3.7
14010,2018,September,Motley                                               ,Not Adjusted,440,458,18,3.9
14011,2018,December,Motley                                               ,Not Adjusted,429,445,16,3.6
14012,2018,March,Nacogdoches                                          ,Not Adjusted,27803,28927,1124,3.9
14013,2018,June,Nacogdoches                                          ,Not Adjusted,27266,28582,1316,4.6
14014,2018,September,Nacogdoches                                          ,Not Adjusted,27568,28623,1055,3.7
14015,2018,December,Nacogdoches                                          ,Not Adjusted,27395,28467,1072,3.8
14016,2018,March,Navarro                                              ,Not Adjusted,22369,23373,1004,4.3
14017,2018,June,Navarro                                              ,Not Adjusted,22387,23327,940,4.0
14018,2018,September,Navarro                                              ,Not Adjusted,23164,23999,835,3.5
14019,2018,December,Navarro                                              ,Not Adjusted,22746,23555,809,3.4
14020,2018,March,Newton                                               ,Not Adjusted,4843,5207,364,7.0
14021,2018,June,Newton                                               ,Not Adjusted,4852,5211,359,6.9
14022,2018,September,Newton                                               ,Not Adjusted,4841,5157,316,6.1
14023,2018,December,Newton                                               ,Not Adjusted,4812,5165,353,6.8
14024,2018,March,Nolan                                                ,Not Adjusted,6460,6685,225,3.4
14025,2018,June,Nolan                                                ,Not Adjusted,6488,6739,251,3.7
14026,2018,September,Nolan                                                ,Not Adjusted,6540,6762,222,3.3
14027,2018,December,Nolan                                                ,Not Adjusted,6509,6714,205,3.1
14028,2018,March,Nueces                                               ,Not Adjusted,160786,169069,8283,4.9
14029,2018,June,Nueces                                               ,Not Adjusted,160357,168911,8554,5.1
14030,2018,September,Nueces                                               ,Not Adjusted,158223,165755,7532,4.5
14031,2018,December,Nueces                                               ,Not Adjusted,160152,167429,7277,4.3
14032,2018,March,Ochiltree                                            ,Not Adjusted,4354,4486,132,2.9
14033,2018,June,Ochiltree                                            ,Not Adjusted,4348,4486,138,3.1
14034,2018,September,Ochiltree                                            ,Not Adjusted,4387,4507,120,2.7
14035,2018,December,Ochiltree                                            ,Not Adjusted,4222,4338,116,2.7
14036,2018,March,Oldham                                               ,Not Adjusted,901,926,25,2.7
14037,2018,June,Oldham                                               ,Not Adjusted,886,910,24,2.6
14038,2018,September,Oldham                                               ,Not Adjusted,883,908,25,2.8
14039,2018,December,Oldham                                               ,Not Adjusted,862,887,25,2.8
14040,2018,March,Orange                                               ,Not Adjusted,34352,36635,2283,6.2
14041,2018,June,Orange                                               ,Not Adjusted,34450,36599,2149,5.9
14042,2018,September,Orange                                               ,Not Adjusted,34376,36354,1978,5.4
14043,2018,December,Orange                                               ,Not Adjusted,34354,36329,1975,5.4
14044,2018,March,Palo Pinto                                           ,Not Adjusted,13054,13531,477,3.5
14045,2018,June,Palo Pinto                                           ,Not Adjusted,13140,13639,499,3.7
14046,2018,September,Palo Pinto                                           ,Not Adjusted,13104,13538,434,3.2
14047,2018,December,Palo Pinto                                           ,Not Adjusted,13050,13483,433,3.2
14048,2018,March,Panola                                               ,Not Adjusted,10436,10913,477,4.4
14049,2018,June,Panola                                               ,Not Adjusted,9784,10303,519,5.0
14050,2018,September,Panola                                               ,Not Adjusted,10343,10757,414,3.8
14051,2018,December,Panola                                               ,Not Adjusted,10612,10998,386,3.5
14052,2018,March,Parker                                               ,Not Adjusted,63516,65626,2110,3.2
14053,2018,June,Parker                                               ,Not Adjusted,63827,66090,2263,3.4
14054,2018,September,Parker                                               ,Not Adjusted,64060,66070,2010,3.0
14055,2018,December,Parker                                               ,Not Adjusted,64587,66556,1969,3.0
14056,2018,March,Parmer                                               ,Not Adjusted,4831,4949,118,2.4
14057,2018,June,Parmer                                               ,Not Adjusted,4809,4944,135,2.7
14058,2018,September,Parmer                                               ,Not Adjusted,4760,4869,109,2.2
14059,2018,December,Parmer                                               ,Not Adjusted,4665,4773,108,2.3
14060,2018,March,Pecos                                                ,Not Adjusted,6151,6402,251,3.9
14061,2018,June,Pecos                                                ,Not Adjusted,6218,6472,254,3.9
14062,2018,September,Pecos                                                ,Not Adjusted,6270,6489,219,3.4
14063,2018,December,Pecos                                                ,Not Adjusted,6168,6391,223,3.5
14064,2018,March,Polk                                                 ,Not Adjusted,16983,17954,971,5.4
14065,2018,June,Polk                                                 ,Not Adjusted,16935,17890,955,5.3
14066,2018,September,Polk                                                 ,Not Adjusted,16936,17776,840,4.7
14067,2018,December,Polk                                                 ,Not Adjusted,16954,17800,846,4.8
14068,2018,March,Potter                                               ,Not Adjusted,53518,55259,1741,3.2
14069,2018,June,Potter                                               ,Not Adjusted,53084,54894,1810,3.3
14070,2018,September,Potter                                               ,Not Adjusted,53046,54606,1560,2.9
14071,2018,December,Potter                                               ,Not Adjusted,53257,54777,1520,2.8
14072,2018,March,Presidio                                             ,Not Adjusted,2769,2993,224,7.5
14073,2018,June,Presidio                                             ,Not Adjusted,2858,3085,227,7.4
14074,2018,September,Presidio                                             ,Not Adjusted,2838,3036,198,6.5
14075,2018,December,Presidio                                             ,Not Adjusted,2846,3025,179,5.9
14076,2018,March,Rains                                                ,Not Adjusted,5786,5993,207,3.5
14077,2018,June,Rains                                                ,Not Adjusted,5645,5866,221,3.8
14078,2018,September,Rains                                                ,Not Adjusted,5638,5840,202,3.5
14079,2018,December,Rains                                                ,Not Adjusted,5828,6031,203,3.4
14080,2018,March,Randall                                              ,Not Adjusted,70053,71970,1917,2.7
14081,2018,June,Randall                                              ,Not Adjusted,69559,71672,2113,2.9
14082,2018,September,Randall                                              ,Not Adjusted,69557,71426,1869,2.6
14083,2018,December,Randall                                              ,Not Adjusted,69565,71347,1782,2.5
14084,2018,March,Reagan                                               ,Not Adjusted,1844,1893,49,2.6
14085,2018,June,Reagan                                               ,Not Adjusted,1851,1903,52,2.7
14086,2018,September,Reagan                                               ,Not Adjusted,1846,1887,41,2.2
14087,2018,December,Reagan                                               ,Not Adjusted,1760,1801,41,2.3
14088,2018,March,Real                                                 ,Not Adjusted,995,1050,55,5.2
14089,2018,June,Real                                                 ,Not Adjusted,1112,1169,57,4.9
14090,2018,September,Real                                                 ,Not Adjusted,955,1010,55,5.4
14091,2018,December,Real                                                 ,Not Adjusted,927,972,45,4.6
14092,2018,March,Red River                                            ,Not Adjusted,4917,5179,262,5.1
14093,2018,June,Red River                                            ,Not Adjusted,4819,5129,310,6.0
14094,2018,September,Red River                                            ,Not Adjusted,4764,5056,292,5.8
14095,2018,December,Red River                                            ,Not Adjusted,4787,5040,253,5.0
14096,2018,March,Reeves                                               ,Not Adjusted,8567,8781,214,2.4
14097,2018,June,Reeves                                               ,Not Adjusted,9173,9386,213,2.3
14098,2018,September,Reeves                                               ,Not Adjusted,9124,9306,182,2.0
14099,2018,December,Reeves                                               ,Not Adjusted,10161,10335,174,1.7
14100,2018,March,Refugio                                              ,Not Adjusted,3026,3184,158,5.0
14101,2018,June,Refugio                                              ,Not Adjusted,2975,3137,162,5.2
14102,2018,September,Refugio                                              ,Not Adjusted,3005,3134,129,4.1
14103,2018,December,Refugio                                              ,Not Adjusted,2986,3108,122,3.9
14104,2018,March,Roberts                                              ,Not Adjusted,435,447,12,2.7
14105,2018,June,Roberts                                              ,Not Adjusted,428,444,16,3.6
14106,2018,September,Roberts                                              ,Not Adjusted,410,422,12,2.8
14107,2018,December,Roberts                                              ,Not Adjusted,393,406,13,3.2
14108,2018,March,Robertson                                            ,Not Adjusted,7354,7665,311,4.1
14109,2018,June,Robertson                                            ,Not Adjusted,6978,7331,353,4.8
14110,2018,September,Robertson                                            ,Not Adjusted,7314,7623,309,4.1
14111,2018,December,Robertson                                            ,Not Adjusted,7285,7569,284,3.8
14112,2018,March,Rockwall                                             ,Not Adjusted,48891,50587,1696,3.4
14113,2018,June,Rockwall                                             ,Not Adjusted,49153,50945,1792,3.5
14114,2018,September,Rockwall                                             ,Not Adjusted,49315,50949,1634,3.2
14115,2018,December,Rockwall                                             ,Not Adjusted,49884,51493,1609,3.1
14116,2018,March,Runnels                                              ,Not Adjusted,4486,4642,156,3.4
14117,2018,June,Runnels                                              ,Not Adjusted,4489,4651,162,3.5
14118,2018,September,Runnels                                              ,Not Adjusted,4424,4557,133,2.9
14119,2018,December,Runnels                                              ,Not Adjusted,4324,4454,130,2.9
14120,2018,March,Rusk                                                 ,Not Adjusted,21922,22881,959,4.2
14121,2018,June,Rusk                                                 ,Not Adjusted,21853,22877,1024,4.5
14122,2018,September,Rusk                                                 ,Not Adjusted,21857,22764,907,4.0
14123,2018,December,Rusk                                                 ,Not Adjusted,21836,22710,874,3.8
14124,2018,March,Sabine                                               ,Not Adjusted,3317,3608,291,8.1
14125,2018,June,Sabine                                               ,Not Adjusted,3305,3612,307,8.5
14126,2018,September,Sabine                                               ,Not Adjusted,3223,3483,260,7.5
14127,2018,December,Sabine                                               ,Not Adjusted,3172,3470,298,8.6
14128,2018,March,San Augustine                                        ,Not Adjusted,2766,2964,198,6.7
14129,2018,June,San Augustine                                        ,Not Adjusted,2801,3015,214,7.1
14130,2018,September,San Augustine                                        ,Not Adjusted,2825,3008,183,6.1
14131,2018,December,San Augustine                                        ,Not Adjusted,2970,3161,191,6.0
14132,2018,March,San Jacinto                                          ,Not Adjusted,10975,11559,584,5.1
14133,2018,June,San Jacinto                                          ,Not Adjusted,10991,11615,624,5.4
14134,2018,September,San Jacinto                                          ,Not Adjusted,10911,11468,557,4.9
14135,2018,December,San Jacinto                                          ,Not Adjusted,11027,11583,556,4.8
14136,2018,March,San Patricio                                         ,Not Adjusted,28340,30415,2075,6.8
14137,2018,June,San Patricio                                         ,Not Adjusted,28263,30353,2090,6.9
14138,2018,September,San Patricio                                         ,Not Adjusted,27890,29660,1770,6.0
14139,2018,December,San Patricio                                         ,Not Adjusted,28118,29796,1678,5.6
14140,2018,March,San Saba                                             ,Not Adjusted,2458,2539,81,3.2
14141,2018,June,San Saba                                             ,Not Adjusted,2384,2473,89,3.6
14142,2018,September,San Saba                                             ,Not Adjusted,2477,2552,75,2.9
14143,2018,December,San Saba                                             ,Not Adjusted,2622,2696,74,2.7
14144,2018,March,Schleicher                                           ,Not Adjusted,1292,1336,44,3.3
14145,2018,June,Schleicher                                           ,Not Adjusted,1354,1397,43,3.1
14146,2018,September,Schleicher                                           ,Not Adjusted,1354,1391,37,2.7
14147,2018,December,Schleicher                                           ,Not Adjusted,1393,1431,38,2.7
14148,2018,March,Scurry                                               ,Not Adjusted,6782,7051,269,3.8
14149,2018,June,Scurry                                               ,Not Adjusted,6762,7048,286,4.1
14150,2018,September,Scurry                                               ,Not Adjusted,6622,6844,222,3.2
14151,2018,December,Scurry                                               ,Not Adjusted,6580,6785,205,3.0
14152,2018,March,Shackelford                                          ,Not Adjusted,1922,1967,45,2.3
14153,2018,June,Shackelford                                          ,Not Adjusted,1941,1990,49,2.5
14154,2018,September,Shackelford                                          ,Not Adjusted,1903,1950,47,2.4
14155,2018,December,Shackelford                                          ,Not Adjusted,1825,1868,43,2.3
14156,2018,March,Shelby                                               ,Not Adjusted,10548,11038,490,4.4
14157,2018,June,Shelby                                               ,Not Adjusted,10585,11109,524,4.7
14158,2018,September,Shelby                                               ,Not Adjusted,10689,11140,451,4.0
14159,2018,December,Shelby                                               ,Not Adjusted,10437,10901,464,4.3
14160,2018,March,Sherman                                              ,Not Adjusted,1298,1334,36,2.7
14161,2018,June,Sherman                                              ,Not Adjusted,1326,1366,40,2.9
14162,2018,September,Sherman                                              ,Not Adjusted,1322,1356,34,2.5
14163,2018,December,Sherman                                              ,Not Adjusted,1232,1267,35,2.8
14164,2018,March,Smith                                                ,Not Adjusted,101951,105859,3908,3.7
14165,2018,June,Smith                                                ,Not Adjusted,102810,107097,4287,4.0
14166,2018,September,Smith                                                ,Not Adjusted,103051,106846,3795,3.6
14167,2018,December,Smith                                                ,Not Adjusted,103910,107761,3851,3.6
14168,2018,March,Somervell                                            ,Not Adjusted,4087,4261,174,4.1
14169,2018,June,Somervell                                            ,Not Adjusted,4109,4316,207,4.8
14170,2018,September,Somervell                                            ,Not Adjusted,4123,4291,168,3.9
14171,2018,December,Somervell                                            ,Not Adjusted,4164,4309,145,3.4
14172,2018,March,Starr                                                ,Not Adjusted,23105,25874,2769,10.7
14173,2018,June,Starr                                                ,Not Adjusted,22500,25385,2885,11.4
14174,2018,September,Starr                                                ,Not Adjusted,22111,24253,2142,8.8
14175,2018,December,Starr                                                ,Not Adjusted,22693,25094,2401,9.6
14176,2018,March,Stephens                                             ,Not Adjusted,3868,4026,158,3.9
14177,2018,June,Stephens                                             ,Not Adjusted,3850,4014,164,4.1
14178,2018,September,Stephens                                             ,Not Adjusted,3781,3920,139,3.5
14179,2018,December,Stephens                                             ,Not Adjusted,3923,4049,126,3.1
14180,2018,March,Sterling                                             ,Not Adjusted,595,613,18,2.9
14181,2018,June,Sterling                                             ,Not Adjusted,580,602,22,3.7
14182,2018,September,Sterling                                             ,Not Adjusted,563,582,19,3.3
14183,2018,December,Sterling                                             ,Not Adjusted,513,532,19,3.6
14184,2018,March,Stonewall                                            ,Not Adjusted,586,605,19,3.1
14185,2018,June,Stonewall                                            ,Not Adjusted,586,609,23,3.8
14186,2018,September,Stonewall                                            ,Not Adjusted,578,599,21,3.5
14187,2018,December,Stonewall                                            ,Not Adjusted,541,558,17,3.0
14188,2018,March,Sutton                                               ,Not Adjusted,1401,1461,60,4.1
14189,2018,June,Sutton                                               ,Not Adjusted,1408,1468,60,4.1
14190,2018,September,Sutton                                               ,Not Adjusted,1426,1481,55,3.7
14191,2018,December,Sutton                                               ,Not Adjusted,1389,1440,51,3.5
14192,2018,March,Swisher                                              ,Not Adjusted,2627,2742,115,4.2
14193,2018,June,Swisher                                              ,Not Adjusted,2555,2683,128,4.8
14194,2018,September,Swisher                                              ,Not Adjusted,2539,2660,121,4.5
14195,2018,December,Swisher                                              ,Not Adjusted,2477,2580,103,4.0
14196,2018,March,Tarrant                                              ,Not Adjusted,1013429,1051673,38244,3.6
14197,2018,June,Tarrant                                              ,Not Adjusted,1020849,1062135,41286,3.9
14198,2018,September,Tarrant                                              ,Not Adjusted,1025582,1062268,36686,3.5
14199,2018,December,Tarrant                                              ,Not Adjusted,1035992,1071542,35550,3.3
14200,2018,March,Taylor                                               ,Not Adjusted,63014,65142,2128,3.3
14201,2018,June,Taylor                                               ,Not Adjusted,63152,65477,2325,3.6
14202,2018,September,Taylor                                               ,Not Adjusted,63244,65279,2035,3.1
14203,2018,December,Taylor                                               ,Not Adjusted,63721,65677,1956,3.0
14204,2018,March,Terrell                                              ,Not Adjusted,372,387,15,3.9
14205,2018,June,Terrell                                              ,Not Adjusted,375,386,11,2.8
14206,2018,September,Terrell                                              ,Not Adjusted,364,376,12,3.2
14207,2018,December,Terrell                                              ,Not Adjusted,353,366,13,3.6
14208,2018,March,Terry                                                ,Not Adjusted,5021,5245,224,4.3
14209,2018,June,Terry                                                ,Not Adjusted,4982,5213,231,4.4
14210,2018,September,Terry                                                ,Not Adjusted,4956,5147,191,3.7
14211,2018,December,Terry                                                ,Not Adjusted,4747,4937,190,3.8
14212,2018,March,Throckmorton                                         ,Not Adjusted,669,694,25,3.6
14213,2018,June,Throckmorton                                         ,Not Adjusted,689,715,26,3.6
14214,2018,September,Throckmorton                                         ,Not Adjusted,690,714,24,3.4
14215,2018,December,Throckmorton                                         ,Not Adjusted,670,692,22,3.2
14216,2018,March,Titus                                                ,Not Adjusted,12439,13126,687,5.2
14217,2018,June,Titus                                                ,Not Adjusted,12242,12996,754,5.8
14218,2018,September,Titus                                                ,Not Adjusted,12195,12827,632,4.9
14219,2018,December,Titus                                                ,Not Adjusted,12107,12689,582,4.6
14220,2018,March,Tom Green                                            ,Not Adjusted,52976,54720,1744,3.2
14221,2018,June,Tom Green                                            ,Not Adjusted,52724,54629,1905,3.5
14222,2018,September,Tom Green                                            ,Not Adjusted,53045,54766,1721,3.1
14223,2018,December,Tom Green                                            ,Not Adjusted,52667,54362,1695,3.1
14224,2018,March,Travis                                               ,Not Adjusted,692666,713864,21198,3.0
14225,2018,June,Travis                                               ,Not Adjusted,698302,720851,22549,3.1
14226,2018,September,Travis                                               ,Not Adjusted,699367,720051,20684,2.9
14227,2018,December,Travis                                               ,Not Adjusted,708997,728411,19414,2.7
14228,2018,March,Trinity                                              ,Not Adjusted,5076,5363,287,5.4
14229,2018,June,Trinity                                              ,Not Adjusted,5113,5412,299,5.5
14230,2018,September,Trinity                                              ,Not Adjusted,5084,5347,263,4.9
14231,2018,December,Trinity                                              ,Not Adjusted,4894,5160,266,5.2
14232,2018,March,Tyler                                                ,Not Adjusted,6498,6985,487,7.0
14233,2018,June,Tyler                                                ,Not Adjusted,6514,6995,481,6.9
14234,2018,September,Tyler                                                ,Not Adjusted,6617,7050,433,6.1
14235,2018,December,Tyler                                                ,Not Adjusted,6527,6957,430,6.2
14236,2018,March,Upshur                                               ,Not Adjusted,16996,17773,777,4.4
14237,2018,June,Upshur                                               ,Not Adjusted,16942,17734,792,4.5
14238,2018,September,Upshur                                               ,Not Adjusted,16946,17654,708,4.0
14239,2018,December,Upshur                                               ,Not Adjusted,16929,17641,712,4.0
14240,2018,March,Upton                                                ,Not Adjusted,1527,1578,51,3.2
14241,2018,June,Upton                                                ,Not Adjusted,1524,1580,56,3.5
14242,2018,September,Upton                                                ,Not Adjusted,1516,1563,47,3.0
14243,2018,December,Upton                                                ,Not Adjusted,1525,1584,59,3.7
14244,2018,March,Uvalde                                               ,Not Adjusted,11184,11677,493,4.2
14245,2018,June,Uvalde                                               ,Not Adjusted,11179,11728,549,4.7
14246,2018,September,Uvalde                                               ,Not Adjusted,10889,11379,490,4.3
14247,2018,December,Uvalde                                               ,Not Adjusted,10757,11226,469,4.2
14248,2018,March,Val Verde                                            ,Not Adjusted,21456,22422,966,4.3
14249,2018,June,Val Verde                                            ,Not Adjusted,21544,22462,918,4.1
14250,2018,September,Val Verde                                            ,Not Adjusted,21590,22401,811,3.6
14251,2018,December,Val Verde                                            ,Not Adjusted,21690,22489,799,3.6
14252,2018,March,Van Zandt                                            ,Not Adjusted,24772,25694,922,3.6
14253,2018,June,Van Zandt                                            ,Not Adjusted,25195,26214,1019,3.9
14254,2018,September,Van Zandt                                            ,Not Adjusted,24818,25704,886,3.4
14255,2018,December,Van Zandt                                            ,Not Adjusted,24801,25653,852,3.3
14256,2018,March,Victoria                                             ,Not Adjusted,41277,43019,1742,4.0
14257,2018,June,Victoria                                             ,Not Adjusted,41235,43047,1812,4.2
14258,2018,September,Victoria                                             ,Not Adjusted,41326,42904,1578,3.7
14259,2018,December,Victoria                                             ,Not Adjusted,41460,42975,1515,3.5
14260,2018,March,Walker                                               ,Not Adjusted,22702,23738,1036,4.4
14261,2018,June,Walker                                               ,Not Adjusted,22749,23903,1154,4.8
14262,2018,September,Walker                                               ,Not Adjusted,23228,24194,966,4.0
14263,2018,December,Walker                                               ,Not Adjusted,22891,23810,919,3.9
14264,2018,March,Waller                                               ,Not Adjusted,22150,23136,986,4.3
14265,2018,June,Waller                                               ,Not Adjusted,22146,23292,1146,4.9
14266,2018,September,Waller                                               ,Not Adjusted,22164,23127,963,4.2
14267,2018,December,Waller                                               ,Not Adjusted,22307,23198,891,3.8
14268,2018,March,Ward                                                 ,Not Adjusted,6113,6297,184,2.9
14269,2018,June,Ward                                                 ,Not Adjusted,6653,6843,190,2.8
14270,2018,September,Ward                                                 ,Not Adjusted,6829,6990,161,2.3
14271,2018,December,Ward                                                 ,Not Adjusted,7051,7217,166,2.3
14272,2018,March,Washington                                           ,Not Adjusted,14458,15053,595,4.0
14273,2018,June,Washington                                           ,Not Adjusted,14325,14957,632,4.2
14274,2018,September,Washington                                           ,Not Adjusted,14369,14880,511,3.4
14275,2018,December,Washington                                           ,Not Adjusted,14255,14760,505,3.4
14276,2018,March,Webb                                                 ,Not Adjusted,111449,115934,4485,3.9
14277,2018,June,Webb                                                 ,Not Adjusted,111021,116064,5043,4.3
14278,2018,September,Webb                                                 ,Not Adjusted,111425,115633,4208,3.6
14279,2018,December,Webb                                                 ,Not Adjusted,113543,117961,4418,3.7
14280,2018,March,Wharton                                              ,Not Adjusted,20604,21414,810,3.8
14281,2018,June,Wharton                                              ,Not Adjusted,20511,21392,881,4.1
14282,2018,September,Wharton                                              ,Not Adjusted,20633,21380,747,3.5
14283,2018,December,Wharton                                              ,Not Adjusted,20409,21138,729,3.4
14284,2018,March,Wheeler                                              ,Not Adjusted,2481,2567,86,3.4
14285,2018,June,Wheeler                                              ,Not Adjusted,2242,2322,80,3.4
14286,2018,September,Wheeler                                              ,Not Adjusted,2351,2417,66,2.7
14287,2018,December,Wheeler                                              ,Not Adjusted,2234,2301,67,2.9
14288,2018,March,Wichita                                              ,Not Adjusted,54399,56430,2031,3.6
14289,2018,June,Wichita                                              ,Not Adjusted,54493,56720,2227,3.9
14290,2018,September,Wichita                                              ,Not Adjusted,53974,55825,1851,3.3
14291,2018,December,Wichita                                              ,Not Adjusted,54679,56537,1858,3.3
14292,2018,March,Wilbarger                                            ,Not Adjusted,4785,4999,214,4.3
14293,2018,June,Wilbarger                                            ,Not Adjusted,4708,4934,226,4.6
14294,2018,September,Wilbarger                                            ,Not Adjusted,4793,4994,201,4.0
14295,2018,December,Wilbarger                                            ,Not Adjusted,4785,4977,192,3.9
14296,2018,March,Willacy                                              ,Not Adjusted,5886,6564,678,10.3
14297,2018,June,Willacy                                              ,Not Adjusted,5628,6372,744,11.7
14298,2018,September,Willacy                                              ,Not Adjusted,5782,6355,573,9.0
14299,2018,December,Willacy                                              ,Not Adjusted,5865,6389,524,8.2
14300,2018,March,Williamson                                           ,Not Adjusted,291888,301366,9478,3.1
14301,2018,June,Williamson                                           ,Not Adjusted,294832,305123,10291,3.4
14302,2018,September,Williamson                                           ,Not Adjusted,295530,304852,9322,3.1
14303,2018,December,Williamson                                           ,Not Adjusted,299173,308115,8942,2.9
14304,2018,March,Wilson                                               ,Not Adjusted,23727,24490,763,3.1
14305,2018,June,Wilson                                               ,Not Adjusted,23815,24678,863,3.5
14306,2018,September,Wilson                                               ,Not Adjusted,23819,24563,744,3.0
14307,2018,December,Wilson                                               ,Not Adjusted,23897,24619,722,2.9
14308,2018,March,Winkler                                              ,Not Adjusted,3754,3876,122,3.1
14309,2018,June,Winkler                                              ,Not Adjusted,3835,3960,125,3.2
14310,2018,September,Winkler                                              ,Not Adjusted,3967,4076,109,2.7
14311,2018,December,Winkler                                              ,Not Adjusted,4164,4275,111,2.6
14312,2018,March,Wise                                                 ,Not Adjusted,30038,31229,1191,3.8
14313,2018,June,Wise                                                 ,Not Adjusted,30154,31369,1215,3.9
14314,2018,September,Wise                                                 ,Not Adjusted,30252,31282,1030,3.3
14315,2018,December,Wise                                                 ,Not Adjusted,30451,31452,1001,3.2
14316,2018,March,Wood                                                 ,Not Adjusted,16698,17462,764,4.4
14317,2018,June,Wood                                                 ,Not Adjusted,16641,17450,809,4.6
14318,2018,September,Wood                                                 ,Not Adjusted,16549,17286,737,4.3
14319,2018,December,Wood                                                 ,Not Adjusted,16657,17375,718,4.1
14320,2018,March,Yoakum                                               ,Not Adjusted,3700,3808,108,2.8
14321,2018,June,Yoakum                                               ,Not Adjusted,3673,3792,119,3.1
14322,2018,September,Yoakum                                               ,Not Adjusted,3630,3735,105,2.8
14323,2018,December,Yoakum                                               ,Not Adjusted,3515,3613,98,2.7
14324,2018,March,Young                                                ,Not Adjusted,7876,8167,291,3.6
14325,2018,June,Young                                                ,Not Adjusted,7954,8233,279,3.4
14326,2018,September,Young                                                ,Not Adjusted,7944,8195,251,3.1
14327,2018,December,Young                                                ,Not Adjusted,7911,8155,244,3.0
14328,2018,March,Zapata                                               ,Not Adjusted,5072,5405,333,6.2
14329,2018,June,Zapata                                               ,Not Adjusted,5067,5405,338,6.3
14330,2018,September,Zapata                                               ,Not Adjusted,5130,5396,266,4.9
14331,2018,December,Zapata                                               ,Not Adjusted,5063,5318,255,4.8
14332,2018,March,Zavala                                               ,Not Adjusted,3397,3748,351,9.4
14333,2018,June,Zavala                                               ,Not Adjusted,3208,3626,418,11.5
14334,2018,September,Zavala                                               ,Not Adjusted,3090,3416,326,9.5
14335,2018,December,Zavala                                               ,Not Adjusted,3085,3403,318,9.3
14336,2019,March,Texas,Not Adjusted,13465204,13954188,488984,3.5
14337,2019,March,Texas,Adjusted,13446764,13939862,493098,3.5
14338,2019,June,Texas,Not Adjusted,13488078,14018408,530330,3.8
14339,2019,June,Texas,Adjusted,13521952,14001987,480035,3.4
14340,2019,September,Texas,Not Adjusted,13616912,14100536,483624,3.4
14341,2019,September,Texas,Adjusted,13616230,14115779,499549,3.5
14342,2019,December,Texas,Not Adjusted,13705505,14169618,464113,3.3
14343,2019,December,Texas,Adjusted,13677859,14174181,496322,3.5
14344,2019,March,Anderson                                             ,Not Adjusted,22665,23343,678,2.9
14345,2019,June,Anderson                                             ,Not Adjusted,22653,23379,726,3.1
14346,2019,September,Anderson                                             ,Not Adjusted,22943,23593,650,2.8
14347,2019,December,Anderson                                             ,Not Adjusted,22748,23387,639,2.7
14348,2019,March,Andrews                                              ,Not Adjusted,9786,10005,219,2.2
14349,2019,June,Andrews                                              ,Not Adjusted,9691,9942,251,2.5
14350,2019,September,Andrews                                              ,Not Adjusted,9680,9914,234,2.4
14351,2019,December,Andrews                                              ,Not Adjusted,9581,9808,227,2.3
14352,2019,March,Angelina                                             ,Not Adjusted,34379,35785,1406,3.9
14353,2019,June,Angelina                                             ,Not Adjusted,34154,35678,1524,4.3
14354,2019,September,Angelina                                             ,Not Adjusted,34562,35960,1398,3.9
14355,2019,December,Angelina                                             ,Not Adjusted,34529,35880,1351,3.8
14356,2019,March,Aransas                                              ,Not Adjusted,8909,9320,411,4.4
14357,2019,June,Aransas                                              ,Not Adjusted,8877,9299,422,4.5
14358,2019,September,Aransas                                              ,Not Adjusted,8862,9222,360,3.9
14359,2019,December,Aransas                                              ,Not Adjusted,8890,9254,364,3.9
14360,2019,March,Archer                                               ,Not Adjusted,3904,4022,118,2.9
14361,2019,June,Archer                                               ,Not Adjusted,3895,4018,123,3.1
14362,2019,September,Archer                                               ,Not Adjusted,3906,4015,109,2.7
14363,2019,December,Archer                                               ,Not Adjusted,3903,4005,102,2.5
14364,2019,March,Armstrong                                            ,Not Adjusted,909,935,26,2.8
14365,2019,June,Armstrong                                            ,Not Adjusted,904,930,26,2.8
14366,2019,September,Armstrong                                            ,Not Adjusted,904,928,24,2.6
14367,2019,December,Armstrong                                            ,Not Adjusted,908,933,25,2.7
14368,2019,March,Atascosa                                             ,Not Adjusted,20877,21648,771,3.6
14369,2019,June,Atascosa                                             ,Not Adjusted,20925,21767,842,3.9
14370,2019,September,Atascosa                                             ,Not Adjusted,21083,21852,769,3.5
14371,2019,December,Atascosa                                             ,Not Adjusted,21182,21907,725,3.3
14372,2019,March,Austin                                               ,Not Adjusted,13468,13940,472,3.4
14373,2019,June,Austin                                               ,Not Adjusted,13459,13980,521,3.7
14374,2019,September,Austin                                               ,Not Adjusted,13558,14021,463,3.3
14375,2019,December,Austin                                               ,Not Adjusted,13603,14054,451,3.2
14376,2019,March,Bailey                                               ,Not Adjusted,2438,2540,102,4.0
14377,2019,June,Bailey                                               ,Not Adjusted,2476,2589,113,4.4
14378,2019,September,Bailey                                               ,Not Adjusted,2390,2472,82,3.3
14379,2019,December,Bailey                                               ,Not Adjusted,2368,2438,70,2.9
14380,2019,March,Bandera                                              ,Not Adjusted,9687,10035,348,3.5
14381,2019,June,Bandera                                              ,Not Adjusted,9698,10031,333,3.3
14382,2019,September,Bandera                                              ,Not Adjusted,9770,10106,336,3.3
14383,2019,December,Bandera                                              ,Not Adjusted,9821,10112,291,2.9
14384,2019,March,Bastrop                                              ,Not Adjusted,41041,42295,1254,3.0
14385,2019,June,Bastrop                                              ,Not Adjusted,41258,42733,1475,3.5
14386,2019,September,Bastrop                                              ,Not Adjusted,41641,42916,1275,3.0
14387,2019,December,Bastrop                                              ,Not Adjusted,42135,43320,1185,2.7
14388,2019,March,Baylor                                               ,Not Adjusted,1691,1731,40,2.3
14389,2019,June,Baylor                                               ,Not Adjusted,1728,1768,40,2.3
14390,2019,September,Baylor                                               ,Not Adjusted,1722,1760,38,2.2
14391,2019,December,Baylor                                               ,Not Adjusted,1759,1798,39,2.2
14392,2019,March,Bee                                                  ,Not Adjusted,9530,9952,422,4.2
14393,2019,June,Bee                                                  ,Not Adjusted,9345,9788,443,4.5
14394,2019,September,Bee                                                  ,Not Adjusted,9419,9850,431,4.4
14395,2019,December,Bee                                                  ,Not Adjusted,9390,9809,419,4.3
14396,2019,March,Bell                                                 ,Not Adjusted,137312,142784,5472,3.8
14397,2019,June,Bell                                                 ,Not Adjusted,137483,143443,5960,4.2
14398,2019,September,Bell                                                 ,Not Adjusted,138908,144299,5391,3.7
14399,2019,December,Bell                                                 ,Not Adjusted,139913,144854,4941,3.4
14400,2019,March,Bexar                                                ,Not Adjusted,907424,936760,29336,3.1
14401,2019,June,Bexar                                                ,Not Adjusted,912276,944433,32157,3.4
14402,2019,September,Bexar                                                ,Not Adjusted,919355,948661,29306,3.1
14403,2019,December,Bexar                                                ,Not Adjusted,924570,951311,26741,2.8
14404,2019,March,Blanco                                               ,Not Adjusted,6296,6464,168,2.6
14405,2019,June,Blanco                                               ,Not Adjusted,6325,6499,174,2.7
14406,2019,September,Blanco                                               ,Not Adjusted,6371,6523,152,2.3
14407,2019,December,Blanco                                               ,Not Adjusted,6529,6667,138,2.1
14408,2019,March,Borden                                               ,Not Adjusted,374,384,10,2.6
14409,2019,June,Borden                                               ,Not Adjusted,374,383,9,2.3
14410,2019,September,Borden                                               ,Not Adjusted,403,414,11,2.7
14411,2019,December,Borden                                               ,Not Adjusted,459,468,9,1.9
14412,2019,March,Bosque                                               ,Not Adjusted,8040,8311,271,3.3
14413,2019,June,Bosque                                               ,Not Adjusted,8068,8369,301,3.6
14414,2019,September,Bosque                                               ,Not Adjusted,8017,8298,281,3.4
14415,2019,December,Bosque                                               ,Not Adjusted,8022,8291,269,3.2
14416,2019,March,Bowie                                                ,Not Adjusted,37890,39678,1788,4.5
14417,2019,June,Bowie                                                ,Not Adjusted,38030,39914,1884,4.7
14418,2019,September,Bowie                                                ,Not Adjusted,38049,39741,1692,4.3
14419,2019,December,Bowie                                                ,Not Adjusted,38137,39617,1480,3.7
14420,2019,March,Brazoria                                             ,Not Adjusted,171280,178229,6949,3.9
14421,2019,June,Brazoria                                             ,Not Adjusted,171719,179704,7985,4.4
14422,2019,September,Brazoria                                             ,Not Adjusted,173016,180771,7755,4.3
14423,2019,December,Brazoria                                             ,Not Adjusted,173717,181433,7716,4.3
14424,2019,March,Brazos                                               ,Not Adjusted,117413,120525,3112,2.6
14425,2019,June,Brazos                                               ,Not Adjusted,110858,114533,3675,3.2
14426,2019,September,Brazos                                               ,Not Adjusted,116975,120127,3152,2.6
14427,2019,December,Brazos                                               ,Not Adjusted,117974,120789,2815,2.3
14428,2019,March,Brewster                                             ,Not Adjusted,4130,4253,123,2.9
14429,2019,June,Brewster                                             ,Not Adjusted,4012,4152,140,3.4
14430,2019,September,Brewster                                             ,Not Adjusted,4046,4166,120,2.9
14431,2019,December,Brewster                                             ,Not Adjusted,4097,4200,103,2.5
14432,2019,March,Briscoe                                              ,Not Adjusted,566,587,21,3.6
14433,2019,June,Briscoe                                              ,Not Adjusted,574,596,22,3.7
14434,2019,September,Briscoe                                              ,Not Adjusted,552,575,23,4.0
14435,2019,December,Briscoe                                              ,Not Adjusted,554,571,17,3.0
14436,2019,March,Brooks                                               ,Not Adjusted,2489,2631,142,5.4
14437,2019,June,Brooks                                               ,Not Adjusted,2431,2582,151,5.8
14438,2019,September,Brooks                                               ,Not Adjusted,2471,2600,129,5.0
14439,2019,December,Brooks                                               ,Not Adjusted,2460,2588,128,4.9
14440,2019,March,Brown                                                ,Not Adjusted,15335,15909,574,3.6
14441,2019,June,Brown                                                ,Not Adjusted,14859,15503,644,4.2
14442,2019,September,Brown                                                ,Not Adjusted,15024,15618,594,3.8
14443,2019,December,Brown                                                ,Not Adjusted,14955,15496,541,3.5
14444,2019,March,Burleson                                             ,Not Adjusted,8166,8426,260,3.1
14445,2019,June,Burleson                                             ,Not Adjusted,7713,7980,267,3.3
14446,2019,September,Burleson                                             ,Not Adjusted,8116,8361,245,2.9
14447,2019,December,Burleson                                             ,Not Adjusted,8178,8434,256,3.0
14448,2019,March,Burnet                                               ,Not Adjusted,22908,23560,652,2.8
14449,2019,June,Burnet                                               ,Not Adjusted,22934,23616,682,2.9
14450,2019,September,Burnet                                               ,Not Adjusted,22958,23594,636,2.7
14451,2019,December,Burnet                                               ,Not Adjusted,23006,23581,575,2.4
14452,2019,March,Caldwell                                             ,Not Adjusted,18553,19209,656,3.4
14453,2019,June,Caldwell                                             ,Not Adjusted,18657,19387,730,3.8
14454,2019,September,Caldwell                                             ,Not Adjusted,18831,19481,650,3.3
14455,2019,December,Caldwell                                             ,Not Adjusted,19056,19619,563,2.9
14456,2019,March,Calhoun                                              ,Not Adjusted,11765,12123,358,3.0
14457,2019,June,Calhoun                                              ,Not Adjusted,11832,12260,428,3.5
14458,2019,September,Calhoun                                              ,Not Adjusted,11657,12027,370,3.1
14459,2019,December,Calhoun                                              ,Not Adjusted,11737,12144,407,3.4
14460,2019,March,Callahan                                             ,Not Adjusted,5843,6030,187,3.1
14461,2019,June,Callahan                                             ,Not Adjusted,5815,6019,204,3.4
14462,2019,September,Callahan                                             ,Not Adjusted,5937,6120,183,3.0
14463,2019,December,Callahan                                             ,Not Adjusted,5964,6140,176,2.9
14464,2019,March,Cameron                                              ,Not Adjusted,156913,165840,8927,5.4
14465,2019,June,Cameron                                              ,Not Adjusted,157030,166835,9805,5.9
14466,2019,September,Cameron                                              ,Not Adjusted,157933,166575,8642,5.2
14467,2019,December,Cameron                                              ,Not Adjusted,159478,168823,9345,5.5
14468,2019,March,Camp                                                 ,Not Adjusted,4728,4938,210,4.3
14469,2019,June,Camp                                                 ,Not Adjusted,4787,5004,217,4.3
14470,2019,September,Camp                                                 ,Not Adjusted,4820,5023,203,4.0
14471,2019,December,Camp                                                 ,Not Adjusted,4762,4957,195,3.9
14472,2019,March,Carson                                               ,Not Adjusted,2913,2996,83,2.8
14473,2019,June,Carson                                               ,Not Adjusted,2897,2978,81,2.7
14474,2019,September,Carson                                               ,Not Adjusted,2901,2969,68,2.3
14475,2019,December,Carson                                               ,Not Adjusted,2917,2984,67,2.2
14476,2019,March,Cass                                                 ,Not Adjusted,12047,12587,540,4.3
14477,2019,June,Cass                                                 ,Not Adjusted,11828,12398,570,4.6
14478,2019,September,Cass                                                 ,Not Adjusted,11881,12404,523,4.2
14479,2019,December,Cass                                                 ,Not Adjusted,11771,12254,483,3.9
14480,2019,March,Castro                                               ,Not Adjusted,3410,3511,101,2.9
14481,2019,June,Castro                                               ,Not Adjusted,3347,3455,108,3.1
14482,2019,September,Castro                                               ,Not Adjusted,3325,3411,86,2.5
14483,2019,December,Castro                                               ,Not Adjusted,3350,3423,73,2.1
14484,2019,March,Chambers                                             ,Not Adjusted,18920,19768,848,4.3
14485,2019,June,Chambers                                             ,Not Adjusted,18967,19949,982,4.9
14486,2019,September,Chambers                                             ,Not Adjusted,19110,19944,834,4.2
14487,2019,December,Chambers                                             ,Not Adjusted,19192,20080,888,4.4
14488,2019,March,Cherokee                                             ,Not Adjusted,20265,21065,800,3.8
14489,2019,June,Cherokee                                             ,Not Adjusted,20064,20886,822,3.9
14490,2019,September,Cherokee                                             ,Not Adjusted,20081,20849,768,3.7
14491,2019,December,Cherokee                                             ,Not Adjusted,20491,21251,760,3.6
14492,2019,March,Childress                                            ,Not Adjusted,2847,2925,78,2.7
14493,2019,June,Childress                                            ,Not Adjusted,2897,2981,84,2.8
14494,2019,September,Childress                                            ,Not Adjusted,2873,2952,79,2.7
14495,2019,December,Childress                                            ,Not Adjusted,2861,2944,83,2.8
14496,2019,March,Clay                                                 ,Not Adjusted,4774,4920,146,3.0
14497,2019,June,Clay                                                 ,Not Adjusted,4761,4930,169,3.4
14498,2019,September,Clay                                                 ,Not Adjusted,4774,4923,149,3.0
14499,2019,December,Clay                                                 ,Not Adjusted,4771,4906,135,2.8
14500,2019,March,Cochran                                              ,Not Adjusted,1135,1176,41,3.5
14501,2019,June,Cochran                                              ,Not Adjusted,1089,1132,43,3.8
14502,2019,September,Cochran                                              ,Not Adjusted,1098,1132,34,3.0
14503,2019,December,Cochran                                              ,Not Adjusted,1066,1105,39,3.5
14504,2019,March,Coke                                                 ,Not Adjusted,1370,1419,49,3.5
14505,2019,June,Coke                                                 ,Not Adjusted,1418,1471,53,3.6
14506,2019,September,Coke                                                 ,Not Adjusted,1439,1483,44,3.0
14507,2019,December,Coke                                                 ,Not Adjusted,1410,1445,35,2.4
14508,2019,March,Coleman                                              ,Not Adjusted,2751,2863,112,3.9
14509,2019,June,Coleman                                              ,Not Adjusted,2753,2874,121,4.2
14510,2019,September,Coleman                                              ,Not Adjusted,2746,2859,113,4.0
14511,2019,December,Coleman                                              ,Not Adjusted,2734,2859,125,4.4
14512,2019,March,Collin                                               ,Not Adjusted,547239,565062,17823,3.2
14513,2019,June,Collin                                               ,Not Adjusted,551348,570286,18938,3.3
14514,2019,September,Collin                                               ,Not Adjusted,558388,575682,17294,3.0
14515,2019,December,Collin                                               ,Not Adjusted,564694,580403,15709,2.7
14516,2019,March,Collingsworth                                        ,Not Adjusted,1109,1143,34,3.0
14517,2019,June,Collingsworth                                        ,Not Adjusted,1160,1196,36,3.0
14518,2019,September,Collingsworth                                        ,Not Adjusted,1105,1143,38,3.3
14519,2019,December,Collingsworth                                        ,Not Adjusted,1094,1132,38,3.4
14520,2019,March,Colorado                                             ,Not Adjusted,9485,9789,304,3.1
14521,2019,June,Colorado                                             ,Not Adjusted,9675,9999,324,3.2
14522,2019,September,Colorado                                             ,Not Adjusted,9570,9862,292,3.0
14523,2019,December,Colorado                                             ,Not Adjusted,9513,9792,279,2.8
14524,2019,March,Comal                                                ,Not Adjusted,73363,75681,2318,3.1
14525,2019,June,Comal                                                ,Not Adjusted,73626,76066,2440,3.2
14526,2019,September,Comal                                                ,Not Adjusted,74193,76392,2199,2.9
14527,2019,December,Comal                                                ,Not Adjusted,74637,76676,2039,2.7
14528,2019,March,Comanche                                             ,Not Adjusted,5399,5576,177,3.2
14529,2019,June,Comanche                                             ,Not Adjusted,5412,5600,188,3.4
14530,2019,September,Comanche                                             ,Not Adjusted,5471,5642,171,3.0
14531,2019,December,Comanche                                             ,Not Adjusted,5484,5667,183,3.2
14532,2019,March,Concho                                               ,Not Adjusted,1102,1138,36,3.2
14533,2019,June,Concho                                               ,Not Adjusted,1216,1262,46,3.6
14534,2019,September,Concho                                               ,Not Adjusted,1322,1363,41,3.0
14535,2019,December,Concho                                               ,Not Adjusted,1305,1338,33,2.5
14536,2019,March,Cooke                                                ,Not Adjusted,19426,19999,573,2.9
14537,2019,June,Cooke                                                ,Not Adjusted,19379,19977,598,3.0
14538,2019,September,Cooke                                                ,Not Adjusted,19137,19701,564,2.9
14539,2019,December,Cooke                                                ,Not Adjusted,19361,19876,515,2.6
14540,2019,March,Coryell                                              ,Not Adjusted,22887,23836,949,4.0
14541,2019,June,Coryell                                              ,Not Adjusted,22908,23947,1039,4.3
14542,2019,September,Coryell                                              ,Not Adjusted,23145,24057,912,3.8
14543,2019,December,Coryell                                              ,Not Adjusted,23310,24170,860,3.6
14544,2019,March,Cottle                                               ,Not Adjusted,532,555,23,4.1
14545,2019,June,Cottle                                               ,Not Adjusted,534,557,23,4.1
14546,2019,September,Cottle                                               ,Not Adjusted,523,544,21,3.9
14547,2019,December,Cottle                                               ,Not Adjusted,520,546,26,4.8
14548,2019,March,Crane                                                ,Not Adjusted,1472,1529,57,3.7
14549,2019,June,Crane                                                ,Not Adjusted,1524,1591,67,4.2
14550,2019,September,Crane                                                ,Not Adjusted,1523,1588,65,4.1
14551,2019,December,Crane                                                ,Not Adjusted,1521,1589,68,4.3
14552,2019,March,Crockett                                             ,Not Adjusted,1594,1635,41,2.5
14553,2019,June,Crockett                                             ,Not Adjusted,1610,1657,47,2.8
14554,2019,September,Crockett                                             ,Not Adjusted,1574,1628,54,3.3
14555,2019,December,Crockett                                             ,Not Adjusted,1529,1589,60,3.8
14556,2019,March,Crosby                                               ,Not Adjusted,2381,2478,97,3.9
14557,2019,June,Crosby                                               ,Not Adjusted,2349,2461,112,4.6
14558,2019,September,Crosby                                               ,Not Adjusted,2367,2465,98,4.0
14559,2019,December,Crosby                                               ,Not Adjusted,2360,2440,80,3.3
14560,2019,March,Culberson                                            ,Not Adjusted,966,997,31,3.1
14561,2019,June,Culberson                                            ,Not Adjusted,1010,1061,51,4.8
14562,2019,September,Culberson                                            ,Not Adjusted,1015,1060,45,4.2
14563,2019,December,Culberson                                            ,Not Adjusted,1030,1065,35,3.3
14564,2019,March,Dallam                                               ,Not Adjusted,3905,3980,75,1.9
14565,2019,June,Dallam                                               ,Not Adjusted,3839,3931,92,2.3
14566,2019,September,Dallam                                               ,Not Adjusted,3834,3906,72,1.8
14567,2019,December,Dallam                                               ,Not Adjusted,3831,3905,74,1.9
14568,2019,March,Dallas                                               ,Not Adjusted,1281238,1328003,46765,3.5
14569,2019,June,Dallas                                               ,Not Adjusted,1290420,1340742,50322,3.8
14570,2019,September,Dallas                                               ,Not Adjusted,1306840,1352613,45773,3.4
14571,2019,December,Dallas                                               ,Not Adjusted,1321744,1363705,41961,3.1
14572,2019,March,Dawson                                               ,Not Adjusted,4548,4718,170,3.6
14573,2019,June,Dawson                                               ,Not Adjusted,4406,4595,189,4.1
14574,2019,September,Dawson                                               ,Not Adjusted,4389,4573,184,4.0
14575,2019,December,Dawson                                               ,Not Adjusted,4417,4590,173,3.8
14576,2019,March,Deaf Smith                                           ,Not Adjusted,8195,8427,232,2.8
14577,2019,June,Deaf Smith                                           ,Not Adjusted,8203,8469,266,3.1
14578,2019,September,Deaf Smith                                           ,Not Adjusted,8294,8519,225,2.6
14579,2019,December,Deaf Smith                                           ,Not Adjusted,8221,8425,204,2.4
14580,2019,March,Delta                                                ,Not Adjusted,2368,2450,82,3.3
14581,2019,June,Delta                                                ,Not Adjusted,2345,2427,82,3.4
14582,2019,September,Delta                                                ,Not Adjusted,2364,2449,85,3.5
14583,2019,December,Delta                                                ,Not Adjusted,2363,2440,77,3.2
14584,2019,March,Denton                                               ,Not Adjusted,482220,497431,15211,3.1
14585,2019,June,Denton                                               ,Not Adjusted,486015,501971,15956,3.2
14586,2019,September,Denton                                               ,Not Adjusted,492241,506913,14672,2.9
14587,2019,December,Denton                                               ,Not Adjusted,497773,511139,13366,2.6
14588,2019,March,DeWitt                                               ,Not Adjusted,9527,9780,253,2.6
14589,2019,June,DeWitt                                               ,Not Adjusted,9447,9722,275,2.8
14590,2019,September,DeWitt                                               ,Not Adjusted,9600,9845,245,2.5
14591,2019,December,DeWitt                                               ,Not Adjusted,9336,9582,246,2.6
14592,2019,March,Dickens                                              ,Not Adjusted,636,665,29,4.4
14593,2019,June,Dickens                                              ,Not Adjusted,669,699,30,4.3
14594,2019,September,Dickens                                              ,Not Adjusted,638,666,28,4.2
14595,2019,December,Dickens                                              ,Not Adjusted,635,660,25,3.8
14596,2019,March,Dimmit                                               ,Not Adjusted,7422,7602,180,2.4
14597,2019,June,Dimmit                                               ,Not Adjusted,7154,7374,220,3.0
14598,2019,September,Dimmit                                               ,Not Adjusted,7088,7267,179,2.5
14599,2019,December,Dimmit                                               ,Not Adjusted,6924,7100,176,2.5
14600,2019,March,Donley                                               ,Not Adjusted,1420,1465,45,3.1
14601,2019,June,Donley                                               ,Not Adjusted,1424,1481,57,3.8
14602,2019,September,Donley                                               ,Not Adjusted,1335,1380,45,3.3
14603,2019,December,Donley                                               ,Not Adjusted,1387,1429,42,2.9
14604,2019,March,Duval                                                ,Not Adjusted,4771,4995,224,4.5
14605,2019,June,Duval                                                ,Not Adjusted,4752,4984,232,4.7
14606,2019,September,Duval                                                ,Not Adjusted,4716,4920,204,4.1
14607,2019,December,Duval                                                ,Not Adjusted,4602,4839,237,4.9
14608,2019,March,Eastland                                             ,Not Adjusted,8406,8680,274,3.2
14609,2019,June,Eastland                                             ,Not Adjusted,7961,8277,316,3.8
14610,2019,September,Eastland                                             ,Not Adjusted,7849,8113,264,3.3
14611,2019,December,Eastland                                             ,Not Adjusted,7860,8099,239,3.0
14612,2019,March,Ector                                                ,Not Adjusted,85936,88096,2160,2.5
14613,2019,June,Ector                                                ,Not Adjusted,85585,88049,2464,2.8
14614,2019,September,Ector                                                ,Not Adjusted,86511,88915,2404,2.7
14615,2019,December,Ector                                                ,Not Adjusted,85147,87691,2544,2.9
14616,2019,March,Edwards                                              ,Not Adjusted,948,976,28,2.9
14617,2019,June,Edwards                                              ,Not Adjusted,1022,1049,27,2.6
14618,2019,September,Edwards                                              ,Not Adjusted,1116,1139,23,2.0
14619,2019,December,Edwards                                              ,Not Adjusted,1068,1085,17,1.6
14620,2019,March,Ellis                                                ,Not Adjusted,90094,93040,2946,3.2
14621,2019,June,Ellis                                                ,Not Adjusted,90703,93916,3213,3.4
14622,2019,September,Ellis                                                ,Not Adjusted,91851,94670,2819,3.0
14623,2019,December,Ellis                                                ,Not Adjusted,92877,95450,2573,2.7
14624,2019,March,El Paso                                              ,Not Adjusted,347370,361102,13732,3.8
14625,2019,June,El Paso                                              ,Not Adjusted,343877,358583,14706,4.1
14626,2019,September,El Paso                                              ,Not Adjusted,351566,365141,13575,3.7
14627,2019,December,El Paso                                              ,Not Adjusted,353517,366284,12767,3.5
14628,2019,March,Erath                                                ,Not Adjusted,20896,21509,613,2.8
14629,2019,June,Erath                                                ,Not Adjusted,19735,20452,717,3.5
14630,2019,September,Erath                                                ,Not Adjusted,19940,20603,663,3.2
14631,2019,December,Erath                                                ,Not Adjusted,20401,21040,639,3.0
14632,2019,March,Falls                                                ,Not Adjusted,6272,6492,220,3.4
14633,2019,June,Falls                                                ,Not Adjusted,6259,6488,229,3.5
14634,2019,September,Falls                                                ,Not Adjusted,6304,6509,205,3.1
14635,2019,December,Falls                                                ,Not Adjusted,6277,6472,195,3.0
14636,2019,March,Fannin                                               ,Not Adjusted,16687,17180,493,2.9
14637,2019,June,Fannin                                               ,Not Adjusted,16815,17317,502,2.9
14638,2019,September,Fannin                                               ,Not Adjusted,16978,17444,466,2.7
14639,2019,December,Fannin                                               ,Not Adjusted,17058,17474,416,2.4
14640,2019,March,Fayette                                              ,Not Adjusted,12197,12543,346,2.8
14641,2019,June,Fayette                                              ,Not Adjusted,12161,12525,364,2.9
14642,2019,September,Fayette                                              ,Not Adjusted,11925,12237,312,2.5
14643,2019,December,Fayette                                              ,Not Adjusted,11949,12230,281,2.3
14644,2019,March,Fisher                                               ,Not Adjusted,1594,1642,48,2.9
14645,2019,June,Fisher                                               ,Not Adjusted,1596,1655,59,3.6
14646,2019,September,Fisher                                               ,Not Adjusted,1569,1620,51,3.1
14647,2019,December,Fisher                                               ,Not Adjusted,1568,1604,36,2.2
14648,2019,March,Floyd                                                ,Not Adjusted,2480,2607,127,4.9
14649,2019,June,Floyd                                                ,Not Adjusted,2475,2588,113,4.4
14650,2019,September,Floyd                                                ,Not Adjusted,2448,2549,101,4.0
14651,2019,December,Floyd                                                ,Not Adjusted,2426,2521,95,3.8
14652,2019,March,Foard                                                ,Not Adjusted,566,581,15,2.6
14653,2019,June,Foard                                                ,Not Adjusted,546,565,19,3.4
14654,2019,September,Foard                                                ,Not Adjusted,571,589,18,3.1
14655,2019,December,Foard                                                ,Not Adjusted,556,569,13,2.3
14656,2019,March,Fort Bend                                            ,Not Adjusted,384326,398100,13774,3.5
14657,2019,June,Fort Bend                                            ,Not Adjusted,385144,399866,14722,3.7
14658,2019,September,Fort Bend                                            ,Not Adjusted,388052,401701,13649,3.4
14659,2019,December,Fort Bend                                            ,Not Adjusted,389741,402411,12670,3.1
14660,2019,March,Franklin                                             ,Not Adjusted,4445,4620,175,3.8
14661,2019,June,Franklin                                             ,Not Adjusted,4545,4723,178,3.8
14662,2019,September,Franklin                                             ,Not Adjusted,4495,4655,160,3.4
14663,2019,December,Franklin                                             ,Not Adjusted,4520,4664,144,3.1
14664,2019,March,Freestone                                            ,Not Adjusted,6104,6407,303,4.7
14665,2019,June,Freestone                                            ,Not Adjusted,6086,6404,318,5.0
14666,2019,September,Freestone                                            ,Not Adjusted,6141,6441,300,4.7
14667,2019,December,Freestone                                            ,Not Adjusted,6063,6353,290,4.6
14668,2019,March,Frio                                                 ,Not Adjusted,10294,10558,264,2.5
14669,2019,June,Frio                                                 ,Not Adjusted,10165,10488,323,3.1
14670,2019,September,Frio                                                 ,Not Adjusted,10148,10393,245,2.4
14671,2019,December,Frio                                                 ,Not Adjusted,9906,10159,253,2.5
14672,2019,March,Gaines                                               ,Not Adjusted,9620,9850,230,2.3
14673,2019,June,Gaines                                               ,Not Adjusted,9612,9882,270,2.7
14674,2019,September,Gaines                                               ,Not Adjusted,9631,9866,235,2.4
14675,2019,December,Gaines                                               ,Not Adjusted,9743,9963,220,2.2
14676,2019,March,Galveston                                            ,Not Adjusted,158460,164927,6467,3.9
14677,2019,June,Galveston                                            ,Not Adjusted,158764,165792,7028,4.2
14678,2019,September,Galveston                                            ,Not Adjusted,159959,166482,6523,3.9
14679,2019,December,Galveston                                            ,Not Adjusted,160629,167110,6481,3.9
14680,2019,March,Garza                                                ,Not Adjusted,2095,2152,57,2.6
14681,2019,June,Garza                                                ,Not Adjusted,2091,2152,61,2.8
14682,2019,September,Garza                                                ,Not Adjusted,2076,2128,52,2.4
14683,2019,December,Garza                                                ,Not Adjusted,2026,2083,57,2.7
14684,2019,March,Gillespie                                            ,Not Adjusted,13142,13490,348,2.6
14685,2019,June,Gillespie                                            ,Not Adjusted,13365,13721,356,2.6
14686,2019,September,Gillespie                                            ,Not Adjusted,13158,13474,316,2.3
14687,2019,December,Gillespie                                            ,Not Adjusted,13538,13820,282,2.0
14688,2019,March,Glasscock                                            ,Not Adjusted,791,809,18,2.2
14689,2019,June,Glasscock                                            ,Not Adjusted,794,813,19,2.3
14690,2019,September,Glasscock                                            ,Not Adjusted,782,799,17,2.1
14691,2019,December,Glasscock                                            ,Not Adjusted,783,798,15,1.9
14692,2019,March,Goliad                                               ,Not Adjusted,3198,3307,109,3.3
14693,2019,June,Goliad                                               ,Not Adjusted,3155,3267,112,3.4
14694,2019,September,Goliad                                               ,Not Adjusted,3161,3263,102,3.1
14695,2019,December,Goliad                                               ,Not Adjusted,3119,3227,108,3.3
14696,2019,March,Gonzales                                             ,Not Adjusted,9400,9659,259,2.7
14697,2019,June,Gonzales                                             ,Not Adjusted,9277,9548,271,2.8
14698,2019,September,Gonzales                                             ,Not Adjusted,9358,9606,248,2.6
14699,2019,December,Gonzales                                             ,Not Adjusted,9415,9657,242,2.5
14700,2019,March,Gray                                                 ,Not Adjusted,7715,8004,289,3.6
14701,2019,June,Gray                                                 ,Not Adjusted,7814,8111,297,3.7
14702,2019,September,Gray                                                 ,Not Adjusted,7826,8107,281,3.5
14703,2019,December,Gray                                                 ,Not Adjusted,7674,7952,278,3.5
14704,2019,March,Grayson                                              ,Not Adjusted,62006,63960,1954,3.1
14705,2019,June,Grayson                                              ,Not Adjusted,62138,64253,2115,3.3
14706,2019,September,Grayson                                              ,Not Adjusted,62456,64425,1969,3.1
14707,2019,December,Grayson                                              ,Not Adjusted,62946,64791,1845,2.8
14708,2019,March,Gregg                                                ,Not Adjusted,55812,57981,2169,3.7
14709,2019,June,Gregg                                                ,Not Adjusted,55663,57941,2278,3.9
14710,2019,September,Gregg                                                ,Not Adjusted,56153,58314,2161,3.7
14711,2019,December,Gregg                                                ,Not Adjusted,55900,57942,2042,3.5
14712,2019,March,Grimes                                               ,Not Adjusted,10910,11355,445,3.9
14713,2019,June,Grimes                                               ,Not Adjusted,10715,11218,503,4.5
14714,2019,September,Grimes                                               ,Not Adjusted,10794,11237,443,3.9
14715,2019,December,Grimes                                               ,Not Adjusted,10686,11102,416,3.7
14716,2019,March,Guadalupe                                            ,Not Adjusted,78830,81268,2438,3.0
14717,2019,June,Guadalupe                                            ,Not Adjusted,79270,81887,2617,3.2
14718,2019,September,Guadalupe                                            ,Not Adjusted,79881,82237,2356,2.9
14719,2019,December,Guadalupe                                            ,Not Adjusted,80308,82450,2142,2.6
14720,2019,March,Hale                                                 ,Not Adjusted,11750,12339,589,4.8
14721,2019,June,Hale                                                 ,Not Adjusted,11544,12201,657,5.4
14722,2019,September,Hale                                                 ,Not Adjusted,11580,12082,502,4.2
14723,2019,December,Hale                                                 ,Not Adjusted,11472,11933,461,3.9
14724,2019,March,Hall                                                 ,Not Adjusted,1044,1090,46,4.2
14725,2019,June,Hall                                                 ,Not Adjusted,1033,1079,46,4.3
14726,2019,September,Hall                                                 ,Not Adjusted,1014,1057,43,4.1
14727,2019,December,Hall                                                 ,Not Adjusted,1016,1060,44,4.2
14728,2019,March,Hamilton                                             ,Not Adjusted,3561,3674,113,3.1
14729,2019,June,Hamilton                                             ,Not Adjusted,3580,3695,115,3.1
14730,2019,September,Hamilton                                             ,Not Adjusted,3554,3666,112,3.1
14731,2019,December,Hamilton                                             ,Not Adjusted,3615,3714,99,2.7
14732,2019,March,Hansford                                             ,Not Adjusted,2759,2829,70,2.5
14733,2019,June,Hansford                                             ,Not Adjusted,2732,2808,76,2.7
14734,2019,September,Hansford                                             ,Not Adjusted,2690,2751,61,2.2
14735,2019,December,Hansford                                             ,Not Adjusted,2661,2719,58,2.1
14736,2019,March,Hardeman                                             ,Not Adjusted,1651,1708,57,3.3
14737,2019,June,Hardeman                                             ,Not Adjusted,1678,1732,54,3.1
14738,2019,September,Hardeman                                             ,Not Adjusted,1702,1753,51,2.9
14739,2019,December,Hardeman                                             ,Not Adjusted,1672,1714,42,2.5
14740,2019,March,Hardin                                               ,Not Adjusted,24506,25651,1145,4.5
14741,2019,June,Hardin                                               ,Not Adjusted,24217,25486,1269,5.0
14742,2019,September,Hardin                                               ,Not Adjusted,24456,25560,1104,4.3
14743,2019,December,Hardin                                               ,Not Adjusted,24539,25663,1124,4.4
14744,2019,March,Harris                                               ,Not Adjusted,2203221,2289779,86558,3.8
14745,2019,June,Harris                                               ,Not Adjusted,2206907,2300681,93774,4.1
14746,2019,September,Harris                                               ,Not Adjusted,2223540,2310144,86604,3.7
14747,2019,December,Harris                                               ,Not Adjusted,2233574,2318017,84443,3.6
14748,2019,March,Harrison                                             ,Not Adjusted,28285,29464,1179,4.0
14749,2019,June,Harrison                                             ,Not Adjusted,28049,29265,1216,4.2
14750,2019,September,Harrison                                             ,Not Adjusted,28568,29744,1176,4.0
14751,2019,December,Harrison                                             ,Not Adjusted,28230,29356,1126,3.8
14752,2019,March,Hartley                                              ,Not Adjusted,2780,2825,45,1.6
14753,2019,June,Hartley                                              ,Not Adjusted,2749,2796,47,1.7
14754,2019,September,Hartley                                              ,Not Adjusted,2732,2780,48,1.7
14755,2019,December,Hartley                                              ,Not Adjusted,2742,2786,44,1.6
14756,2019,March,Haskell                                              ,Not Adjusted,2194,2271,77,3.4
14757,2019,June,Haskell                                              ,Not Adjusted,2189,2266,77,3.4
14758,2019,September,Haskell                                              ,Not Adjusted,2207,2278,71,3.1
14759,2019,December,Haskell                                              ,Not Adjusted,2159,2219,60,2.7
14760,2019,March,Hays                                                 ,Not Adjusted,116378,119665,3287,2.7
14761,2019,June,Hays                                                 ,Not Adjusted,117136,120751,3615,3.0
14762,2019,September,Hays                                                 ,Not Adjusted,118236,121597,3361,2.8
14763,2019,December,Hays                                                 ,Not Adjusted,119700,122718,3018,2.5
14764,2019,March,Hemphill                                             ,Not Adjusted,1873,1919,46,2.4
14765,2019,June,Hemphill                                             ,Not Adjusted,1962,2021,59,2.9
14766,2019,September,Hemphill                                             ,Not Adjusted,1875,1923,48,2.5
14767,2019,December,Hemphill                                             ,Not Adjusted,2154,2203,49,2.2
14768,2019,March,Henderson                                            ,Not Adjusted,35097,36396,1299,3.6
14769,2019,June,Henderson                                            ,Not Adjusted,35346,36741,1395,3.8
14770,2019,September,Henderson                                            ,Not Adjusted,35555,36816,1261,3.4
14771,2019,December,Henderson                                            ,Not Adjusted,35818,36997,1179,3.2
14772,2019,March,Hidalgo                                              ,Not Adjusted,330696,350867,20171,5.7
14773,2019,June,Hidalgo                                              ,Not Adjusted,327514,350836,23322,6.6
14774,2019,September,Hidalgo                                              ,Not Adjusted,330632,351718,21086,6.0
14775,2019,December,Hidalgo                                              ,Not Adjusted,335985,360907,24922,6.9
14776,2019,March,Hill                                                 ,Not Adjusted,15782,16334,552,3.4
14777,2019,June,Hill                                                 ,Not Adjusted,15736,16326,590,3.6
14778,2019,September,Hill                                                 ,Not Adjusted,16027,16563,536,3.2
14779,2019,December,Hill                                                 ,Not Adjusted,16075,16564,489,3.0
14780,2019,March,Hockley                                              ,Not Adjusted,11019,11370,351,3.1
14781,2019,June,Hockley                                              ,Not Adjusted,10859,11233,374,3.3
14782,2019,September,Hockley                                              ,Not Adjusted,10874,11187,313,2.8
14783,2019,December,Hockley                                              ,Not Adjusted,10777,11064,287,2.6
14784,2019,March,Hood                                                 ,Not Adjusted,26629,27576,947,3.4
14785,2019,June,Hood                                                 ,Not Adjusted,26648,27662,1014,3.7
14786,2019,September,Hood                                                 ,Not Adjusted,26988,27929,941,3.4
14787,2019,December,Hood                                                 ,Not Adjusted,27290,28178,888,3.2
14788,2019,March,Hopkins                                              ,Not Adjusted,16978,17542,564,3.2
14789,2019,June,Hopkins                                              ,Not Adjusted,16965,17524,559,3.2
14790,2019,September,Hopkins                                              ,Not Adjusted,17083,17590,507,2.9
14791,2019,December,Hopkins                                              ,Not Adjusted,17140,17629,489,2.8
14792,2019,March,Houston                                              ,Not Adjusted,9845,10157,312,3.1
14793,2019,June,Houston                                              ,Not Adjusted,10050,10412,362,3.5
14794,2019,September,Houston                                              ,Not Adjusted,10112,10421,309,3.0
14795,2019,December,Houston                                              ,Not Adjusted,9912,10218,306,3.0
14796,2019,March,Howard                                               ,Not Adjusted,13514,13956,442,3.2
14797,2019,June,Howard                                               ,Not Adjusted,13579,14047,468,3.3
14798,2019,September,Howard                                               ,Not Adjusted,13628,14066,438,3.1
14799,2019,December,Howard                                               ,Not Adjusted,13651,14070,419,3.0
14800,2019,March,Hudspeth                                             ,Not Adjusted,1793,1868,75,4.0
14801,2019,June,Hudspeth                                             ,Not Adjusted,1761,1845,84,4.6
14802,2019,September,Hudspeth                                             ,Not Adjusted,1796,1887,91,4.8
14803,2019,December,Hudspeth                                             ,Not Adjusted,1794,1868,74,4.0
14804,2019,March,Hunt                                                 ,Not Adjusted,41686,43228,1542,3.6
14805,2019,June,Hunt                                                 ,Not Adjusted,41944,43638,1694,3.9
14806,2019,September,Hunt                                                 ,Not Adjusted,42471,43986,1515,3.4
14807,2019,December,Hunt                                                 ,Not Adjusted,42938,44376,1438,3.2
14808,2019,March,Hutchinson                                           ,Not Adjusted,8177,8536,359,4.2
14809,2019,June,Hutchinson                                           ,Not Adjusted,8419,8827,408,4.6
14810,2019,September,Hutchinson                                           ,Not Adjusted,8352,8736,384,4.4
14811,2019,December,Hutchinson                                           ,Not Adjusted,8225,8609,384,4.5
14812,2019,March,Irion                                                ,Not Adjusted,753,772,19,2.5
14813,2019,June,Irion                                                ,Not Adjusted,740,759,19,2.5
14814,2019,September,Irion                                                ,Not Adjusted,746,764,18,2.4
14815,2019,December,Irion                                                ,Not Adjusted,742,758,16,2.1
14816,2019,March,Jack                                                 ,Not Adjusted,3341,3449,108,3.1
14817,2019,June,Jack                                                 ,Not Adjusted,3385,3494,109,3.1
14818,2019,September,Jack                                                 ,Not Adjusted,3368,3479,111,3.2
14819,2019,December,Jack                                                 ,Not Adjusted,3352,3457,105,3.0
14820,2019,March,Jackson                                              ,Not Adjusted,7210,7434,224,3.0
14821,2019,June,Jackson                                              ,Not Adjusted,7336,7582,246,3.2
14822,2019,September,Jackson                                              ,Not Adjusted,7402,7616,214,2.8
14823,2019,December,Jackson                                              ,Not Adjusted,7315,7529,214,2.8
14824,2019,March,Jasper                                               ,Not Adjusted,12159,12923,764,5.9
14825,2019,June,Jasper                                               ,Not Adjusted,11994,12816,822,6.4
14826,2019,September,Jasper                                               ,Not Adjusted,12041,12785,744,5.8
14827,2019,December,Jasper                                               ,Not Adjusted,12028,12856,828,6.4
14828,2019,March,Jeff Davis                                           ,Not Adjusted,1054,1085,31,2.9
14829,2019,June,Jeff Davis                                           ,Not Adjusted,1032,1060,28,2.6
14830,2019,September,Jeff Davis                                           ,Not Adjusted,987,1018,31,3.0
14831,2019,December,Jeff Davis                                           ,Not Adjusted,981,1010,29,2.9
14832,2019,March,Jefferson                                            ,Not Adjusted,100130,105944,5814,5.5
14833,2019,June,Jefferson                                            ,Not Adjusted,98929,105558,6629,6.3
14834,2019,September,Jefferson                                            ,Not Adjusted,99901,106040,6139,5.8
14835,2019,December,Jefferson                                            ,Not Adjusted,100243,106331,6088,5.7
14836,2019,March,Jim Hogg                                             ,Not Adjusted,1804,1901,97,5.1
14837,2019,June,Jim Hogg                                             ,Not Adjusted,1753,1849,96,5.2
14838,2019,September,Jim Hogg                                             ,Not Adjusted,1792,1873,81,4.3
14839,2019,December,Jim Hogg                                             ,Not Adjusted,1809,1890,81,4.3
14840,2019,March,Jim Wells                                            ,Not Adjusted,16164,16947,783,4.6
14841,2019,June,Jim Wells                                            ,Not Adjusted,16096,16944,848,5.0
14842,2019,September,Jim Wells                                            ,Not Adjusted,15950,16677,727,4.4
14843,2019,December,Jim Wells                                            ,Not Adjusted,15852,16686,834,5.0
14844,2019,March,Johnson                                              ,Not Adjusted,79957,82666,2709,3.3
14845,2019,June,Johnson                                              ,Not Adjusted,80225,83117,2892,3.5
14846,2019,September,Johnson                                              ,Not Adjusted,81284,83898,2614,3.1
14847,2019,December,Johnson                                              ,Not Adjusted,82211,84654,2443,2.9
14848,2019,March,Jones                                                ,Not Adjusted,5519,5789,270,4.7
14849,2019,June,Jones                                                ,Not Adjusted,5491,5753,262,4.6
14850,2019,September,Jones                                                ,Not Adjusted,5607,5848,241,4.1
14851,2019,December,Jones                                                ,Not Adjusted,5616,5844,228,3.9
14852,2019,March,Karnes                                               ,Not Adjusted,6876,7047,171,2.4
14853,2019,June,Karnes                                               ,Not Adjusted,6968,7161,193,2.7
14854,2019,September,Karnes                                               ,Not Adjusted,7046,7229,183,2.5
14855,2019,December,Karnes                                               ,Not Adjusted,7066,7233,167,2.3
14856,2019,March,Kaufman                                              ,Not Adjusted,64346,66540,2194,3.3
14857,2019,June,Kaufman                                              ,Not Adjusted,64851,67199,2348,3.5
14858,2019,September,Kaufman                                              ,Not Adjusted,65682,67799,2117,3.1
14859,2019,December,Kaufman                                              ,Not Adjusted,66412,68387,1975,2.9
14860,2019,March,Kendall                                              ,Not Adjusted,21988,22615,627,2.8
14861,2019,June,Kendall                                              ,Not Adjusted,21998,22663,665,2.9
14862,2019,September,Kendall                                              ,Not Adjusted,22162,22770,608,2.7
14863,2019,December,Kendall                                              ,Not Adjusted,22271,22817,546,2.4
14864,2019,March,Kenedy                                               ,Not Adjusted,235,243,8,3.3
14865,2019,June,Kenedy                                               ,Not Adjusted,221,228,7,3.1
14866,2019,September,Kenedy                                               ,Not Adjusted,216,225,9,4.0
14867,2019,December,Kenedy                                               ,Not Adjusted,214,223,9,4.0
14868,2019,March,Kent                                                 ,Not Adjusted,452,462,10,2.2
14869,2019,June,Kent                                                 ,Not Adjusted,479,491,12,2.4
14870,2019,September,Kent                                                 ,Not Adjusted,483,494,11,2.2
14871,2019,December,Kent                                                 ,Not Adjusted,430,443,13,2.9
14872,2019,March,Kerr                                                 ,Not Adjusted,21505,22170,665,3.0
14873,2019,June,Kerr                                                 ,Not Adjusted,21625,22320,695,3.1
14874,2019,September,Kerr                                                 ,Not Adjusted,21567,22217,650,2.9
14875,2019,December,Kerr                                                 ,Not Adjusted,21747,22322,575,2.6
14876,2019,March,Kimble                                               ,Not Adjusted,1786,1841,55,3.0
14877,2019,June,Kimble                                               ,Not Adjusted,1845,1907,62,3.3
14878,2019,September,Kimble                                               ,Not Adjusted,1769,1827,58,3.2
14879,2019,December,Kimble                                               ,Not Adjusted,1788,1839,51,2.8
14880,2019,March,King                                                 ,Not Adjusted,213,218,5,2.3
14881,2019,June,King                                                 ,Not Adjusted,223,228,5,2.2
14882,2019,September,King                                                 ,Not Adjusted,245,249,4,1.6
14883,2019,December,King                                                 ,Not Adjusted,251,255,4,1.6
14884,2019,March,Kinney                                               ,Not Adjusted,1333,1387,54,3.9
14885,2019,June,Kinney                                               ,Not Adjusted,1331,1380,49,3.6
14886,2019,September,Kinney                                               ,Not Adjusted,1347,1387,40,2.9
14887,2019,December,Kinney                                               ,Not Adjusted,1328,1380,52,3.8
14888,2019,March,Kleberg                                              ,Not Adjusted,13098,13657,559,4.1
14889,2019,June,Kleberg                                              ,Not Adjusted,12657,13285,628,4.7
14890,2019,September,Kleberg                                              ,Not Adjusted,12768,13336,568,4.3
14891,2019,December,Kleberg                                              ,Not Adjusted,13129,13662,533,3.9
14892,2019,March,Knox                                                 ,Not Adjusted,1408,1458,50,3.4
14893,2019,June,Knox                                                 ,Not Adjusted,1409,1456,47,3.2
14894,2019,September,Knox                                                 ,Not Adjusted,1390,1434,44,3.1
14895,2019,December,Knox                                                 ,Not Adjusted,1391,1430,39,2.7
14896,2019,March,Lamar                                                ,Not Adjusted,23158,23971,813,3.4
14897,2019,June,Lamar                                                ,Not Adjusted,22916,23757,841,3.5
14898,2019,September,Lamar                                                ,Not Adjusted,23463,24248,785,3.2
14899,2019,December,Lamar                                                ,Not Adjusted,23086,23819,733,3.1
14900,2019,March,Lamb                                                 ,Not Adjusted,5120,5336,216,4.0
14901,2019,June,Lamb                                                 ,Not Adjusted,5083,5298,215,4.1
14902,2019,September,Lamb                                                 ,Not Adjusted,5101,5297,196,3.7
14903,2019,December,Lamb                                                 ,Not Adjusted,5025,5197,172,3.3
14904,2019,March,Lampasas                                             ,Not Adjusted,8773,9082,309,3.4
14905,2019,June,Lampasas                                             ,Not Adjusted,8758,9083,325,3.6
14906,2019,September,Lampasas                                             ,Not Adjusted,8847,9133,286,3.1
14907,2019,December,Lampasas                                             ,Not Adjusted,8905,9183,278,3.0
14908,2019,March,La Salle                                             ,Not Adjusted,4286,4390,104,2.4
14909,2019,June,La Salle                                             ,Not Adjusted,4217,4325,108,2.5
14910,2019,September,La Salle                                             ,Not Adjusted,4222,4334,112,2.6
14911,2019,December,La Salle                                             ,Not Adjusted,4169,4275,106,2.5
14912,2019,March,Lavaca                                               ,Not Adjusted,8334,8598,264,3.1
14913,2019,June,Lavaca                                               ,Not Adjusted,8395,8680,285,3.3
14914,2019,September,Lavaca                                               ,Not Adjusted,8362,8610,248,2.9
14915,2019,December,Lavaca                                               ,Not Adjusted,8381,8601,220,2.6
14916,2019,March,Lee                                                  ,Not Adjusted,9968,10243,275,2.7
14917,2019,June,Lee                                                  ,Not Adjusted,9871,10160,289,2.8
14918,2019,September,Lee                                                  ,Not Adjusted,9859,10115,256,2.5
14919,2019,December,Lee                                                  ,Not Adjusted,9626,9873,247,2.5
14920,2019,March,Leon                                                 ,Not Adjusted,6035,6295,260,4.1
14921,2019,June,Leon                                                 ,Not Adjusted,6046,6342,296,4.7
14922,2019,September,Leon                                                 ,Not Adjusted,6101,6390,289,4.5
14923,2019,December,Leon                                                 ,Not Adjusted,6069,6324,255,4.0
14924,2019,March,Liberty                                              ,Not Adjusted,31681,33274,1593,4.8
14925,2019,June,Liberty                                              ,Not Adjusted,31715,33532,1817,5.4
14926,2019,September,Liberty                                              ,Not Adjusted,31952,33559,1607,4.8
14927,2019,December,Liberty                                              ,Not Adjusted,32076,33833,1757,5.2
14928,2019,March,Limestone                                            ,Not Adjusted,8282,8609,327,3.8
14929,2019,June,Limestone                                            ,Not Adjusted,8241,8599,358,4.2
14930,2019,September,Limestone                                            ,Not Adjusted,8306,8619,313,3.6
14931,2019,December,Limestone                                            ,Not Adjusted,8337,8648,311,3.6
14932,2019,March,Lipscomb                                             ,Not Adjusted,1599,1644,45,2.7
14933,2019,June,Lipscomb                                             ,Not Adjusted,1593,1643,50,3.0
14934,2019,September,Lipscomb                                             ,Not Adjusted,1571,1612,41,2.5
14935,2019,December,Lipscomb                                             ,Not Adjusted,1522,1557,35,2.2
14936,2019,March,Live Oak                                             ,Not Adjusted,5347,5518,171,3.1
14937,2019,June,Live Oak                                             ,Not Adjusted,5372,5558,186,3.3
14938,2019,September,Live Oak                                             ,Not Adjusted,5494,5660,166,2.9
14939,2019,December,Live Oak                                             ,Not Adjusted,5427,5583,156,2.8
14940,2019,March,Llano                                                ,Not Adjusted,8224,8533,309,3.6
14941,2019,June,Llano                                                ,Not Adjusted,8445,8757,312,3.6
14942,2019,September,Llano                                                ,Not Adjusted,8485,8778,293,3.3
14943,2019,December,Llano                                                ,Not Adjusted,8302,8576,274,3.2
14944,2019,March,Loving                                               ,Not Adjusted,401,405,4,1.0
14945,2019,June,Loving                                               ,Not Adjusted,580,585,5,0.9
14946,2019,September,Loving                                               ,Not Adjusted,611,615,4,0.7
14947,2019,December,Loving                                               ,Not Adjusted,403,407,4,1.0
14948,2019,March,Lubbock                                              ,Not Adjusted,152866,157702,4836,3.1
14949,2019,June,Lubbock                                              ,Not Adjusted,152676,157916,5240,3.3
14950,2019,September,Lubbock                                              ,Not Adjusted,153988,158305,4317,2.7
14951,2019,December,Lubbock                                              ,Not Adjusted,154760,158602,3842,2.4
14952,2019,March,Lynn                                                 ,Not Adjusted,2716,2801,85,3.0
14953,2019,June,Lynn                                                 ,Not Adjusted,2688,2780,92,3.3
14954,2019,September,Lynn                                                 ,Not Adjusted,2706,2791,85,3.0
14955,2019,December,Lynn                                                 ,Not Adjusted,2701,2778,77,2.8
14956,2019,March,McCulloch                                            ,Not Adjusted,3553,3714,161,4.3
14957,2019,June,McCulloch                                            ,Not Adjusted,3213,3428,215,6.3
14958,2019,September,McCulloch                                            ,Not Adjusted,3182,3369,187,5.6
14959,2019,December,McCulloch                                            ,Not Adjusted,3207,3353,146,4.4
14960,2019,March,McLennan                                             ,Not Adjusted,114887,118869,3982,3.3
14961,2019,June,McLennan                                             ,Not Adjusted,114952,119396,4444,3.7
14962,2019,September,McLennan                                             ,Not Adjusted,115837,119688,3851,3.2
14963,2019,December,McLennan                                             ,Not Adjusted,115647,119197,3550,3.0
14964,2019,March,McMullen                                             ,Not Adjusted,758,772,14,1.8
14965,2019,June,McMullen                                             ,Not Adjusted,772,783,11,1.4
14966,2019,September,McMullen                                             ,Not Adjusted,873,887,14,1.6
14967,2019,December,McMullen                                             ,Not Adjusted,837,850,13,1.5
14968,2019,March,Madison                                              ,Not Adjusted,4426,4602,176,3.8
14969,2019,June,Madison                                              ,Not Adjusted,4300,4528,228,5.0
14970,2019,September,Madison                                              ,Not Adjusted,4338,4534,196,4.3
14971,2019,December,Madison                                              ,Not Adjusted,4352,4521,169,3.7
14972,2019,March,Marion                                               ,Not Adjusted,4058,4244,186,4.4
14973,2019,June,Marion                                               ,Not Adjusted,4034,4209,175,4.2
14974,2019,September,Marion                                               ,Not Adjusted,4055,4221,166,3.9
14975,2019,December,Marion                                               ,Not Adjusted,4037,4225,188,4.4
14976,2019,March,Martin                                               ,Not Adjusted,2737,2804,67,2.4
14977,2019,June,Martin                                               ,Not Adjusted,2746,2823,77,2.7
14978,2019,September,Martin                                               ,Not Adjusted,2757,2832,75,2.6
14979,2019,December,Martin                                               ,Not Adjusted,2716,2796,80,2.9
14980,2019,March,Mason                                                ,Not Adjusted,1728,1786,58,3.2
14981,2019,June,Mason                                                ,Not Adjusted,1747,1808,61,3.4
14982,2019,September,Mason                                                ,Not Adjusted,1689,1741,52,3.0
14983,2019,December,Mason                                                ,Not Adjusted,1671,1725,54,3.1
14984,2019,March,Matagorda                                            ,Not Adjusted,15803,16657,854,5.1
14985,2019,June,Matagorda                                            ,Not Adjusted,15720,16740,1020,6.1
14986,2019,September,Matagorda                                            ,Not Adjusted,15838,16787,949,5.7
14987,2019,December,Matagorda                                            ,Not Adjusted,15715,16725,1010,6.0
14988,2019,March,Maverick                                             ,Not Adjusted,22220,24157,1937,8.0
14989,2019,June,Maverick                                             ,Not Adjusted,22066,23899,1833,7.7
14990,2019,September,Maverick                                             ,Not Adjusted,21710,23188,1478,6.4
14991,2019,December,Maverick                                             ,Not Adjusted,21880,23778,1898,8.0
14992,2019,March,Medina                                               ,Not Adjusted,21008,21698,690,3.2
14993,2019,June,Medina                                               ,Not Adjusted,21064,21795,731,3.4
14994,2019,September,Medina                                               ,Not Adjusted,21223,21907,684,3.1
14995,2019,December,Medina                                               ,Not Adjusted,21316,21958,642,2.9
14996,2019,March,Menard                                               ,Not Adjusted,804,834,30,3.6
14997,2019,June,Menard                                               ,Not Adjusted,833,863,30,3.5
14998,2019,September,Menard                                               ,Not Adjusted,861,892,31,3.5
14999,2019,December,Menard                                               ,Not Adjusted,865,891,26,2.9
15000,2019,March,Midland                                              ,Not Adjusted,103616,105798,2182,2.1
15001,2019,June,Midland                                              ,Not Adjusted,104705,107052,2347,2.2
15002,2019,September,Midland                                              ,Not Adjusted,105175,107416,2241,2.1
15003,2019,December,Midland                                              ,Not Adjusted,103839,106012,2173,2.0
15004,2019,March,Milam                                                ,Not Adjusted,9288,9807,519,5.3
15005,2019,June,Milam                                                ,Not Adjusted,9315,9824,509,5.2
15006,2019,September,Milam                                                ,Not Adjusted,9315,9747,432,4.4
15007,2019,December,Milam                                                ,Not Adjusted,9277,9680,403,4.2
15008,2019,March,Mills                                                ,Not Adjusted,1837,1907,70,3.7
15009,2019,June,Mills                                                ,Not Adjusted,1809,1871,62,3.3
15010,2019,September,Mills                                                ,Not Adjusted,1850,1905,55,2.9
15011,2019,December,Mills                                                ,Not Adjusted,1816,1871,55,2.9
15012,2019,March,Mitchell                                             ,Not Adjusted,2236,2320,84,3.6
15013,2019,June,Mitchell                                             ,Not Adjusted,2249,2345,96,4.1
15014,2019,September,Mitchell                                             ,Not Adjusted,2251,2337,86,3.7
15015,2019,December,Mitchell                                             ,Not Adjusted,2274,2350,76,3.2
15016,2019,March,Montague                                             ,Not Adjusted,8913,9186,273,3.0
15017,2019,June,Montague                                             ,Not Adjusted,9120,9401,281,3.0
15018,2019,September,Montague                                             ,Not Adjusted,9124,9396,272,2.9
15019,2019,December,Montague                                             ,Not Adjusted,8980,9216,236,2.6
15020,2019,March,Montgomery                                           ,Not Adjusted,278069,287675,9606,3.3
15021,2019,June,Montgomery                                           ,Not Adjusted,278418,288842,10424,3.6
15022,2019,September,Montgomery                                           ,Not Adjusted,280510,290145,9635,3.3
15023,2019,December,Montgomery                                           ,Not Adjusted,281770,290976,9206,3.2
15024,2019,March,Moore                                                ,Not Adjusted,10627,10873,246,2.3
15025,2019,June,Moore                                                ,Not Adjusted,10710,10984,274,2.5
15026,2019,September,Moore                                                ,Not Adjusted,10646,10894,248,2.3
15027,2019,December,Moore                                                ,Not Adjusted,10383,10616,233,2.2
15028,2019,March,Morris                                               ,Not Adjusted,4519,4772,253,5.3
15029,2019,June,Morris                                               ,Not Adjusted,4563,4830,267,5.5
15030,2019,September,Morris                                               ,Not Adjusted,4606,4851,245,5.1
15031,2019,December,Morris                                               ,Not Adjusted,4567,4822,255,5.3
15032,2019,March,Motley                                               ,Not Adjusted,461,480,19,4.0
15033,2019,June,Motley                                               ,Not Adjusted,462,481,19,4.0
15034,2019,September,Motley                                               ,Not Adjusted,460,476,16,3.4
15035,2019,December,Motley                                               ,Not Adjusted,436,449,13,2.9
15036,2019,March,Nacogdoches                                          ,Not Adjusted,27450,28439,989,3.5
15037,2019,June,Nacogdoches                                          ,Not Adjusted,26663,27874,1211,4.3
15038,2019,September,Nacogdoches                                          ,Not Adjusted,27135,28149,1014,3.6
15039,2019,December,Nacogdoches                                          ,Not Adjusted,27304,28241,937,3.3
15040,2019,March,Navarro                                              ,Not Adjusted,22633,23505,872,3.7
15041,2019,June,Navarro                                              ,Not Adjusted,23005,23827,822,3.4
15042,2019,September,Navarro                                              ,Not Adjusted,23695,24422,727,3.0
15043,2019,December,Navarro                                              ,Not Adjusted,23173,23853,680,2.9
15044,2019,March,Newton                                               ,Not Adjusted,4843,5138,295,5.7
15045,2019,June,Newton                                               ,Not Adjusted,4783,5128,345,6.7
15046,2019,September,Newton                                               ,Not Adjusted,4829,5141,312,6.1
15047,2019,December,Newton                                               ,Not Adjusted,4842,5171,329,6.4
15048,2019,March,Nolan                                                ,Not Adjusted,6660,6866,206,3.0
15049,2019,June,Nolan                                                ,Not Adjusted,6861,7085,224,3.2
15050,2019,September,Nolan                                                ,Not Adjusted,7011,7221,210,2.9
15051,2019,December,Nolan                                                ,Not Adjusted,6892,7080,188,2.7
15052,2019,March,Nueces                                               ,Not Adjusted,160154,167147,6993,4.2
15053,2019,June,Nueces                                               ,Not Adjusted,160064,167354,7290,4.4
15054,2019,September,Nueces                                               ,Not Adjusted,159722,166306,6584,4.0
15055,2019,December,Nueces                                               ,Not Adjusted,160227,166875,6648,4.0
15056,2019,March,Ochiltree                                            ,Not Adjusted,4241,4354,113,2.6
15057,2019,June,Ochiltree                                            ,Not Adjusted,4162,4283,121,2.8
15058,2019,September,Ochiltree                                            ,Not Adjusted,4209,4321,112,2.6
15059,2019,December,Ochiltree                                            ,Not Adjusted,4099,4227,128,3.0
15060,2019,March,Oldham                                               ,Not Adjusted,889,915,26,2.8
15061,2019,June,Oldham                                               ,Not Adjusted,883,913,30,3.3
15062,2019,September,Oldham                                               ,Not Adjusted,884,910,26,2.9
15063,2019,December,Oldham                                               ,Not Adjusted,887,912,25,2.7
15064,2019,March,Orange                                               ,Not Adjusted,34698,36478,1780,4.9
15065,2019,June,Orange                                               ,Not Adjusted,34287,36276,1989,5.5
15066,2019,September,Orange                                               ,Not Adjusted,34623,36468,1845,5.1
15067,2019,December,Orange                                               ,Not Adjusted,34750,36576,1826,5.0
15068,2019,March,Palo Pinto                                           ,Not Adjusted,13152,13599,447,3.3
15069,2019,June,Palo Pinto                                           ,Not Adjusted,13252,13715,463,3.4
15070,2019,September,Palo Pinto                                           ,Not Adjusted,13183,13595,412,3.0
15071,2019,December,Palo Pinto                                           ,Not Adjusted,13096,13467,371,2.8
15072,2019,March,Panola                                               ,Not Adjusted,10053,10470,417,4.0
15073,2019,June,Panola                                               ,Not Adjusted,9650,10082,432,4.3
15074,2019,September,Panola                                               ,Not Adjusted,9632,10037,405,4.0
15075,2019,December,Panola                                               ,Not Adjusted,9285,9681,396,4.1
15076,2019,March,Parker                                               ,Not Adjusted,66206,68209,2003,2.9
15077,2019,June,Parker                                               ,Not Adjusted,66360,68504,2144,3.1
15078,2019,September,Parker                                               ,Not Adjusted,67225,69176,1951,2.8
15079,2019,December,Parker                                               ,Not Adjusted,67978,69815,1837,2.6
15080,2019,March,Parmer                                               ,Not Adjusted,4751,4865,114,2.3
15081,2019,June,Parmer                                               ,Not Adjusted,4784,4903,119,2.4
15082,2019,September,Parmer                                               ,Not Adjusted,4735,4837,102,2.1
15083,2019,December,Parmer                                               ,Not Adjusted,4756,4851,95,2.0
15084,2019,March,Pecos                                                ,Not Adjusted,6241,6441,200,3.1
15085,2019,June,Pecos                                                ,Not Adjusted,6268,6481,213,3.3
15086,2019,September,Pecos                                                ,Not Adjusted,6125,6325,200,3.2
15087,2019,December,Pecos                                                ,Not Adjusted,6020,6234,214,3.4
15088,2019,March,Polk                                                 ,Not Adjusted,17226,18064,838,4.6
15089,2019,June,Polk                                                 ,Not Adjusted,17065,17953,888,4.9
15090,2019,September,Polk                                                 ,Not Adjusted,17243,18062,819,4.5
15091,2019,December,Polk                                                 ,Not Adjusted,17301,18202,901,5.0
15092,2019,March,Potter                                               ,Not Adjusted,52739,54279,1540,2.8
15093,2019,June,Potter                                               ,Not Adjusted,52743,54384,1641,3.0
15094,2019,September,Potter                                               ,Not Adjusted,52813,54277,1464,2.7
15095,2019,December,Potter                                               ,Not Adjusted,53313,54661,1348,2.5
15096,2019,March,Presidio                                             ,Not Adjusted,2872,3033,161,5.3
15097,2019,June,Presidio                                             ,Not Adjusted,2909,3109,200,6.4
15098,2019,September,Presidio                                             ,Not Adjusted,2919,3127,208,6.7
15099,2019,December,Presidio                                             ,Not Adjusted,2976,3238,262,8.1
15100,2019,March,Rains                                                ,Not Adjusted,5892,6083,191,3.1
15101,2019,June,Rains                                                ,Not Adjusted,5836,6029,193,3.2
15102,2019,September,Rains                                                ,Not Adjusted,5817,5998,181,3.0
15103,2019,December,Rains                                                ,Not Adjusted,5941,6104,163,2.7
15104,2019,March,Randall                                              ,Not Adjusted,71165,72967,1802,2.5
15105,2019,June,Randall                                              ,Not Adjusted,71224,73131,1907,2.6
15106,2019,September,Randall                                              ,Not Adjusted,71307,73023,1716,2.3
15107,2019,December,Randall                                              ,Not Adjusted,71931,73461,1530,2.1
15108,2019,March,Reagan                                               ,Not Adjusted,1816,1857,41,2.2
15109,2019,June,Reagan                                               ,Not Adjusted,1903,1956,53,2.7
15110,2019,September,Reagan                                               ,Not Adjusted,1858,1912,54,2.8
15111,2019,December,Reagan                                               ,Not Adjusted,1792,1852,60,3.2
15112,2019,March,Real                                                 ,Not Adjusted,994,1037,43,4.1
15113,2019,June,Real                                                 ,Not Adjusted,1170,1221,51,4.2
15114,2019,September,Real                                                 ,Not Adjusted,956,996,40,4.0
15115,2019,December,Real                                                 ,Not Adjusted,979,1014,35,3.5
15116,2019,March,Red River                                            ,Not Adjusted,4807,5039,232,4.6
15117,2019,June,Red River                                            ,Not Adjusted,4827,5066,239,4.7
15118,2019,September,Red River                                            ,Not Adjusted,4892,5120,228,4.5
15119,2019,December,Red River                                            ,Not Adjusted,4859,5077,218,4.3
15120,2019,March,Reeves                                               ,Not Adjusted,10856,11041,185,1.7
15121,2019,June,Reeves                                               ,Not Adjusted,11359,11574,215,1.9
15122,2019,September,Reeves                                               ,Not Adjusted,10988,11202,214,1.9
15123,2019,December,Reeves                                               ,Not Adjusted,10619,10826,207,1.9
15124,2019,March,Refugio                                              ,Not Adjusted,3038,3150,112,3.6
15125,2019,June,Refugio                                              ,Not Adjusted,3039,3162,123,3.9
15126,2019,September,Refugio                                              ,Not Adjusted,3023,3139,116,3.7
15127,2019,December,Refugio                                              ,Not Adjusted,3035,3138,103,3.3
15128,2019,March,Roberts                                              ,Not Adjusted,394,407,13,3.2
15129,2019,June,Roberts                                              ,Not Adjusted,412,427,15,3.5
15130,2019,September,Roberts                                              ,Not Adjusted,412,423,11,2.6
15131,2019,December,Roberts                                              ,Not Adjusted,417,427,10,2.3
15132,2019,March,Robertson                                            ,Not Adjusted,7335,7609,274,3.6
15133,2019,June,Robertson                                            ,Not Adjusted,6924,7209,285,4.0
15134,2019,September,Robertson                                            ,Not Adjusted,7284,7545,261,3.5
15135,2019,December,Robertson                                            ,Not Adjusted,7332,7578,246,3.2
15136,2019,March,Rockwall                                             ,Not Adjusted,51225,52860,1635,3.1
15137,2019,June,Rockwall                                             ,Not Adjusted,51579,53339,1760,3.3
15138,2019,September,Rockwall                                             ,Not Adjusted,52235,53867,1632,3.0
15139,2019,December,Rockwall                                             ,Not Adjusted,52828,54308,1480,2.7
15140,2019,March,Runnels                                              ,Not Adjusted,4427,4559,132,2.9
15141,2019,June,Runnels                                              ,Not Adjusted,4516,4655,139,3.0
15142,2019,September,Runnels                                              ,Not Adjusted,4503,4626,123,2.7
15143,2019,December,Runnels                                              ,Not Adjusted,4479,4597,118,2.6
15144,2019,March,Rusk                                                 ,Not Adjusted,22077,22852,775,3.4
15145,2019,June,Rusk                                                 ,Not Adjusted,21985,22853,868,3.8
15146,2019,September,Rusk                                                 ,Not Adjusted,22176,22995,819,3.6
15147,2019,December,Rusk                                                 ,Not Adjusted,22072,22871,799,3.5
15148,2019,March,Sabine                                               ,Not Adjusted,3485,3725,240,6.4
15149,2019,June,Sabine                                               ,Not Adjusted,3539,3812,273,7.2
15150,2019,September,Sabine                                               ,Not Adjusted,3489,3717,228,6.1
15151,2019,December,Sabine                                               ,Not Adjusted,3512,3749,237,6.3
15152,2019,March,San Augustine                                        ,Not Adjusted,3301,3451,150,4.3
15153,2019,June,San Augustine                                        ,Not Adjusted,3180,3338,158,4.7
15154,2019,September,San Augustine                                        ,Not Adjusted,3237,3394,157,4.6
15155,2019,December,San Augustine                                        ,Not Adjusted,3113,3295,182,5.5
15156,2019,March,San Jacinto                                          ,Not Adjusted,11200,11706,506,4.3
15157,2019,June,San Jacinto                                          ,Not Adjusted,11210,11771,561,4.8
15158,2019,September,San Jacinto                                          ,Not Adjusted,11269,11799,530,4.5
15159,2019,December,San Jacinto                                          ,Not Adjusted,11312,11859,547,4.6
15160,2019,March,San Patricio                                         ,Not Adjusted,28153,29774,1621,5.4
15161,2019,June,San Patricio                                         ,Not Adjusted,28136,29861,1725,5.8
15162,2019,September,San Patricio                                         ,Not Adjusted,28073,29664,1591,5.4
15163,2019,December,San Patricio                                         ,Not Adjusted,28136,29772,1636,5.5
15164,2019,March,San Saba                                             ,Not Adjusted,2527,2602,75,2.9
15165,2019,June,San Saba                                             ,Not Adjusted,2433,2513,80,3.2
15166,2019,September,San Saba                                             ,Not Adjusted,2457,2529,72,2.8
15167,2019,December,San Saba                                             ,Not Adjusted,2363,2439,76,3.1
15168,2019,March,Schleicher                                           ,Not Adjusted,1320,1353,33,2.4
15169,2019,June,Schleicher                                           ,Not Adjusted,1282,1320,38,2.9
15170,2019,September,Schleicher                                           ,Not Adjusted,1249,1287,38,3.0
15171,2019,December,Schleicher                                           ,Not Adjusted,1232,1270,38,3.0
15172,2019,March,Scurry                                               ,Not Adjusted,6448,6659,211,3.2
15173,2019,June,Scurry                                               ,Not Adjusted,6565,6823,258,3.8
15174,2019,September,Scurry                                               ,Not Adjusted,6472,6673,201,3.0
15175,2019,December,Scurry                                               ,Not Adjusted,6288,6492,204,3.1
15176,2019,March,Shackelford                                          ,Not Adjusted,1853,1899,46,2.4
15177,2019,June,Shackelford                                          ,Not Adjusted,1893,1938,45,2.3
15178,2019,September,Shackelford                                          ,Not Adjusted,1849,1889,40,2.1
15179,2019,December,Shackelford                                          ,Not Adjusted,1830,1868,38,2.0
15180,2019,March,Shelby                                               ,Not Adjusted,10582,11013,431,3.9
15181,2019,June,Shelby                                               ,Not Adjusted,10807,11266,459,4.1
15182,2019,September,Shelby                                               ,Not Adjusted,10849,11271,422,3.7
15183,2019,December,Shelby                                               ,Not Adjusted,10772,11204,432,3.9
15184,2019,March,Sherman                                              ,Not Adjusted,1366,1399,33,2.4
15185,2019,June,Sherman                                              ,Not Adjusted,1349,1385,36,2.6
15186,2019,September,Sherman                                              ,Not Adjusted,1344,1375,31,2.3
15187,2019,December,Sherman                                              ,Not Adjusted,1340,1366,26,1.9
15188,2019,March,Smith                                                ,Not Adjusted,104120,107705,3585,3.3
15189,2019,June,Smith                                                ,Not Adjusted,104471,108351,3880,3.6
15190,2019,September,Smith                                                ,Not Adjusted,105021,108537,3516,3.2
15191,2019,December,Smith                                                ,Not Adjusted,105970,109290,3320,3.0
15192,2019,March,Somervell                                            ,Not Adjusted,4178,4334,156,3.6
15193,2019,June,Somervell                                            ,Not Adjusted,4189,4358,169,3.9
15194,2019,September,Somervell                                            ,Not Adjusted,4244,4398,154,3.5
15195,2019,December,Somervell                                            ,Not Adjusted,4293,4453,160,3.6
15196,2019,March,Starr                                                ,Not Adjusted,23277,25502,2225,8.7
15197,2019,June,Starr                                                ,Not Adjusted,22310,24812,2502,10.1
15198,2019,September,Starr                                                ,Not Adjusted,22172,24571,2399,9.8
15199,2019,December,Starr                                                ,Not Adjusted,22236,25410,3174,12.5
15200,2019,March,Stephens                                             ,Not Adjusted,4064,4190,126,3.0
15201,2019,June,Stephens                                             ,Not Adjusted,3936,4071,135,3.3
15202,2019,September,Stephens                                             ,Not Adjusted,3922,4044,122,3.0
15203,2019,December,Stephens                                             ,Not Adjusted,3920,4026,106,2.6
15204,2019,March,Sterling                                             ,Not Adjusted,566,582,16,2.7
15205,2019,June,Sterling                                             ,Not Adjusted,568,587,19,3.2
15206,2019,September,Sterling                                             ,Not Adjusted,556,573,17,3.0
15207,2019,December,Sterling                                             ,Not Adjusted,552,568,16,2.8
15208,2019,March,Stonewall                                            ,Not Adjusted,554,570,16,2.8
15209,2019,June,Stonewall                                            ,Not Adjusted,593,611,18,2.9
15210,2019,September,Stonewall                                            ,Not Adjusted,574,591,17,2.9
15211,2019,December,Stonewall                                            ,Not Adjusted,550,566,16,2.8
15212,2019,March,Sutton                                               ,Not Adjusted,1466,1518,52,3.4
15213,2019,June,Sutton                                               ,Not Adjusted,1476,1531,55,3.6
15214,2019,September,Sutton                                               ,Not Adjusted,1279,1331,52,3.9
15215,2019,December,Sutton                                               ,Not Adjusted,1246,1298,52,4.0
15216,2019,March,Swisher                                              ,Not Adjusted,2559,2660,101,3.8
15217,2019,June,Swisher                                              ,Not Adjusted,2524,2623,99,3.8
15218,2019,September,Swisher                                              ,Not Adjusted,2511,2600,89,3.4
15219,2019,December,Swisher                                              ,Not Adjusted,2471,2554,83,3.2
15220,2019,March,Tarrant                                              ,Not Adjusted,1033940,1069456,35516,3.3
15221,2019,June,Tarrant                                              ,Not Adjusted,1037887,1076158,38271,3.6
15222,2019,September,Tarrant                                              ,Not Adjusted,1051671,1086348,34677,3.2
15223,2019,December,Tarrant                                              ,Not Adjusted,1064004,1095781,31777,2.9
15224,2019,March,Taylor                                               ,Not Adjusted,64355,66280,1925,2.9
15225,2019,June,Taylor                                               ,Not Adjusted,64255,66368,2113,3.2
15226,2019,September,Taylor                                               ,Not Adjusted,65682,67549,1867,2.8
15227,2019,December,Taylor                                               ,Not Adjusted,65965,67668,1703,2.5
15228,2019,March,Terrell                                              ,Not Adjusted,362,375,13,3.5
15229,2019,June,Terrell                                              ,Not Adjusted,386,397,11,2.8
15230,2019,September,Terrell                                              ,Not Adjusted,356,372,16,4.3
15231,2019,December,Terrell                                              ,Not Adjusted,374,387,13,3.4
15232,2019,March,Terry                                                ,Not Adjusted,4894,5079,185,3.6
15233,2019,June,Terry                                                ,Not Adjusted,4816,5014,198,3.9
15234,2019,September,Terry                                                ,Not Adjusted,4767,4936,169,3.4
15235,2019,December,Terry                                                ,Not Adjusted,4714,4873,159,3.3
15236,2019,March,Throckmorton                                         ,Not Adjusted,638,661,23,3.5
15237,2019,June,Throckmorton                                         ,Not Adjusted,636,664,28,4.2
15238,2019,September,Throckmorton                                         ,Not Adjusted,626,653,27,4.1
15239,2019,December,Throckmorton                                         ,Not Adjusted,598,618,20,3.2
15240,2019,March,Titus                                                ,Not Adjusted,12264,12824,560,4.4
15241,2019,June,Titus                                                ,Not Adjusted,12407,12991,584,4.5
15242,2019,September,Titus                                                ,Not Adjusted,12611,13113,502,3.8
15243,2019,December,Titus                                                ,Not Adjusted,12574,13060,486,3.7
15244,2019,March,Tom Green                                            ,Not Adjusted,53210,54852,1642,3.0
15245,2019,June,Tom Green                                            ,Not Adjusted,52761,54568,1807,3.3
15246,2019,September,Tom Green                                            ,Not Adjusted,53254,54848,1594,2.9
15247,2019,December,Tom Green                                            ,Not Adjusted,53021,54530,1509,2.8
15248,2019,March,Travis                                               ,Not Adjusted,711444,730664,19220,2.6
15249,2019,June,Travis                                               ,Not Adjusted,715833,736298,20465,2.8
15250,2019,September,Travis                                               ,Not Adjusted,722555,741660,19105,2.6
15251,2019,December,Travis                                               ,Not Adjusted,731651,748945,17294,2.3
15252,2019,March,Trinity                                              ,Not Adjusted,5058,5300,242,4.6
15253,2019,June,Trinity                                              ,Not Adjusted,5051,5301,250,4.7
15254,2019,September,Trinity                                              ,Not Adjusted,5117,5365,248,4.6
15255,2019,December,Trinity                                              ,Not Adjusted,5009,5268,259,4.9
15256,2019,March,Tyler                                                ,Not Adjusted,6772,7159,387,5.4
15257,2019,June,Tyler                                                ,Not Adjusted,6731,7168,437,6.1
15258,2019,September,Tyler                                                ,Not Adjusted,6800,7191,391,5.4
15259,2019,December,Tyler                                                ,Not Adjusted,6731,7173,442,6.2
15260,2019,March,Upshur                                               ,Not Adjusted,17334,17991,657,3.7
15261,2019,June,Upshur                                               ,Not Adjusted,17263,17938,675,3.8
15262,2019,September,Upshur                                               ,Not Adjusted,17412,18052,640,3.5
15263,2019,December,Upshur                                               ,Not Adjusted,17331,17986,655,3.6
15264,2019,March,Upton                                                ,Not Adjusted,1580,1632,52,3.2
15265,2019,June,Upton                                                ,Not Adjusted,1656,1710,54,3.2
15266,2019,September,Upton                                                ,Not Adjusted,1613,1658,45,2.7
15267,2019,December,Upton                                                ,Not Adjusted,1570,1609,39,2.4
15268,2019,March,Uvalde                                               ,Not Adjusted,11046,11479,433,3.8
15269,2019,June,Uvalde                                               ,Not Adjusted,11230,11706,476,4.1
15270,2019,September,Uvalde                                               ,Not Adjusted,11119,11526,407,3.5
15271,2019,December,Uvalde                                               ,Not Adjusted,10956,11334,378,3.3
15272,2019,March,Val Verde                                            ,Not Adjusted,21933,22689,756,3.3
15273,2019,June,Val Verde                                            ,Not Adjusted,22341,23132,791,3.4
15274,2019,September,Val Verde                                            ,Not Adjusted,22234,22944,710,3.1
15275,2019,December,Val Verde                                            ,Not Adjusted,22405,23219,814,3.5
15276,2019,March,Van Zandt                                            ,Not Adjusted,25160,26026,866,3.3
15277,2019,June,Van Zandt                                            ,Not Adjusted,25550,26457,907,3.4
15278,2019,September,Van Zandt                                            ,Not Adjusted,25327,26160,833,3.2
15279,2019,December,Van Zandt                                            ,Not Adjusted,25309,26108,799,3.1
15280,2019,March,Victoria                                             ,Not Adjusted,41379,42836,1457,3.4
15281,2019,June,Victoria                                             ,Not Adjusted,40919,42471,1552,3.7
15282,2019,September,Victoria                                             ,Not Adjusted,40991,42422,1431,3.4
15283,2019,December,Victoria                                             ,Not Adjusted,40449,41882,1433,3.4
15284,2019,March,Walker                                               ,Not Adjusted,23268,24173,905,3.7
15285,2019,June,Walker                                               ,Not Adjusted,22895,23975,1080,4.5
15286,2019,September,Walker                                               ,Not Adjusted,23463,24411,948,3.9
15287,2019,December,Walker                                               ,Not Adjusted,23293,24127,834,3.5
15288,2019,March,Waller                                               ,Not Adjusted,23192,24078,886,3.7
15289,2019,June,Waller                                               ,Not Adjusted,23205,24236,1031,4.3
15290,2019,September,Waller                                               ,Not Adjusted,23375,24259,884,3.6
15291,2019,December,Waller                                               ,Not Adjusted,23454,24292,838,3.4
15292,2019,March,Ward                                                 ,Not Adjusted,7297,7465,168,2.3
15293,2019,June,Ward                                                 ,Not Adjusted,7293,7477,184,2.5
15294,2019,September,Ward                                                 ,Not Adjusted,7232,7399,167,2.3
15295,2019,December,Ward                                                 ,Not Adjusted,6764,6942,178,2.6
15296,2019,March,Washington                                           ,Not Adjusted,14462,15016,554,3.7
15297,2019,June,Washington                                           ,Not Adjusted,14552,15149,597,3.9
15298,2019,September,Washington                                           ,Not Adjusted,14943,15426,483,3.1
15299,2019,December,Washington                                           ,Not Adjusted,14828,15288,460,3.0
15300,2019,March,Webb                                                 ,Not Adjusted,113530,117940,4410,3.7
15301,2019,June,Webb                                                 ,Not Adjusted,113601,118412,4811,4.1
15302,2019,September,Webb                                                 ,Not Adjusted,114714,118767,4053,3.4
15303,2019,December,Webb                                                 ,Not Adjusted,115199,119414,4215,3.5
15304,2019,March,Wharton                                              ,Not Adjusted,20857,21554,697,3.2
15305,2019,June,Wharton                                              ,Not Adjusted,20967,21771,804,3.7
15306,2019,September,Wharton                                              ,Not Adjusted,21082,21812,730,3.3
15307,2019,December,Wharton                                              ,Not Adjusted,21134,21856,722,3.3
15308,2019,March,Wheeler                                              ,Not Adjusted,2203,2268,65,2.9
15309,2019,June,Wheeler                                              ,Not Adjusted,2201,2267,66,2.9
15310,2019,September,Wheeler                                              ,Not Adjusted,2183,2254,71,3.1
15311,2019,December,Wheeler                                              ,Not Adjusted,2201,2266,65,2.9
15312,2019,March,Wichita                                              ,Not Adjusted,54242,56019,1777,3.2
15313,2019,June,Wichita                                              ,Not Adjusted,54277,56286,2009,3.6
15314,2019,September,Wichita                                              ,Not Adjusted,54439,56145,1706,3.0
15315,2019,December,Wichita                                              ,Not Adjusted,54529,56144,1615,2.9
15316,2019,March,Wilbarger                                            ,Not Adjusted,4802,4987,185,3.7
15317,2019,June,Wilbarger                                            ,Not Adjusted,4768,4961,193,3.9
15318,2019,September,Wilbarger                                            ,Not Adjusted,4796,4956,160,3.2
15319,2019,December,Wilbarger                                            ,Not Adjusted,4731,4898,167,3.4
15320,2019,March,Willacy                                              ,Not Adjusted,6064,6598,534,8.1
15321,2019,June,Willacy                                              ,Not Adjusted,5902,6513,611,9.4
15322,2019,September,Willacy                                              ,Not Adjusted,6156,6653,497,7.5
15323,2019,December,Willacy                                              ,Not Adjusted,6095,6568,473,7.2
15324,2019,March,Williamson                                           ,Not Adjusted,306699,315665,8966,2.8
15325,2019,June,Williamson                                           ,Not Adjusted,308968,318468,9500,3.0
15326,2019,September,Williamson                                           ,Not Adjusted,311892,320833,8941,2.8
15327,2019,December,Williamson                                           ,Not Adjusted,315764,323821,8057,2.5
15328,2019,March,Wilson                                               ,Not Adjusted,24078,24790,712,2.9
15329,2019,June,Wilson                                               ,Not Adjusted,24169,24952,783,3.1
15330,2019,September,Wilson                                               ,Not Adjusted,24355,25031,676,2.7
15331,2019,December,Wilson                                               ,Not Adjusted,24481,25127,646,2.6
15332,2019,March,Winkler                                              ,Not Adjusted,4001,4112,111,2.7
15333,2019,June,Winkler                                              ,Not Adjusted,3865,3988,123,3.1
15334,2019,September,Winkler                                              ,Not Adjusted,3953,4075,122,3.0
15335,2019,December,Winkler                                              ,Not Adjusted,4029,4156,127,3.1
15336,2019,March,Wise                                                 ,Not Adjusted,31038,32146,1108,3.4
15337,2019,June,Wise                                                 ,Not Adjusted,31091,32284,1193,3.7
15338,2019,September,Wise                                                 ,Not Adjusted,31493,32483,990,3.0
15339,2019,December,Wise                                                 ,Not Adjusted,31833,32786,953,2.9
15340,2019,March,Wood                                                 ,Not Adjusted,16884,17571,687,3.9
15341,2019,June,Wood                                                 ,Not Adjusted,17061,17768,707,4.0
15342,2019,September,Wood                                                 ,Not Adjusted,17139,17820,681,3.8
15343,2019,December,Wood                                                 ,Not Adjusted,17119,17774,655,3.7
15344,2019,March,Yoakum                                               ,Not Adjusted,3718,3822,104,2.7
15345,2019,June,Yoakum                                               ,Not Adjusted,3744,3865,121,3.1
15346,2019,September,Yoakum                                               ,Not Adjusted,3614,3725,111,3.0
15347,2019,December,Yoakum                                               ,Not Adjusted,3526,3634,108,3.0
15348,2019,March,Young                                                ,Not Adjusted,7733,7968,235,2.9
15349,2019,June,Young                                                ,Not Adjusted,7802,8053,251,3.1
15350,2019,September,Young                                                ,Not Adjusted,7844,8076,232,2.9
15351,2019,December,Young                                                ,Not Adjusted,7684,7901,217,2.7
15352,2019,March,Zapata                                               ,Not Adjusted,5003,5253,250,4.8
15353,2019,June,Zapata                                               ,Not Adjusted,4830,5099,269,5.3
15354,2019,September,Zapata                                               ,Not Adjusted,4815,5046,231,4.6
15355,2019,December,Zapata                                               ,Not Adjusted,4715,4994,279,5.6
15356,2019,March,Zavala                                               ,Not Adjusted,3084,3358,274,8.2
15357,2019,June,Zavala                                               ,Not Adjusted,2991,3291,300,9.1
15358,2019,September,Zavala                                               ,Not Adjusted,3012,3278,266,8.1
15359,2019,December,Zavala                                               ,Not Adjusted,3216,3482,266,7.6
15360,2020,March,Texas,Not Adjusted,13248772,13953661,704889,5.1
15361,2020,March,Texas,Adjusted,13306781,13986789,680008,4.9
15362,2020,June,Texas,Not Adjusted,12620076,14074215,1454139,10.3
15363,2020,June,Texas,Adjusted,12638796,14068625,1429829,10.2
15364,2020,September,Texas,Not Adjusted,12877405,13993842,1116437,8.0
15365,2020,September,Texas,Adjusted,12872257,13978180,1105923,7.9
15366,2020,December,Texas,Not Adjusted,13191324,14139874,948550,6.7
15367,2020,December,Texas,Adjusted,13162510,14133518,971008,6.9
15368,2020,March,Anderson                                             ,Not Adjusted,22243,23203,960,4.1
15369,2020,June,Anderson                                             ,Not Adjusted,21910,23661,1751,7.4
15370,2020,September,Anderson                                             ,Not Adjusted,21932,23376,1444,6.2
15371,2020,December,Anderson                                             ,Not Adjusted,22154,23490,1336,5.7
15372,2020,March,Andrews                                              ,Not Adjusted,9126,9460,334,3.5
15373,2020,June,Andrews                                              ,Not Adjusted,8095,9247,1152,12.5
15374,2020,September,Andrews                                              ,Not Adjusted,8280,9153,873,9.5
15375,2020,December,Andrews                                              ,Not Adjusted,8303,9015,712,7.9
15376,2020,March,Angelina                                             ,Not Adjusted,33215,35267,2052,5.8
15377,2020,June,Angelina                                             ,Not Adjusted,32685,36274,3589,9.9
15378,2020,September,Angelina                                             ,Not Adjusted,32817,35699,2882,8.1
15379,2020,December,Angelina                                             ,Not Adjusted,33027,35595,2568,7.2
15380,2020,March,Aransas                                              ,Not Adjusted,8581,9144,563,6.2
15381,2020,June,Aransas                                              ,Not Adjusted,8202,9161,959,10.5
15382,2020,September,Aransas                                              ,Not Adjusted,8251,9052,801,8.8
15383,2020,December,Aransas                                              ,Not Adjusted,8307,9049,742,8.2
15384,2020,March,Archer                                               ,Not Adjusted,3782,3939,157,4.0
15385,2020,June,Archer                                               ,Not Adjusted,3667,3943,276,7.0
15386,2020,September,Archer                                               ,Not Adjusted,3677,3893,216,5.5
15387,2020,December,Archer                                               ,Not Adjusted,3742,3944,202,5.1
15388,2020,March,Armstrong                                            ,Not Adjusted,887,924,37,4.0
15389,2020,June,Armstrong                                            ,Not Adjusted,861,907,46,5.1
15390,2020,September,Armstrong                                            ,Not Adjusted,877,914,37,4.0
15391,2020,December,Armstrong                                            ,Not Adjusted,888,927,39,4.2
15392,2020,March,Atascosa                                             ,Not Adjusted,20433,21557,1124,5.2
15393,2020,June,Atascosa                                             ,Not Adjusted,19491,22011,2520,11.4
15394,2020,September,Atascosa                                             ,Not Adjusted,20032,22067,2035,9.2
15395,2020,December,Atascosa                                             ,Not Adjusted,20543,22246,1703,7.7
15396,2020,March,Austin                                               ,Not Adjusted,13210,13910,700,5.0
15397,2020,June,Austin                                               ,Not Adjusted,12492,13654,1162,8.5
15398,2020,September,Austin                                               ,Not Adjusted,12594,13541,947,7.0
15399,2020,December,Austin                                               ,Not Adjusted,12858,13737,879,6.4
15400,2020,March,Bailey                                               ,Not Adjusted,2331,2454,123,5.0
15401,2020,June,Bailey                                               ,Not Adjusted,2295,2442,147,6.0
15402,2020,September,Bailey                                               ,Not Adjusted,2316,2425,109,4.5
15403,2020,December,Bailey                                               ,Not Adjusted,2315,2438,123,5.0
15404,2020,March,Bandera                                              ,Not Adjusted,9470,9927,457,4.6
15405,2020,June,Bandera                                              ,Not Adjusted,9034,9784,750,7.7
15406,2020,September,Bandera                                              ,Not Adjusted,9292,9890,598,6.0
15407,2020,December,Bandera                                              ,Not Adjusted,9519,10052,533,5.3
15408,2020,March,Bastrop                                              ,Not Adjusted,40978,42733,1755,4.1
15409,2020,June,Bastrop                                              ,Not Adjusted,38942,42496,3554,8.4
15410,2020,September,Bastrop                                              ,Not Adjusted,40094,42684,2590,6.1
15411,2020,December,Bastrop                                              ,Not Adjusted,41215,43425,2210,5.1
15412,2020,March,Baylor                                               ,Not Adjusted,1710,1770,60,3.4
15413,2020,June,Baylor                                               ,Not Adjusted,1716,1796,80,4.5
15414,2020,September,Baylor                                               ,Not Adjusted,1720,1786,66,3.7
15415,2020,December,Baylor                                               ,Not Adjusted,1741,1800,59,3.3
15416,2020,March,Bee                                                  ,Not Adjusted,9359,10015,656,6.6
15417,2020,June,Bee                                                  ,Not Adjusted,8610,9960,1350,13.6
15418,2020,September,Bee                                                  ,Not Adjusted,8801,9914,1113,11.2
15419,2020,December,Bee                                                  ,Not Adjusted,8861,9813,952,9.7
15420,2020,March,Bell                                                 ,Not Adjusted,135602,143080,7478,5.2
15421,2020,June,Bell                                                 ,Not Adjusted,132162,145612,13450,9.2
15422,2020,September,Bell                                                 ,Not Adjusted,134741,145167,10426,7.2
15423,2020,December,Bell                                                 ,Not Adjusted,137091,146395,9304,6.4
15424,2020,March,Bexar                                                ,Not Adjusted,889643,931622,41979,4.5
15425,2020,June,Bexar                                                ,Not Adjusted,850226,948422,98196,10.4
15426,2020,September,Bexar                                                ,Not Adjusted,873829,947504,73675,7.8
15427,2020,December,Bexar                                                ,Not Adjusted,898537,958124,59587,6.2
15428,2020,March,Blanco                                               ,Not Adjusted,6400,6618,218,3.3
15429,2020,June,Blanco                                               ,Not Adjusted,6215,6529,314,4.8
15430,2020,September,Blanco                                               ,Not Adjusted,6333,6591,258,3.9
15431,2020,December,Blanco                                               ,Not Adjusted,6493,6722,229,3.4
15432,2020,March,Borden                                               ,Not Adjusted,426,442,16,3.6
15433,2020,June,Borden                                               ,Not Adjusted,365,383,18,4.7
15434,2020,September,Borden                                               ,Not Adjusted,425,440,15,3.4
15435,2020,December,Borden                                               ,Not Adjusted,461,475,14,2.9
15436,2020,March,Bosque                                               ,Not Adjusted,7869,8275,406,4.9
15437,2020,June,Bosque                                               ,Not Adjusted,7794,8373,579,6.9
15438,2020,September,Bosque                                               ,Not Adjusted,7924,8380,456,5.4
15439,2020,December,Bosque                                               ,Not Adjusted,8006,8446,440,5.2
15440,2020,March,Bowie                                                ,Not Adjusted,36624,38826,2202,5.7
15441,2020,June,Bowie                                                ,Not Adjusted,34991,38698,3707,9.6
15442,2020,September,Bowie                                                ,Not Adjusted,36052,38893,2841,7.3
15443,2020,December,Bowie                                                ,Not Adjusted,36711,39163,2452,6.3
15444,2020,March,Brazoria                                             ,Not Adjusted,168347,179272,10925,6.1
15445,2020,June,Brazoria                                             ,Not Adjusted,159411,179115,19704,11.0
15446,2020,September,Brazoria                                             ,Not Adjusted,160505,176679,16174,9.2
15447,2020,December,Brazoria                                             ,Not Adjusted,164341,179075,14734,8.2
15448,2020,March,Brazos                                               ,Not Adjusted,115179,119635,4456,3.7
15449,2020,June,Brazos                                               ,Not Adjusted,104589,113383,8794,7.8
15450,2020,September,Brazos                                               ,Not Adjusted,110258,116456,6198,5.3
15451,2020,December,Brazos                                               ,Not Adjusted,112362,117935,5573,4.7
15452,2020,March,Brewster                                             ,Not Adjusted,3878,4049,171,4.2
15453,2020,June,Brewster                                             ,Not Adjusted,3727,4103,376,9.2
15454,2020,September,Brewster                                             ,Not Adjusted,3795,4061,266,6.6
15455,2020,December,Brewster                                             ,Not Adjusted,3876,4114,238,5.8
15456,2020,March,Briscoe                                              ,Not Adjusted,551,583,32,5.5
15457,2020,June,Briscoe                                              ,Not Adjusted,543,574,31,5.4
15458,2020,September,Briscoe                                              ,Not Adjusted,536,558,22,3.9
15459,2020,December,Briscoe                                              ,Not Adjusted,543,573,30,5.2
15460,2020,March,Brooks                                               ,Not Adjusted,2510,2732,222,8.1
15461,2020,June,Brooks                                               ,Not Adjusted,2222,2592,370,14.3
15462,2020,September,Brooks                                               ,Not Adjusted,2213,2509,296,11.8
15463,2020,December,Brooks                                               ,Not Adjusted,2263,2537,274,10.8
15464,2020,March,Brown                                                ,Not Adjusted,14356,15244,888,5.8
15465,2020,June,Brown                                                ,Not Adjusted,13952,15231,1279,8.4
15466,2020,September,Brown                                                ,Not Adjusted,14407,15419,1012,6.6
15467,2020,December,Brown                                                ,Not Adjusted,14429,15341,912,5.9
15468,2020,March,Burleson                                             ,Not Adjusted,7995,8412,417,5.0
15469,2020,June,Burleson                                             ,Not Adjusted,7269,7933,664,8.4
15470,2020,September,Burleson                                             ,Not Adjusted,7654,8214,560,6.8
15471,2020,December,Burleson                                             ,Not Adjusted,7781,8275,494,6.0
15472,2020,March,Burnet                                               ,Not Adjusted,22692,23580,888,3.8
15473,2020,June,Burnet                                               ,Not Adjusted,22267,23678,1411,6.0
15474,2020,September,Burnet                                               ,Not Adjusted,22705,23833,1128,4.7
15475,2020,December,Burnet                                               ,Not Adjusted,22989,24020,1031,4.3
15476,2020,March,Caldwell                                             ,Not Adjusted,18529,19419,890,4.6
15477,2020,June,Caldwell                                             ,Not Adjusted,17612,19278,1666,8.6
15478,2020,September,Caldwell                                             ,Not Adjusted,18131,19384,1253,6.5
15479,2020,December,Caldwell                                             ,Not Adjusted,18644,19737,1093,5.5
15480,2020,March,Calhoun                                              ,Not Adjusted,11343,11885,542,4.6
15481,2020,June,Calhoun                                              ,Not Adjusted,10749,11629,880,7.6
15482,2020,September,Calhoun                                              ,Not Adjusted,11499,12238,739,6.0
15483,2020,December,Calhoun                                              ,Not Adjusted,11768,12460,692,5.6
15484,2020,March,Callahan                                             ,Not Adjusted,5757,6021,264,4.4
15485,2020,June,Callahan                                             ,Not Adjusted,5523,5967,444,7.4
15486,2020,September,Callahan                                             ,Not Adjusted,5683,6024,341,5.7
15487,2020,December,Callahan                                             ,Not Adjusted,5744,6045,301,5.0
15488,2020,March,Cameron                                              ,Not Adjusted,155564,168585,13021,7.7
15489,2020,June,Cameron                                              ,Not Adjusted,150682,172060,21378,12.4
15490,2020,September,Cameron                                              ,Not Adjusted,151527,168933,17406,10.3
15491,2020,December,Cameron                                              ,Not Adjusted,153750,169862,16112,9.5
15492,2020,March,Camp                                                 ,Not Adjusted,4637,4924,287,5.8
15493,2020,June,Camp                                                 ,Not Adjusted,4597,5090,493,9.7
15494,2020,September,Camp                                                 ,Not Adjusted,4700,5096,396,7.8
15495,2020,December,Camp                                                 ,Not Adjusted,4698,5069,371,7.3
15496,2020,March,Carson                                               ,Not Adjusted,2845,2956,111,3.8
15497,2020,June,Carson                                               ,Not Adjusted,2765,2930,165,5.6
15498,2020,September,Carson                                               ,Not Adjusted,2819,2937,118,4.0
15499,2020,December,Carson                                               ,Not Adjusted,2851,2968,117,3.9
15500,2020,March,Cass                                                 ,Not Adjusted,11376,12139,763,6.3
15501,2020,June,Cass                                                 ,Not Adjusted,11110,12345,1235,10.0
15502,2020,September,Cass                                                 ,Not Adjusted,11359,12395,1036,8.4
15503,2020,December,Cass                                                 ,Not Adjusted,11417,12427,1010,8.1
15504,2020,March,Castro                                               ,Not Adjusted,3236,3361,125,3.7
15505,2020,June,Castro                                               ,Not Adjusted,3164,3314,150,4.5
15506,2020,September,Castro                                               ,Not Adjusted,3191,3314,123,3.7
15507,2020,December,Castro                                               ,Not Adjusted,3204,3327,123,3.7
15508,2020,March,Chambers                                             ,Not Adjusted,18592,19878,1286,6.5
15509,2020,June,Chambers                                             ,Not Adjusted,17608,20029,2421,12.1
15510,2020,September,Chambers                                             ,Not Adjusted,17735,19812,2077,10.5
15511,2020,December,Chambers                                             ,Not Adjusted,18159,20110,1951,9.7
15512,2020,March,Cherokee                                             ,Not Adjusted,19797,20935,1138,5.4
15513,2020,June,Cherokee                                             ,Not Adjusted,19489,21683,2194,10.1
15514,2020,September,Cherokee                                             ,Not Adjusted,19474,21367,1893,8.9
15515,2020,December,Cherokee                                             ,Not Adjusted,20026,21606,1580,7.3
15516,2020,March,Childress                                            ,Not Adjusted,2949,3065,116,3.8
15517,2020,June,Childress                                            ,Not Adjusted,2691,2835,144,5.1
15518,2020,September,Childress                                            ,Not Adjusted,3012,3126,114,3.6
15519,2020,December,Childress                                            ,Not Adjusted,2995,3107,112,3.6
15520,2020,March,Clay                                                 ,Not Adjusted,4628,4834,206,4.3
15521,2020,June,Clay                                                 ,Not Adjusted,4481,4818,337,7.0
15522,2020,September,Clay                                                 ,Not Adjusted,4490,4767,277,5.8
15523,2020,December,Clay                                                 ,Not Adjusted,4569,4857,288,5.9
15524,2020,March,Cochran                                              ,Not Adjusted,1078,1133,55,4.9
15525,2020,June,Cochran                                              ,Not Adjusted,1013,1124,111,9.9
15526,2020,September,Cochran                                              ,Not Adjusted,1021,1110,89,8.0
15527,2020,December,Cochran                                              ,Not Adjusted,1005,1072,67,6.3
15528,2020,March,Coke                                                 ,Not Adjusted,1347,1405,58,4.1
15529,2020,June,Coke                                                 ,Not Adjusted,1257,1360,103,7.6
15530,2020,September,Coke                                                 ,Not Adjusted,1296,1382,86,6.2
15531,2020,December,Coke                                                 ,Not Adjusted,1286,1360,74,5.4
15532,2020,March,Coleman                                              ,Not Adjusted,2659,2849,190,6.7
15533,2020,June,Coleman                                              ,Not Adjusted,2641,2912,271,9.3
15534,2020,September,Coleman                                              ,Not Adjusted,2711,2936,225,7.7
15535,2020,December,Coleman                                              ,Not Adjusted,2704,2910,206,7.1
15536,2020,March,Collin                                               ,Not Adjusted,543490,567942,24452,4.3
15537,2020,June,Collin                                               ,Not Adjusted,520086,570162,50076,8.8
15538,2020,September,Collin                                               ,Not Adjusted,536215,571633,35418,6.2
15539,2020,December,Collin                                               ,Not Adjusted,552359,582281,29922,5.1
15540,2020,March,Collingsworth                                        ,Not Adjusted,1024,1077,53,4.9
15541,2020,June,Collingsworth                                        ,Not Adjusted,1051,1103,52,4.7
15542,2020,September,Collingsworth                                        ,Not Adjusted,1026,1073,47,4.4
15543,2020,December,Collingsworth                                        ,Not Adjusted,1027,1074,47,4.4
15544,2020,March,Colorado                                             ,Not Adjusted,9334,9789,455,4.6
15545,2020,June,Colorado                                             ,Not Adjusted,9251,9934,683,6.9
15546,2020,September,Colorado                                             ,Not Adjusted,9093,9674,581,6.0
15547,2020,December,Colorado                                             ,Not Adjusted,9130,9681,551,5.7
15548,2020,March,Comal                                                ,Not Adjusted,71815,75153,3338,4.4
15549,2020,June,Comal                                                ,Not Adjusted,68614,74889,6275,8.4
15550,2020,September,Comal                                                ,Not Adjusted,70588,75151,4563,6.1
15551,2020,December,Comal                                                ,Not Adjusted,72468,76389,3921,5.1
15552,2020,March,Comanche                                             ,Not Adjusted,5317,5611,294,5.2
15553,2020,June,Comanche                                             ,Not Adjusted,5235,5632,397,7.0
15554,2020,September,Comanche                                             ,Not Adjusted,5378,5698,320,5.6
15555,2020,December,Comanche                                             ,Not Adjusted,5433,5750,317,5.5
15556,2020,March,Concho                                               ,Not Adjusted,1282,1335,53,4.0
15557,2020,June,Concho                                               ,Not Adjusted,1231,1307,76,5.8
15558,2020,September,Concho                                               ,Not Adjusted,1239,1295,56,4.3
15559,2020,December,Concho                                               ,Not Adjusted,1229,1293,64,4.9
15560,2020,March,Cooke                                                ,Not Adjusted,18540,19405,865,4.5
15561,2020,June,Cooke                                                ,Not Adjusted,17592,19337,1745,9.0
15562,2020,September,Cooke                                                ,Not Adjusted,17772,19161,1389,7.2
15563,2020,December,Cooke                                                ,Not Adjusted,18116,19316,1200,6.2
15564,2020,March,Coryell                                              ,Not Adjusted,22597,23879,1282,5.4
15565,2020,June,Coryell                                              ,Not Adjusted,22016,24083,2067,8.6
15566,2020,September,Coryell                                              ,Not Adjusted,22447,24056,1609,6.7
15567,2020,December,Coryell                                              ,Not Adjusted,22834,24270,1436,5.9
15568,2020,March,Cottle                                               ,Not Adjusted,518,551,33,6.0
15569,2020,June,Cottle                                               ,Not Adjusted,552,584,32,5.5
15570,2020,September,Cottle                                               ,Not Adjusted,544,570,26,4.6
15571,2020,December,Cottle                                               ,Not Adjusted,557,587,30,5.1
15572,2020,March,Crane                                                ,Not Adjusted,1449,1556,107,6.9
15573,2020,June,Crane                                                ,Not Adjusted,1354,1690,336,19.9
15574,2020,September,Crane                                                ,Not Adjusted,1383,1632,249,15.3
15575,2020,December,Crane                                                ,Not Adjusted,1404,1619,215,13.3
15576,2020,March,Crockett                                             ,Not Adjusted,1480,1573,93,5.9
15577,2020,June,Crockett                                             ,Not Adjusted,1425,1613,188,11.7
15578,2020,September,Crockett                                             ,Not Adjusted,1407,1560,153,9.8
15579,2020,December,Crockett                                             ,Not Adjusted,1383,1510,127,8.4
15580,2020,March,Crosby                                               ,Not Adjusted,2319,2435,116,4.8
15581,2020,June,Crosby                                               ,Not Adjusted,2218,2358,140,5.9
15582,2020,September,Crosby                                               ,Not Adjusted,2259,2380,121,5.1
15583,2020,December,Crosby                                               ,Not Adjusted,2278,2410,132,5.5
15584,2020,March,Culberson                                            ,Not Adjusted,1098,1144,46,4.0
15585,2020,June,Culberson                                            ,Not Adjusted,1056,1161,105,9.0
15586,2020,September,Culberson                                            ,Not Adjusted,1070,1151,81,7.0
15587,2020,December,Culberson                                            ,Not Adjusted,1100,1162,62,5.3
15588,2020,March,Dallam                                               ,Not Adjusted,3642,3755,113,3.0
15589,2020,June,Dallam                                               ,Not Adjusted,3625,3755,130,3.5
15590,2020,September,Dallam                                               ,Not Adjusted,3634,3740,106,2.8
15591,2020,December,Dallam                                               ,Not Adjusted,3640,3740,100,2.7
15592,2020,March,Dallas                                               ,Not Adjusted,1271901,1336719,64818,4.8
15593,2020,June,Dallas                                               ,Not Adjusted,1217153,1362788,145635,10.7
15594,2020,September,Dallas                                               ,Not Adjusted,1255242,1364310,109068,8.0
15595,2020,December,Dallas                                               ,Not Adjusted,1292626,1382661,90035,6.5
15596,2020,March,Dawson                                               ,Not Adjusted,4239,4510,271,6.0
15597,2020,June,Dawson                                               ,Not Adjusted,4061,4596,535,11.6
15598,2020,September,Dawson                                               ,Not Adjusted,4124,4570,446,9.8
15599,2020,December,Dawson                                               ,Not Adjusted,4200,4608,408,8.9
15600,2020,March,Deaf Smith                                           ,Not Adjusted,8320,8635,315,3.6
15601,2020,June,Deaf Smith                                           ,Not Adjusted,8244,8608,364,4.2
15602,2020,September,Deaf Smith                                           ,Not Adjusted,8192,8497,305,3.6
15603,2020,December,Deaf Smith                                           ,Not Adjusted,8213,8564,351,4.1
15604,2020,March,Delta                                                ,Not Adjusted,2291,2407,116,4.8
15605,2020,June,Delta                                                ,Not Adjusted,2208,2376,168,7.1
15606,2020,September,Delta                                                ,Not Adjusted,2283,2416,133,5.5
15607,2020,December,Delta                                                ,Not Adjusted,2318,2438,120,4.9
15608,2020,March,Denton                                               ,Not Adjusted,479118,500051,20933,4.2
15609,2020,June,Denton                                               ,Not Adjusted,458499,504314,45815,9.1
15610,2020,September,Denton                                               ,Not Adjusted,472617,504459,31842,6.3
15611,2020,December,Denton                                               ,Not Adjusted,487005,514240,27235,5.3
15612,2020,March,DeWitt                                               ,Not Adjusted,9006,9367,361,3.9
15613,2020,June,DeWitt                                               ,Not Adjusted,8625,9369,744,7.9
15614,2020,September,DeWitt                                               ,Not Adjusted,8614,9273,659,7.1
15615,2020,December,DeWitt                                               ,Not Adjusted,8554,9105,551,6.1
15616,2020,March,Dickens                                              ,Not Adjusted,640,677,37,5.5
15617,2020,June,Dickens                                              ,Not Adjusted,639,692,53,7.7
15618,2020,September,Dickens                                              ,Not Adjusted,623,667,44,6.6
15619,2020,December,Dickens                                              ,Not Adjusted,623,666,43,6.5
15620,2020,March,Dimmit                                               ,Not Adjusted,6721,6987,266,3.8
15621,2020,June,Dimmit                                               ,Not Adjusted,5877,6454,577,8.9
15622,2020,September,Dimmit                                               ,Not Adjusted,5674,6121,447,7.3
15623,2020,December,Dimmit                                               ,Not Adjusted,5708,6135,427,7.0
15624,2020,March,Donley                                               ,Not Adjusted,1380,1445,65,4.5
15625,2020,June,Donley                                               ,Not Adjusted,1352,1440,88,6.1
15626,2020,September,Donley                                               ,Not Adjusted,1339,1398,59,4.2
15627,2020,December,Donley                                               ,Not Adjusted,1377,1441,64,4.4
15628,2020,March,Duval                                                ,Not Adjusted,4480,4830,350,7.2
15629,2020,June,Duval                                                ,Not Adjusted,4155,4946,791,16.0
15630,2020,September,Duval                                                ,Not Adjusted,4173,4861,688,14.2
15631,2020,December,Duval                                                ,Not Adjusted,4186,4780,594,12.4
15632,2020,March,Eastland                                             ,Not Adjusted,7217,7613,396,5.2
15633,2020,June,Eastland                                             ,Not Adjusted,6515,7194,679,9.4
15634,2020,September,Eastland                                             ,Not Adjusted,6805,7330,525,7.2
15635,2020,December,Eastland                                             ,Not Adjusted,6991,7492,501,6.7
15636,2020,March,Ector                                                ,Not Adjusted,81632,85687,4055,4.7
15637,2020,June,Ector                                                ,Not Adjusted,70461,83539,13078,15.7
15638,2020,September,Ector                                                ,Not Adjusted,70176,81172,10996,13.5
15639,2020,December,Ector                                                ,Not Adjusted,71447,80798,9351,11.6
15640,2020,March,Edwards                                              ,Not Adjusted,1131,1164,33,2.8
15641,2020,June,Edwards                                              ,Not Adjusted,1183,1238,55,4.4
15642,2020,September,Edwards                                              ,Not Adjusted,1282,1334,52,3.9
15643,2020,December,Edwards                                              ,Not Adjusted,1233,1290,57,4.4
15644,2020,March,Ellis                                                ,Not Adjusted,89416,93512,4096,4.4
15645,2020,June,Ellis                                                ,Not Adjusted,85541,93199,7658,8.2
15646,2020,September,Ellis                                                ,Not Adjusted,88205,93901,5696,6.1
15647,2020,December,Ellis                                                ,Not Adjusted,90802,95868,5066,5.3
15648,2020,March,El Paso                                              ,Not Adjusted,341691,360545,18854,5.2
15649,2020,June,El Paso                                              ,Not Adjusted,325780,366594,40814,11.1
15650,2020,September,El Paso                                              ,Not Adjusted,335199,365158,29959,8.2
15651,2020,December,El Paso                                              ,Not Adjusted,342154,369671,27517,7.4
15652,2020,March,Erath                                                ,Not Adjusted,19648,20587,939,4.6
15653,2020,June,Erath                                                ,Not Adjusted,18062,19624,1562,8.0
15654,2020,September,Erath                                                ,Not Adjusted,18606,19751,1145,5.8
15655,2020,December,Erath                                                ,Not Adjusted,19267,20348,1081,5.3
15656,2020,March,Falls                                                ,Not Adjusted,6156,6471,315,4.9
15657,2020,June,Falls                                                ,Not Adjusted,6067,6583,516,7.8
15658,2020,September,Falls                                                ,Not Adjusted,6188,6593,405,6.1
15659,2020,December,Falls                                                ,Not Adjusted,6275,6653,378,5.7
15660,2020,March,Fannin                                               ,Not Adjusted,16035,16675,640,3.8
15661,2020,June,Fannin                                               ,Not Adjusted,15669,16703,1034,6.2
15662,2020,September,Fannin                                               ,Not Adjusted,16112,16911,799,4.7
15663,2020,December,Fannin                                               ,Not Adjusted,16389,17142,753,4.4
15664,2020,March,Fayette                                              ,Not Adjusted,11501,11948,447,3.7
15665,2020,June,Fayette                                              ,Not Adjusted,11145,11827,682,5.8
15666,2020,September,Fayette                                              ,Not Adjusted,11174,11782,608,5.2
15667,2020,December,Fayette                                              ,Not Adjusted,11162,11752,590,5.0
15668,2020,March,Fisher                                               ,Not Adjusted,1571,1629,58,3.6
15669,2020,June,Fisher                                               ,Not Adjusted,1502,1595,93,5.8
15670,2020,September,Fisher                                               ,Not Adjusted,1515,1599,84,5.3
15671,2020,December,Fisher                                               ,Not Adjusted,1521,1601,80,5.0
15672,2020,March,Floyd                                                ,Not Adjusted,2371,2554,183,7.2
15673,2020,June,Floyd                                                ,Not Adjusted,2340,2522,182,7.2
15674,2020,September,Floyd                                                ,Not Adjusted,2336,2476,140,5.7
15675,2020,December,Floyd                                                ,Not Adjusted,2344,2497,153,6.1
15676,2020,March,Foard                                                ,Not Adjusted,554,575,21,3.7
15677,2020,June,Foard                                                ,Not Adjusted,549,581,32,5.5
15678,2020,September,Foard                                                ,Not Adjusted,547,569,22,3.9
15679,2020,December,Foard                                                ,Not Adjusted,541,564,23,4.1
15680,2020,March,Fort Bend                                            ,Not Adjusted,377533,397145,19612,4.9
15681,2020,June,Fort Bend                                            ,Not Adjusted,357561,398852,41291,10.4
15682,2020,September,Fort Bend                                            ,Not Adjusted,360286,392798,32512,8.3
15683,2020,December,Fort Bend                                            ,Not Adjusted,368750,396512,27762,7.0
15684,2020,March,Franklin                                             ,Not Adjusted,4502,4715,213,4.5
15685,2020,June,Franklin                                             ,Not Adjusted,4553,4878,325,6.7
15686,2020,September,Franklin                                             ,Not Adjusted,4598,4859,261,5.4
15687,2020,December,Franklin                                             ,Not Adjusted,4632,4901,269,5.5
15688,2020,March,Freestone                                            ,Not Adjusted,5975,6430,455,7.1
15689,2020,June,Freestone                                            ,Not Adjusted,5703,6414,711,11.1
15690,2020,September,Freestone                                            ,Not Adjusted,5789,6356,567,8.9
15691,2020,December,Freestone                                            ,Not Adjusted,5801,6302,501,7.9
15692,2020,March,Frio                                                 ,Not Adjusted,9642,10039,397,4.0
15693,2020,June,Frio                                                 ,Not Adjusted,8728,9462,734,7.8
15694,2020,September,Frio                                                 ,Not Adjusted,8834,9436,602,6.4
15695,2020,December,Frio                                                 ,Not Adjusted,8619,9165,546,6.0
15696,2020,March,Gaines                                               ,Not Adjusted,9399,9765,366,3.7
15697,2020,June,Gaines                                               ,Not Adjusted,9044,9777,733,7.5
15698,2020,September,Gaines                                               ,Not Adjusted,9024,9635,611,6.3
15699,2020,December,Gaines                                               ,Not Adjusted,9114,9690,576,5.9
15700,2020,March,Galveston                                            ,Not Adjusted,155649,164987,9338,5.7
15701,2020,June,Galveston                                            ,Not Adjusted,147388,166071,18683,11.3
15702,2020,September,Galveston                                            ,Not Adjusted,148500,163430,14930,9.1
15703,2020,December,Galveston                                            ,Not Adjusted,151960,164963,13003,7.9
15704,2020,March,Garza                                                ,Not Adjusted,1971,2061,90,4.4
15705,2020,June,Garza                                                ,Not Adjusted,1811,2005,194,9.7
15706,2020,September,Garza                                                ,Not Adjusted,1869,2025,156,7.7
15707,2020,December,Garza                                                ,Not Adjusted,1877,2004,127,6.3
15708,2020,March,Gillespie                                            ,Not Adjusted,12945,13423,478,3.6
15709,2020,June,Gillespie                                            ,Not Adjusted,12538,13372,834,6.2
15710,2020,September,Gillespie                                            ,Not Adjusted,12658,13257,599,4.5
15711,2020,December,Gillespie                                            ,Not Adjusted,13106,13617,511,3.8
15712,2020,March,Glasscock                                            ,Not Adjusted,859,884,25,2.8
15713,2020,June,Glasscock                                            ,Not Adjusted,736,773,37,4.8
15714,2020,September,Glasscock                                            ,Not Adjusted,730,765,35,4.6
15715,2020,December,Glasscock                                            ,Not Adjusted,733,762,29,3.8
15716,2020,March,Goliad                                               ,Not Adjusted,3006,3178,172,5.4
15717,2020,June,Goliad                                               ,Not Adjusted,2853,3171,318,10.0
15718,2020,September,Goliad                                               ,Not Adjusted,2912,3181,269,8.5
15719,2020,December,Goliad                                               ,Not Adjusted,2959,3202,243,7.6
15720,2020,March,Gonzales                                             ,Not Adjusted,9343,9730,387,4.0
15721,2020,June,Gonzales                                             ,Not Adjusted,8714,9376,662,7.1
15722,2020,September,Gonzales                                             ,Not Adjusted,9073,9637,564,5.9
15723,2020,December,Gonzales                                             ,Not Adjusted,9105,9608,503,5.2
15724,2020,March,Gray                                                 ,Not Adjusted,7365,7801,436,5.6
15725,2020,June,Gray                                                 ,Not Adjusted,7047,7930,883,11.1
15726,2020,September,Gray                                                 ,Not Adjusted,7032,7731,699,9.0
15727,2020,December,Gray                                                 ,Not Adjusted,7023,7708,685,8.9
15728,2020,March,Grayson                                              ,Not Adjusted,60947,63815,2868,4.5
15729,2020,June,Grayson                                              ,Not Adjusted,59009,64020,5011,7.8
15730,2020,September,Grayson                                              ,Not Adjusted,60892,64661,3769,5.8
15731,2020,December,Grayson                                              ,Not Adjusted,62244,65603,3359,5.1
15732,2020,March,Gregg                                                ,Not Adjusted,53803,56976,3173,5.6
15733,2020,June,Gregg                                                ,Not Adjusted,50433,56731,6298,11.1
15734,2020,September,Gregg                                                ,Not Adjusted,51387,56433,5046,8.9
15735,2020,December,Gregg                                                ,Not Adjusted,52201,56505,4304,7.6
15736,2020,March,Grimes                                               ,Not Adjusted,10478,11185,707,6.3
15737,2020,June,Grimes                                               ,Not Adjusted,9887,11049,1162,10.5
15738,2020,September,Grimes                                               ,Not Adjusted,10083,11046,963,8.7
15739,2020,December,Grimes                                               ,Not Adjusted,10196,11091,895,8.1
15740,2020,March,Guadalupe                                            ,Not Adjusted,77316,80626,3310,4.1
15741,2020,June,Guadalupe                                            ,Not Adjusted,73873,80525,6652,8.3
15742,2020,September,Guadalupe                                            ,Not Adjusted,75886,80763,4877,6.0
15743,2020,December,Guadalupe                                            ,Not Adjusted,78047,82196,4149,5.0
15744,2020,March,Hale                                                 ,Not Adjusted,11156,11868,712,6.0
15745,2020,June,Hale                                                 ,Not Adjusted,10759,11853,1094,9.2
15746,2020,September,Hale                                                 ,Not Adjusted,11011,11766,755,6.4
15747,2020,December,Hale                                                 ,Not Adjusted,11092,11885,793,6.7
15748,2020,March,Hall                                                 ,Not Adjusted,1015,1082,67,6.2
15749,2020,June,Hall                                                 ,Not Adjusted,992,1068,76,7.1
15750,2020,September,Hall                                                 ,Not Adjusted,1015,1081,66,6.1
15751,2020,December,Hall                                                 ,Not Adjusted,1017,1076,59,5.5
15752,2020,March,Hamilton                                             ,Not Adjusted,3581,3739,158,4.2
15753,2020,June,Hamilton                                             ,Not Adjusted,3545,3755,210,5.6
15754,2020,September,Hamilton                                             ,Not Adjusted,3613,3791,178,4.7
15755,2020,December,Hamilton                                             ,Not Adjusted,3674,3849,175,4.5
15756,2020,March,Hansford                                             ,Not Adjusted,2439,2522,83,3.3
15757,2020,June,Hansford                                             ,Not Adjusted,2377,2494,117,4.7
15758,2020,September,Hansford                                             ,Not Adjusted,2433,2529,96,3.8
15759,2020,December,Hansford                                             ,Not Adjusted,2428,2518,90,3.6
15760,2020,March,Hardeman                                             ,Not Adjusted,1650,1719,69,4.0
15761,2020,June,Hardeman                                             ,Not Adjusted,1600,1702,102,6.0
15762,2020,September,Hardeman                                             ,Not Adjusted,1646,1722,76,4.4
15763,2020,December,Hardeman                                             ,Not Adjusted,1626,1715,89,5.2
15764,2020,March,Hardin                                               ,Not Adjusted,23710,25342,1632,6.4
15765,2020,June,Hardin                                               ,Not Adjusted,22012,24964,2952,11.8
15766,2020,September,Hardin                                               ,Not Adjusted,22469,24777,2308,9.3
15767,2020,December,Hardin                                               ,Not Adjusted,23082,25200,2118,8.4
15768,2020,March,Harris                                               ,Not Adjusted,2163221,2291312,128091,5.6
15769,2020,June,Harris                                               ,Not Adjusted,2048923,2330137,281214,12.1
15770,2020,September,Harris                                               ,Not Adjusted,2065715,2289765,224050,9.8
15771,2020,December,Harris                                               ,Not Adjusted,2113351,2290029,176678,7.7
15772,2020,March,Harrison                                             ,Not Adjusted,27468,29190,1722,5.9
15773,2020,June,Harrison                                             ,Not Adjusted,26430,29470,3040,10.3
15774,2020,September,Harrison                                             ,Not Adjusted,26773,29203,2430,8.3
15775,2020,December,Harrison                                             ,Not Adjusted,26834,29071,2237,7.7
15776,2020,March,Hartley                                              ,Not Adjusted,2574,2637,63,2.4
15777,2020,June,Hartley                                              ,Not Adjusted,2559,2628,69,2.6
15778,2020,September,Hartley                                              ,Not Adjusted,2580,2629,49,1.9
15779,2020,December,Hartley                                              ,Not Adjusted,2591,2637,46,1.7
15780,2020,March,Haskell                                              ,Not Adjusted,2511,2611,100,3.8
15781,2020,June,Haskell                                              ,Not Adjusted,2529,2675,146,5.5
15782,2020,September,Haskell                                              ,Not Adjusted,2528,2654,126,4.7
15783,2020,December,Haskell                                              ,Not Adjusted,2519,2639,120,4.5
15784,2020,March,Hays                                                 ,Not Adjusted,116311,120942,4631,3.8
15785,2020,June,Hays                                                 ,Not Adjusted,110604,121586,10982,9.0
15786,2020,September,Hays                                                 ,Not Adjusted,113888,121415,7527,6.2
15787,2020,December,Hays                                                 ,Not Adjusted,117196,123233,6037,4.9
15788,2020,March,Hemphill                                             ,Not Adjusted,1965,2042,77,3.8
15789,2020,June,Hemphill                                             ,Not Adjusted,1693,1798,105,5.8
15790,2020,September,Hemphill                                             ,Not Adjusted,1659,1736,77,4.4
15791,2020,December,Hemphill                                             ,Not Adjusted,1776,1862,86,4.6
15792,2020,March,Henderson                                            ,Not Adjusted,35023,36905,1882,5.1
15793,2020,June,Henderson                                            ,Not Adjusted,34357,37529,3172,8.5
15794,2020,September,Henderson                                            ,Not Adjusted,34976,37462,2486,6.6
15795,2020,December,Henderson                                            ,Not Adjusted,35480,37693,2213,5.9
15796,2020,March,Hidalgo                                              ,Not Adjusted,326667,359125,32458,9.0
15797,2020,June,Hidalgo                                              ,Not Adjusted,313724,366147,52423,14.3
15798,2020,September,Hidalgo                                              ,Not Adjusted,317147,360711,43564,12.1
15799,2020,December,Hidalgo                                              ,Not Adjusted,324276,363869,39593,10.9
15800,2020,March,Hill                                                 ,Not Adjusted,15530,16302,772,4.7
15801,2020,June,Hill                                                 ,Not Adjusted,14976,16351,1375,8.4
15802,2020,September,Hill                                                 ,Not Adjusted,15332,16368,1036,6.3
15803,2020,December,Hill                                                 ,Not Adjusted,15575,16547,972,5.9
15804,2020,March,Hockley                                              ,Not Adjusted,10656,11133,477,4.3
15805,2020,June,Hockley                                              ,Not Adjusted,9280,10506,1226,11.7
15806,2020,September,Hockley                                              ,Not Adjusted,9555,10472,917,8.8
15807,2020,December,Hockley                                              ,Not Adjusted,9573,10375,802,7.7
15808,2020,March,Hood                                                 ,Not Adjusted,26289,27631,1342,4.9
15809,2020,June,Hood                                                 ,Not Adjusted,25119,27558,2439,8.9
15810,2020,September,Hood                                                 ,Not Adjusted,25708,27633,1925,7.0
15811,2020,December,Hood                                                 ,Not Adjusted,26528,28258,1730,6.1
15812,2020,March,Hopkins                                              ,Not Adjusted,16632,17385,753,4.3
15813,2020,June,Hopkins                                              ,Not Adjusted,16310,17443,1133,6.5
15814,2020,September,Hopkins                                              ,Not Adjusted,16681,17608,927,5.3
15815,2020,December,Hopkins                                              ,Not Adjusted,16885,17744,859,4.8
15816,2020,March,Houston                                              ,Not Adjusted,9533,10029,496,4.9
15817,2020,June,Houston                                              ,Not Adjusted,9513,10162,649,6.4
15818,2020,September,Houston                                              ,Not Adjusted,9533,10081,548,5.4
15819,2020,December,Houston                                              ,Not Adjusted,9472,10079,607,6.0
15820,2020,March,Howard                                               ,Not Adjusted,13151,13791,640,4.6
15821,2020,June,Howard                                               ,Not Adjusted,12094,13623,1529,11.2
15822,2020,September,Howard                                               ,Not Adjusted,12078,13341,1263,9.5
15823,2020,December,Howard                                               ,Not Adjusted,12316,13417,1101,8.2
15824,2020,March,Hudspeth                                             ,Not Adjusted,1757,1857,100,5.4
15825,2020,June,Hudspeth                                             ,Not Adjusted,1661,1856,195,10.5
15826,2020,September,Hudspeth                                             ,Not Adjusted,1702,1847,145,7.9
15827,2020,December,Hudspeth                                             ,Not Adjusted,1724,1883,159,8.4
15828,2020,March,Hunt                                                 ,Not Adjusted,41353,43564,2211,5.1
15829,2020,June,Hunt                                                 ,Not Adjusted,39550,43404,3854,8.9
15830,2020,September,Hunt                                                 ,Not Adjusted,40782,43622,2840,6.5
15831,2020,December,Hunt                                                 ,Not Adjusted,41962,44554,2592,5.8
15832,2020,March,Hutchinson                                           ,Not Adjusted,7908,8434,526,6.2
15833,2020,June,Hutchinson                                           ,Not Adjusted,7893,8714,821,9.4
15834,2020,September,Hutchinson                                           ,Not Adjusted,7981,8591,610,7.1
15835,2020,December,Hutchinson                                           ,Not Adjusted,8004,8600,596,6.9
15836,2020,March,Irion                                                ,Not Adjusted,727,755,28,3.7
15837,2020,June,Irion                                                ,Not Adjusted,690,755,65,8.6
15838,2020,September,Irion                                                ,Not Adjusted,703,758,55,7.3
15839,2020,December,Irion                                                ,Not Adjusted,709,761,52,6.8
15840,2020,March,Jack                                                 ,Not Adjusted,3261,3451,190,5.5
15841,2020,June,Jack                                                 ,Not Adjusted,3092,3406,314,9.2
15842,2020,September,Jack                                                 ,Not Adjusted,3099,3353,254,7.6
15843,2020,December,Jack                                                 ,Not Adjusted,3118,3339,221,6.6
15844,2020,March,Jackson                                              ,Not Adjusted,7189,7520,331,4.4
15845,2020,June,Jackson                                              ,Not Adjusted,6804,7341,537,7.3
15846,2020,September,Jackson                                              ,Not Adjusted,6766,7213,447,6.2
15847,2020,December,Jackson                                              ,Not Adjusted,6824,7236,412,5.7
15848,2020,March,Jasper                                               ,Not Adjusted,11644,12819,1175,9.2
15849,2020,June,Jasper                                               ,Not Adjusted,11364,13149,1785,13.6
15850,2020,September,Jasper                                               ,Not Adjusted,11373,12922,1549,12.0
15851,2020,December,Jasper                                               ,Not Adjusted,11511,12923,1412,10.9
15852,2020,March,Jeff Davis                                           ,Not Adjusted,974,1021,47,4.6
15853,2020,June,Jeff Davis                                           ,Not Adjusted,915,977,62,6.3
15854,2020,September,Jeff Davis                                           ,Not Adjusted,920,968,48,5.0
15855,2020,December,Jeff Davis                                           ,Not Adjusted,919,969,50,5.2
15856,2020,March,Jefferson                                            ,Not Adjusted,96859,105821,8962,8.5
15857,2020,June,Jefferson                                            ,Not Adjusted,89935,106561,16626,15.6
15858,2020,September,Jefferson                                            ,Not Adjusted,91819,105247,13428,12.8
15859,2020,December,Jefferson                                            ,Not Adjusted,94294,105955,11661,11.0
15860,2020,March,Jim Hogg                                             ,Not Adjusted,1744,1858,114,6.1
15861,2020,June,Jim Hogg                                             ,Not Adjusted,1691,1924,233,12.1
15862,2020,September,Jim Hogg                                             ,Not Adjusted,1691,1907,216,11.3
15863,2020,December,Jim Hogg                                             ,Not Adjusted,1718,1910,192,10.1
15864,2020,March,Jim Wells                                            ,Not Adjusted,15246,16535,1289,7.8
15865,2020,June,Jim Wells                                            ,Not Adjusted,13570,16409,2839,17.3
15866,2020,September,Jim Wells                                            ,Not Adjusted,13446,15877,2431,15.3
15867,2020,December,Jim Wells                                            ,Not Adjusted,13564,15603,2039,13.1
15868,2020,March,Johnson                                              ,Not Adjusted,79141,82920,3779,4.6
15869,2020,June,Johnson                                              ,Not Adjusted,75688,83037,7349,8.9
15870,2020,September,Johnson                                              ,Not Adjusted,77361,82788,5427,6.6
15871,2020,December,Johnson                                              ,Not Adjusted,80053,84954,4901,5.8
15872,2020,March,Jones                                                ,Not Adjusted,5448,5779,331,5.7
15873,2020,June,Jones                                                ,Not Adjusted,5214,5729,515,9.0
15874,2020,September,Jones                                                ,Not Adjusted,5346,5774,428,7.4
15875,2020,December,Jones                                                ,Not Adjusted,5402,5816,414,7.1
15876,2020,March,Karnes                                               ,Not Adjusted,7167,7434,267,3.6
15877,2020,June,Karnes                                               ,Not Adjusted,6268,6861,593,8.6
15878,2020,September,Karnes                                               ,Not Adjusted,6220,6739,519,7.7
15879,2020,December,Karnes                                               ,Not Adjusted,6358,6809,451,6.6
15880,2020,March,Kaufman                                              ,Not Adjusted,63936,66952,3016,4.5
15881,2020,June,Kaufman                                              ,Not Adjusted,61179,67165,5986,8.9
15882,2020,September,Kaufman                                              ,Not Adjusted,63054,67543,4489,6.6
15883,2020,December,Kaufman                                              ,Not Adjusted,64973,68963,3990,5.8
15884,2020,March,Kendall                                              ,Not Adjusted,21487,22350,863,3.9
15885,2020,June,Kendall                                              ,Not Adjusted,20490,21984,1494,6.8
15886,2020,September,Kendall                                              ,Not Adjusted,21076,22162,1086,4.9
15887,2020,December,Kendall                                              ,Not Adjusted,21578,22550,972,4.3
15888,2020,March,Kenedy                                               ,Not Adjusted,219,230,11,4.8
15889,2020,June,Kenedy                                               ,Not Adjusted,153,165,12,7.3
15890,2020,September,Kenedy                                               ,Not Adjusted,155,165,10,6.1
15891,2020,December,Kenedy                                               ,Not Adjusted,155,165,10,6.1
15892,2020,March,Kent                                                 ,Not Adjusted,453,479,26,5.4
15893,2020,June,Kent                                                 ,Not Adjusted,450,472,22,4.7
15894,2020,September,Kent                                                 ,Not Adjusted,449,468,19,4.1
15895,2020,December,Kent                                                 ,Not Adjusted,415,426,11,2.6
15896,2020,March,Kerr                                                 ,Not Adjusted,20800,21762,962,4.4
15897,2020,June,Kerr                                                 ,Not Adjusted,20134,21826,1692,7.8
15898,2020,September,Kerr                                                 ,Not Adjusted,20170,21359,1189,5.6
15899,2020,December,Kerr                                                 ,Not Adjusted,20553,21614,1061,4.9
15900,2020,March,Kimble                                               ,Not Adjusted,1713,1796,83,4.6
15901,2020,June,Kimble                                               ,Not Adjusted,1712,1822,110,6.0
15902,2020,September,Kimble                                               ,Not Adjusted,1707,1814,107,5.9
15903,2020,December,Kimble                                               ,Not Adjusted,1727,1829,102,5.6
15904,2020,March,King                                                 ,Not Adjusted,232,239,7,2.9
15905,2020,June,King                                                 ,Not Adjusted,207,211,4,1.9
15906,2020,September,King                                                 ,Not Adjusted,250,253,3,1.2
15907,2020,December,King                                                 ,Not Adjusted,256,260,4,1.5
15908,2020,March,Kinney                                               ,Not Adjusted,1305,1389,84,6.0
15909,2020,June,Kinney                                               ,Not Adjusted,1150,1246,96,7.7
15910,2020,September,Kinney                                               ,Not Adjusted,1232,1311,79,6.0
15911,2020,December,Kinney                                               ,Not Adjusted,1215,1298,83,6.4
15912,2020,March,Kleberg                                              ,Not Adjusted,12654,13489,835,6.2
15913,2020,June,Kleberg                                              ,Not Adjusted,11895,13372,1477,11.0
15914,2020,September,Kleberg                                              ,Not Adjusted,12129,13334,1205,9.0
15915,2020,December,Kleberg                                              ,Not Adjusted,12552,13587,1035,7.6
15916,2020,March,Knox                                                 ,Not Adjusted,1398,1472,74,5.0
15917,2020,June,Knox                                                 ,Not Adjusted,1354,1463,109,7.5
15918,2020,September,Knox                                                 ,Not Adjusted,1362,1448,86,5.9
15919,2020,December,Knox                                                 ,Not Adjusted,1377,1457,80,5.5
15920,2020,March,Lamar                                                ,Not Adjusted,22179,23215,1036,4.5
15921,2020,June,Lamar                                                ,Not Adjusted,21422,23560,2138,9.1
15922,2020,September,Lamar                                                ,Not Adjusted,22346,23904,1558,6.5
15923,2020,December,Lamar                                                ,Not Adjusted,22430,23895,1465,6.1
15924,2020,March,Lamb                                                 ,Not Adjusted,4978,5252,274,5.2
15925,2020,June,Lamb                                                 ,Not Adjusted,4939,5278,339,6.4
15926,2020,September,Lamb                                                 ,Not Adjusted,4939,5206,267,5.1
15927,2020,December,Lamb                                                 ,Not Adjusted,4926,5208,282,5.4
15928,2020,March,Lampasas                                             ,Not Adjusted,8642,9062,420,4.6
15929,2020,June,Lampasas                                             ,Not Adjusted,8403,9023,620,6.9
15930,2020,September,Lampasas                                             ,Not Adjusted,8575,9061,486,5.4
15931,2020,December,Lampasas                                             ,Not Adjusted,8706,9190,484,5.3
15932,2020,March,La Salle                                             ,Not Adjusted,3927,4105,178,4.3
15933,2020,June,La Salle                                             ,Not Adjusted,3196,3550,354,10.0
15934,2020,September,La Salle                                             ,Not Adjusted,3278,3563,285,8.0
15935,2020,December,La Salle                                             ,Not Adjusted,3264,3489,225,6.4
15936,2020,March,Lavaca                                               ,Not Adjusted,8078,8421,343,4.1
15937,2020,June,Lavaca                                               ,Not Adjusted,7904,8471,567,6.7
15938,2020,September,Lavaca                                               ,Not Adjusted,7936,8447,511,6.0
15939,2020,December,Lavaca                                               ,Not Adjusted,8003,8453,450,5.3
15940,2020,March,Lee                                                  ,Not Adjusted,8885,9284,399,4.3
15941,2020,June,Lee                                                  ,Not Adjusted,8702,9272,570,6.1
15942,2020,September,Lee                                                  ,Not Adjusted,8658,9129,471,5.2
15943,2020,December,Lee                                                  ,Not Adjusted,8592,9014,422,4.7
15944,2020,March,Leon                                                 ,Not Adjusted,5806,6207,401,6.5
15945,2020,June,Leon                                                 ,Not Adjusted,5469,6068,599,9.9
15946,2020,September,Leon                                                 ,Not Adjusted,5667,6163,496,8.0
15947,2020,December,Leon                                                 ,Not Adjusted,5735,6271,536,8.5
15948,2020,March,Liberty                                              ,Not Adjusted,31103,33667,2564,7.6
15949,2020,June,Liberty                                              ,Not Adjusted,29440,33958,4518,13.3
15950,2020,September,Liberty                                              ,Not Adjusted,29666,33544,3878,11.6
15951,2020,December,Liberty                                              ,Not Adjusted,30337,34129,3792,11.1
15952,2020,March,Limestone                                            ,Not Adjusted,7990,8454,464,5.5
15953,2020,June,Limestone                                            ,Not Adjusted,7653,8436,783,9.3
15954,2020,September,Limestone                                            ,Not Adjusted,7623,8296,673,8.1
15955,2020,December,Limestone                                            ,Not Adjusted,7712,8326,614,7.4
15956,2020,March,Lipscomb                                             ,Not Adjusted,1540,1596,56,3.5
15957,2020,June,Lipscomb                                             ,Not Adjusted,1460,1538,78,5.1
15958,2020,September,Lipscomb                                             ,Not Adjusted,1461,1533,72,4.7
15959,2020,December,Lipscomb                                             ,Not Adjusted,1455,1522,67,4.4
15960,2020,March,Live Oak                                             ,Not Adjusted,5121,5371,250,4.7
15961,2020,June,Live Oak                                             ,Not Adjusted,4596,5097,501,9.8
15962,2020,September,Live Oak                                             ,Not Adjusted,4618,5067,449,8.9
15963,2020,December,Live Oak                                             ,Not Adjusted,4692,5110,418,8.2
15964,2020,March,Llano                                                ,Not Adjusted,8146,8561,415,4.8
15965,2020,June,Llano                                                ,Not Adjusted,7912,8494,582,6.9
15966,2020,September,Llano                                                ,Not Adjusted,8166,8664,498,5.7
15967,2020,December,Llano                                                ,Not Adjusted,8056,8540,484,5.7
15968,2020,March,Loving                                               ,Not Adjusted,293,298,5,1.7
15969,2020,June,Loving                                               ,Not Adjusted,201,208,7,3.4
15970,2020,September,Loving                                               ,Not Adjusted,310,314,4,1.3
15971,2020,December,Loving                                               ,Not Adjusted,278,281,3,1.1
15972,2020,March,Lubbock                                              ,Not Adjusted,149511,155450,5939,3.8
15973,2020,June,Lubbock                                              ,Not Adjusted,145041,157368,12327,7.8
15974,2020,September,Lubbock                                              ,Not Adjusted,148369,157507,9138,5.8
15975,2020,December,Lubbock                                              ,Not Adjusted,151060,159248,8188,5.1
15976,2020,March,Lynn                                                 ,Not Adjusted,2649,2781,132,4.7
15977,2020,June,Lynn                                                 ,Not Adjusted,2539,2746,207,7.5
15978,2020,September,Lynn                                                 ,Not Adjusted,2587,2733,146,5.3
15979,2020,December,Lynn                                                 ,Not Adjusted,2612,2751,139,5.1
15980,2020,March,McCulloch                                            ,Not Adjusted,3098,3300,202,6.1
15981,2020,June,McCulloch                                            ,Not Adjusted,2944,3239,295,9.1
15982,2020,September,McCulloch                                            ,Not Adjusted,3005,3270,265,8.1
15983,2020,December,McCulloch                                            ,Not Adjusted,3039,3304,265,8.0
15984,2020,March,McLennan                                             ,Not Adjusted,112819,118433,5614,4.7
15985,2020,June,McLennan                                             ,Not Adjusted,111667,121492,9825,8.1
15986,2020,September,McLennan                                             ,Not Adjusted,114132,121584,7452,6.1
15987,2020,December,McLennan                                             ,Not Adjusted,115969,122783,6814,5.5
15988,2020,March,McMullen                                             ,Not Adjusted,774,790,16,2.0
15989,2020,June,McMullen                                             ,Not Adjusted,709,735,26,3.5
15990,2020,September,McMullen                                             ,Not Adjusted,650,675,25,3.7
15991,2020,December,McMullen                                             ,Not Adjusted,665,684,19,2.8
15992,2020,March,Madison                                              ,Not Adjusted,4200,4450,250,5.6
15993,2020,June,Madison                                              ,Not Adjusted,4050,4473,423,9.5
15994,2020,September,Madison                                              ,Not Adjusted,4132,4490,358,8.0
15995,2020,December,Madison                                              ,Not Adjusted,4179,4521,342,7.6
15996,2020,March,Marion                                               ,Not Adjusted,3964,4242,278,6.6
15997,2020,June,Marion                                               ,Not Adjusted,3863,4325,462,10.7
15998,2020,September,Marion                                               ,Not Adjusted,3936,4305,369,8.6
15999,2020,December,Marion                                               ,Not Adjusted,3949,4274,325,7.6
16000,2020,March,Martin                                               ,Not Adjusted,2658,2762,104,3.8
16001,2020,June,Martin                                               ,Not Adjusted,2252,2467,215,8.7
16002,2020,September,Martin                                               ,Not Adjusted,2272,2439,167,6.8
16003,2020,December,Martin                                               ,Not Adjusted,2330,2480,150,6.0
16004,2020,March,Mason                                                ,Not Adjusted,1688,1771,83,4.7
16005,2020,June,Mason                                                ,Not Adjusted,1612,1727,115,6.7
16006,2020,September,Mason                                                ,Not Adjusted,1599,1702,103,6.1
16007,2020,December,Mason                                                ,Not Adjusted,1596,1698,102,6.0
16008,2020,March,Matagorda                                            ,Not Adjusted,15722,17022,1300,7.6
16009,2020,June,Matagorda                                            ,Not Adjusted,14491,16746,2255,13.5
16010,2020,September,Matagorda                                            ,Not Adjusted,14580,16453,1873,11.4
16011,2020,December,Matagorda                                            ,Not Adjusted,14629,16275,1646,10.1
16012,2020,March,Maverick                                             ,Not Adjusted,21396,24414,3018,12.4
16013,2020,June,Maverick                                             ,Not Adjusted,20314,24900,4586,18.4
16014,2020,September,Maverick                                             ,Not Adjusted,20756,24629,3873,15.7
16015,2020,December,Maverick                                             ,Not Adjusted,21180,25027,3847,15.4
16016,2020,March,Medina                                               ,Not Adjusted,20573,21572,999,4.6
16017,2020,June,Medina                                               ,Not Adjusted,19622,21453,1831,8.5
16018,2020,September,Medina                                               ,Not Adjusted,20152,21522,1370,6.4
16019,2020,December,Medina                                               ,Not Adjusted,20673,21905,1232,5.6
16020,2020,March,Menard                                               ,Not Adjusted,860,897,37,4.1
16021,2020,June,Menard                                               ,Not Adjusted,790,852,62,7.3
16022,2020,September,Menard                                               ,Not Adjusted,824,869,45,5.2
16023,2020,December,Menard                                               ,Not Adjusted,829,875,46,5.3
16024,2020,March,Midland                                              ,Not Adjusted,100818,104321,3503,3.4
16025,2020,June,Midland                                              ,Not Adjusted,84789,96390,11601,12.0
16026,2020,September,Midland                                              ,Not Adjusted,85680,95108,9428,9.9
16027,2020,December,Midland                                              ,Not Adjusted,88475,96272,7797,8.1
16028,2020,March,Milam                                                ,Not Adjusted,9134,9716,582,6.0
16029,2020,June,Milam                                                ,Not Adjusted,8978,9862,884,9.0
16030,2020,September,Milam                                                ,Not Adjusted,9125,9831,706,7.2
16031,2020,December,Milam                                                ,Not Adjusted,9185,9844,659,6.7
16032,2020,March,Mills                                                ,Not Adjusted,1836,1915,79,4.1
16033,2020,June,Mills                                                ,Not Adjusted,1744,1835,91,5.0
16034,2020,September,Mills                                                ,Not Adjusted,1831,1914,83,4.3
16035,2020,December,Mills                                                ,Not Adjusted,1823,1913,90,4.7
16036,2020,March,Mitchell                                             ,Not Adjusted,2241,2347,106,4.5
16037,2020,June,Mitchell                                             ,Not Adjusted,2166,2420,254,10.5
16038,2020,September,Mitchell                                             ,Not Adjusted,2185,2415,230,9.5
16039,2020,December,Mitchell                                             ,Not Adjusted,2205,2406,201,8.4
16040,2020,March,Montague                                             ,Not Adjusted,8851,9266,415,4.5
16041,2020,June,Montague                                             ,Not Adjusted,8259,9062,803,8.9
16042,2020,September,Montague                                             ,Not Adjusted,8399,9033,634,7.0
16043,2020,December,Montague                                             ,Not Adjusted,8425,8984,559,6.2
16044,2020,March,Montgomery                                           ,Not Adjusted,272928,287022,14094,4.9
16045,2020,June,Montgomery                                           ,Not Adjusted,258484,287164,28680,10.0
16046,2020,September,Montgomery                                           ,Not Adjusted,260677,283138,22461,7.9
16047,2020,December,Montgomery                                           ,Not Adjusted,266590,286502,19912,7.0
16048,2020,March,Moore                                                ,Not Adjusted,10083,10433,350,3.4
16049,2020,June,Moore                                                ,Not Adjusted,10045,10576,531,5.0
16050,2020,September,Moore                                                ,Not Adjusted,10369,10787,418,3.9
16051,2020,December,Moore                                                ,Not Adjusted,10307,10711,404,3.8
16052,2020,March,Morris                                               ,Not Adjusted,4457,4798,341,7.1
16053,2020,June,Morris                                               ,Not Adjusted,4188,4886,698,14.3
16054,2020,September,Morris                                               ,Not Adjusted,4104,4761,657,13.8
16055,2020,December,Morris                                               ,Not Adjusted,4109,4742,633,13.3
16056,2020,March,Motley                                               ,Not Adjusted,426,451,25,5.5
16057,2020,June,Motley                                               ,Not Adjusted,413,439,26,5.9
16058,2020,September,Motley                                               ,Not Adjusted,408,430,22,5.1
16059,2020,December,Motley                                               ,Not Adjusted,398,415,17,4.1
16060,2020,March,Nacogdoches                                          ,Not Adjusted,26708,28217,1509,5.3
16061,2020,June,Nacogdoches                                          ,Not Adjusted,25156,27601,2445,8.9
16062,2020,September,Nacogdoches                                          ,Not Adjusted,26377,28279,1902,6.7
16063,2020,December,Nacogdoches                                          ,Not Adjusted,26663,28435,1772,6.2
16064,2020,March,Navarro                                              ,Not Adjusted,22080,23260,1180,5.1
16065,2020,June,Navarro                                              ,Not Adjusted,20960,22906,1946,8.5
16066,2020,September,Navarro                                              ,Not Adjusted,21971,23387,1416,6.1
16067,2020,December,Navarro                                              ,Not Adjusted,21906,23218,1312,5.7
16068,2020,March,Newton                                               ,Not Adjusted,4687,5176,489,9.4
16069,2020,June,Newton                                               ,Not Adjusted,4348,5056,708,14.0
16070,2020,September,Newton                                               ,Not Adjusted,4435,5024,589,11.7
16071,2020,December,Newton                                               ,Not Adjusted,4552,5082,530,10.4
16072,2020,March,Nolan                                                ,Not Adjusted,6845,7142,297,4.2
16073,2020,June,Nolan                                                ,Not Adjusted,6598,7096,498,7.0
16074,2020,September,Nolan                                                ,Not Adjusted,6863,7268,405,5.6
16075,2020,December,Nolan                                                ,Not Adjusted,6847,7261,414,5.7
16076,2020,March,Nueces                                               ,Not Adjusted,154476,164034,9558,5.8
16077,2020,June,Nueces                                               ,Not Adjusted,147857,166845,18988,11.4
16078,2020,September,Nueces                                               ,Not Adjusted,148366,163780,15414,9.4
16079,2020,December,Nueces                                               ,Not Adjusted,149655,162984,13329,8.2
16080,2020,March,Ochiltree                                            ,Not Adjusted,3994,4191,197,4.7
16081,2020,June,Ochiltree                                            ,Not Adjusted,3802,4117,315,7.7
16082,2020,September,Ochiltree                                            ,Not Adjusted,3753,4003,250,6.2
16083,2020,December,Ochiltree                                            ,Not Adjusted,3724,3956,232,5.9
16084,2020,March,Oldham                                               ,Not Adjusted,868,901,33,3.7
16085,2020,June,Oldham                                               ,Not Adjusted,843,880,37,4.2
16086,2020,September,Oldham                                               ,Not Adjusted,857,889,32,3.6
16087,2020,December,Oldham                                               ,Not Adjusted,866,909,43,4.7
16088,2020,March,Orange                                               ,Not Adjusted,33562,36209,2647,7.3
16089,2020,June,Orange                                               ,Not Adjusted,31172,36157,4985,13.8
16090,2020,September,Orange                                               ,Not Adjusted,31835,35906,4071,11.3
16091,2020,December,Orange                                               ,Not Adjusted,32694,36256,3562,9.8
16092,2020,March,Palo Pinto                                           ,Not Adjusted,12673,13260,587,4.4
16093,2020,June,Palo Pinto                                           ,Not Adjusted,12232,13498,1266,9.4
16094,2020,September,Palo Pinto                                           ,Not Adjusted,12199,13233,1034,7.8
16095,2020,December,Palo Pinto                                           ,Not Adjusted,12287,13208,921,7.0
16096,2020,March,Panola                                               ,Not Adjusted,8892,9522,630,6.6
16097,2020,June,Panola                                               ,Not Adjusted,8581,9605,1024,10.7
16098,2020,September,Panola                                               ,Not Adjusted,8487,9352,865,9.2
16099,2020,December,Panola                                               ,Not Adjusted,8537,9325,788,8.5
16100,2020,March,Parker                                               ,Not Adjusted,65469,68404,2935,4.3
16101,2020,June,Parker                                               ,Not Adjusted,62587,67973,5386,7.9
16102,2020,September,Parker                                               ,Not Adjusted,63993,68071,4078,6.0
16103,2020,December,Parker                                               ,Not Adjusted,66149,69801,3652,5.2
16104,2020,March,Parmer                                               ,Not Adjusted,4659,4807,148,3.1
16105,2020,June,Parmer                                               ,Not Adjusted,4646,4790,144,3.0
16106,2020,September,Parmer                                               ,Not Adjusted,4879,5008,129,2.6
16107,2020,December,Parmer                                               ,Not Adjusted,4952,5097,145,2.8
16108,2020,March,Pecos                                                ,Not Adjusted,5953,6280,327,5.2
16109,2020,June,Pecos                                                ,Not Adjusted,5726,6455,729,11.3
16110,2020,September,Pecos                                                ,Not Adjusted,6151,6753,602,8.9
16111,2020,December,Pecos                                                ,Not Adjusted,6162,6731,569,8.5
16112,2020,March,Polk                                                 ,Not Adjusted,16914,18182,1268,7.0
16113,2020,June,Polk                                                 ,Not Adjusted,16446,18489,2043,11.0
16114,2020,September,Polk                                                 ,Not Adjusted,16887,18585,1698,9.1
16115,2020,December,Polk                                                 ,Not Adjusted,17094,18751,1657,8.8
16116,2020,March,Potter                                               ,Not Adjusted,51587,53562,1975,3.7
16117,2020,June,Potter                                               ,Not Adjusted,50485,54629,4144,7.6
16118,2020,September,Potter                                               ,Not Adjusted,51578,54539,2961,5.4
16119,2020,December,Potter                                               ,Not Adjusted,52394,55132,2738,5.0
16120,2020,March,Presidio                                             ,Not Adjusted,2895,3234,339,10.5
16121,2020,June,Presidio                                             ,Not Adjusted,2664,3293,629,19.1
16122,2020,September,Presidio                                             ,Not Adjusted,2674,3216,542,16.9
16123,2020,December,Presidio                                             ,Not Adjusted,2727,3152,425,13.5
16124,2020,March,Rains                                                ,Not Adjusted,5729,5979,250,4.2
16125,2020,June,Rains                                                ,Not Adjusted,5609,5972,363,6.1
16126,2020,September,Rains                                                ,Not Adjusted,5751,6048,297,4.9
16127,2020,December,Rains                                                ,Not Adjusted,5969,6228,259,4.2
16128,2020,March,Randall                                              ,Not Adjusted,69689,72132,2443,3.4
16129,2020,June,Randall                                              ,Not Adjusted,68211,72666,4455,6.1
16130,2020,September,Randall                                              ,Not Adjusted,69588,72645,3057,4.2
16131,2020,December,Randall                                              ,Not Adjusted,70729,73646,2917,4.0
16132,2020,March,Reagan                                               ,Not Adjusted,1789,1868,79,4.2
16133,2020,June,Reagan                                               ,Not Adjusted,1606,1853,247,13.3
16134,2020,September,Reagan                                               ,Not Adjusted,1558,1780,222,12.5
16135,2020,December,Reagan                                               ,Not Adjusted,1543,1726,183,10.6
16136,2020,March,Real                                                 ,Not Adjusted,992,1061,69,6.5
16137,2020,June,Real                                                 ,Not Adjusted,983,1071,88,8.2
16138,2020,September,Real                                                 ,Not Adjusted,999,1079,80,7.4
16139,2020,December,Real                                                 ,Not Adjusted,1022,1096,74,6.8
16140,2020,March,Red River                                            ,Not Adjusted,4785,5095,310,6.1
16141,2020,June,Red River                                            ,Not Adjusted,4729,5147,418,8.1
16142,2020,September,Red River                                            ,Not Adjusted,4906,5236,330,6.3
16143,2020,December,Red River                                            ,Not Adjusted,4929,5261,332,6.3
16144,2020,March,Reeves                                               ,Not Adjusted,9686,10061,375,3.7
16145,2020,June,Reeves                                               ,Not Adjusted,7598,8485,887,10.5
16146,2020,September,Reeves                                               ,Not Adjusted,7315,8083,768,9.5
16147,2020,December,Reeves                                               ,Not Adjusted,7495,8168,673,8.2
16148,2020,March,Refugio                                              ,Not Adjusted,2927,3091,164,5.3
16149,2020,June,Refugio                                              ,Not Adjusted,2781,3121,340,10.9
16150,2020,September,Refugio                                              ,Not Adjusted,2785,3066,281,9.2
16151,2020,December,Refugio                                              ,Not Adjusted,2823,3078,255,8.3
16152,2020,March,Roberts                                              ,Not Adjusted,401,422,21,5.0
16153,2020,June,Roberts                                              ,Not Adjusted,384,404,20,5.0
16154,2020,September,Roberts                                              ,Not Adjusted,392,416,24,5.8
16155,2020,December,Roberts                                              ,Not Adjusted,396,413,17,4.1
16156,2020,March,Robertson                                            ,Not Adjusted,7182,7572,390,5.2
16157,2020,June,Robertson                                            ,Not Adjusted,6523,7128,605,8.5
16158,2020,September,Robertson                                            ,Not Adjusted,6860,7358,498,6.8
16159,2020,December,Robertson                                            ,Not Adjusted,6971,7454,483,6.5
16160,2020,March,Rockwall                                             ,Not Adjusted,50840,53058,2218,4.2
16161,2020,June,Rockwall                                             ,Not Adjusted,48647,53072,4425,8.3
16162,2020,September,Rockwall                                             ,Not Adjusted,50172,53283,3111,5.8
16163,2020,December,Rockwall                                             ,Not Adjusted,51654,54367,2713,5.0
16164,2020,March,Runnels                                              ,Not Adjusted,4375,4577,202,4.4
16165,2020,June,Runnels                                              ,Not Adjusted,4298,4600,302,6.6
16166,2020,September,Runnels                                              ,Not Adjusted,4277,4494,217,4.8
16167,2020,December,Runnels                                              ,Not Adjusted,4310,4513,203,4.5
16168,2020,March,Rusk                                                 ,Not Adjusted,21271,22495,1224,5.4
16169,2020,June,Rusk                                                 ,Not Adjusted,19932,21985,2053,9.3
16170,2020,September,Rusk                                                 ,Not Adjusted,20318,22079,1761,8.0
16171,2020,December,Rusk                                                 ,Not Adjusted,20612,22258,1646,7.4
16172,2020,March,Sabine                                               ,Not Adjusted,3449,3799,350,9.2
16173,2020,June,Sabine                                               ,Not Adjusted,3481,4001,520,13.0
16174,2020,September,Sabine                                               ,Not Adjusted,3544,3986,442,11.1
16175,2020,December,Sabine                                               ,Not Adjusted,3590,4030,440,10.9
16176,2020,March,San Augustine                                        ,Not Adjusted,2797,3040,243,8.0
16177,2020,June,San Augustine                                        ,Not Adjusted,2717,3074,357,11.6
16178,2020,September,San Augustine                                        ,Not Adjusted,2663,2985,322,10.8
16179,2020,December,San Augustine                                        ,Not Adjusted,2693,2994,301,10.1
16180,2020,March,San Jacinto                                          ,Not Adjusted,10982,11712,730,6.2
16181,2020,June,San Jacinto                                          ,Not Adjusted,10444,11631,1187,10.2
16182,2020,September,San Jacinto                                          ,Not Adjusted,10711,11727,1016,8.7
16183,2020,December,San Jacinto                                          ,Not Adjusted,10893,11887,994,8.4
16184,2020,March,San Patricio                                         ,Not Adjusted,27168,29384,2216,7.5
16185,2020,June,San Patricio                                         ,Not Adjusted,25984,29739,3755,12.6
16186,2020,September,San Patricio                                         ,Not Adjusted,26042,29167,3125,10.7
16187,2020,December,San Patricio                                         ,Not Adjusted,26265,29174,2909,10.0
16188,2020,March,San Saba                                             ,Not Adjusted,2263,2388,125,5.2
16189,2020,June,San Saba                                             ,Not Adjusted,1970,2109,139,6.6
16190,2020,September,San Saba                                             ,Not Adjusted,2016,2123,107,5.0
16191,2020,December,San Saba                                             ,Not Adjusted,2058,2170,112,5.2
16192,2020,March,Schleicher                                           ,Not Adjusted,1171,1227,56,4.6
16193,2020,June,Schleicher                                           ,Not Adjusted,1125,1246,121,9.7
16194,2020,September,Schleicher                                           ,Not Adjusted,1081,1177,96,8.2
16195,2020,December,Schleicher                                           ,Not Adjusted,1107,1199,92,7.7
16196,2020,March,Scurry                                               ,Not Adjusted,5991,6337,346,5.5
16197,2020,June,Scurry                                               ,Not Adjusted,5589,6311,722,11.4
16198,2020,September,Scurry                                               ,Not Adjusted,5655,6202,547,8.8
16199,2020,December,Scurry                                               ,Not Adjusted,5645,6158,513,8.3
16200,2020,March,Shackelford                                          ,Not Adjusted,1798,1867,69,3.7
16201,2020,June,Shackelford                                          ,Not Adjusted,1629,1759,130,7.4
16202,2020,September,Shackelford                                          ,Not Adjusted,1656,1756,100,5.7
16203,2020,December,Shackelford                                          ,Not Adjusted,1654,1747,93,5.3
16204,2020,March,Shelby                                               ,Not Adjusted,10534,11167,633,5.7
16205,2020,June,Shelby                                               ,Not Adjusted,10320,11355,1035,9.1
16206,2020,September,Shelby                                               ,Not Adjusted,10546,11383,837,7.4
16207,2020,December,Shelby                                               ,Not Adjusted,10552,11284,732,6.5
16208,2020,March,Sherman                                              ,Not Adjusted,1296,1345,49,3.6
16209,2020,June,Sherman                                              ,Not Adjusted,1222,1270,48,3.8
16210,2020,September,Sherman                                              ,Not Adjusted,1266,1305,39,3.0
16211,2020,December,Sherman                                              ,Not Adjusted,1261,1308,47,3.6
16212,2020,March,Smith                                                ,Not Adjusted,102094,107191,5097,4.8
16213,2020,June,Smith                                                ,Not Adjusted,100087,110050,9963,9.1
16214,2020,September,Smith                                                ,Not Adjusted,101450,108873,7423,6.8
16215,2020,December,Smith                                                ,Not Adjusted,103888,110435,6547,5.9
16216,2020,March,Somervell                                            ,Not Adjusted,4132,4343,211,4.9
16217,2020,June,Somervell                                            ,Not Adjusted,3951,4340,389,9.0
16218,2020,September,Somervell                                            ,Not Adjusted,4042,4328,286,6.6
16219,2020,December,Somervell                                            ,Not Adjusted,4178,4440,262,5.9
16220,2020,March,Starr                                                ,Not Adjusted,21747,26232,4485,17.1
16221,2020,June,Starr                                                ,Not Adjusted,21101,26543,5442,20.5
16222,2020,September,Starr                                                ,Not Adjusted,21404,25935,4531,17.5
16223,2020,December,Starr                                                ,Not Adjusted,21635,26202,4567,17.4
16224,2020,March,Stephens                                             ,Not Adjusted,3838,4016,178,4.4
16225,2020,June,Stephens                                             ,Not Adjusted,3698,4015,317,7.9
16226,2020,September,Stephens                                             ,Not Adjusted,3760,4048,288,7.1
16227,2020,December,Stephens                                             ,Not Adjusted,3831,4079,248,6.1
16228,2020,March,Sterling                                             ,Not Adjusted,547,573,26,4.5
16229,2020,June,Sterling                                             ,Not Adjusted,519,571,52,9.1
16230,2020,September,Sterling                                             ,Not Adjusted,515,555,40,7.2
16231,2020,December,Sterling                                             ,Not Adjusted,515,557,42,7.5
16232,2020,March,Stonewall                                            ,Not Adjusted,534,559,25,4.5
16233,2020,June,Stonewall                                            ,Not Adjusted,546,585,39,6.7
16234,2020,September,Stonewall                                            ,Not Adjusted,560,592,32,5.4
16235,2020,December,Stonewall                                            ,Not Adjusted,541,573,32,5.6
16236,2020,March,Sutton                                               ,Not Adjusted,1169,1243,74,6.0
16237,2020,June,Sutton                                               ,Not Adjusted,1086,1250,164,13.1
16238,2020,September,Sutton                                               ,Not Adjusted,1087,1223,136,11.1
16239,2020,December,Sutton                                               ,Not Adjusted,1073,1205,132,11.0
16240,2020,March,Swisher                                              ,Not Adjusted,2419,2544,125,4.9
16241,2020,June,Swisher                                              ,Not Adjusted,2371,2528,157,6.2
16242,2020,September,Swisher                                              ,Not Adjusted,2414,2547,133,5.2
16243,2020,December,Swisher                                              ,Not Adjusted,2407,2540,133,5.2
16244,2020,March,Tarrant                                              ,Not Adjusted,1023632,1073764,50132,4.7
16245,2020,June,Tarrant                                              ,Not Adjusted,979368,1090819,111451,10.2
16246,2020,September,Tarrant                                              ,Not Adjusted,1001177,1081802,80625,7.5
16247,2020,December,Tarrant                                              ,Not Adjusted,1036454,1104763,68309,6.2
16248,2020,March,Taylor                                               ,Not Adjusted,63634,66316,2682,4.0
16249,2020,June,Taylor                                               ,Not Adjusted,61136,65986,4850,7.4
16250,2020,September,Taylor                                               ,Not Adjusted,62804,66477,3673,5.5
16251,2020,December,Taylor                                               ,Not Adjusted,63632,66893,3261,4.9
16252,2020,March,Terrell                                              ,Not Adjusted,366,385,19,4.9
16253,2020,June,Terrell                                              ,Not Adjusted,367,390,23,5.9
16254,2020,September,Terrell                                              ,Not Adjusted,374,393,19,4.8
16255,2020,December,Terrell                                              ,Not Adjusted,390,406,16,3.9
16256,2020,March,Terry                                                ,Not Adjusted,4639,4889,250,5.1
16257,2020,June,Terry                                                ,Not Adjusted,4415,4910,495,10.1
16258,2020,September,Terry                                                ,Not Adjusted,4411,4803,392,8.2
16259,2020,December,Terry                                                ,Not Adjusted,4413,4762,349,7.3
16260,2020,March,Throckmorton                                         ,Not Adjusted,616,644,28,4.3
16261,2020,June,Throckmorton                                         ,Not Adjusted,588,628,40,6.4
16262,2020,September,Throckmorton                                         ,Not Adjusted,601,637,36,5.7
16263,2020,December,Throckmorton                                         ,Not Adjusted,591,625,34,5.4
16264,2020,March,Titus                                                ,Not Adjusted,12554,13291,737,5.5
16265,2020,June,Titus                                                ,Not Adjusted,12072,13276,1204,9.1
16266,2020,September,Titus                                                ,Not Adjusted,12605,13517,912,6.7
16267,2020,December,Titus                                                ,Not Adjusted,12643,13491,848,6.3
16268,2020,March,Tom Green                                            ,Not Adjusted,51664,53899,2235,4.1
16269,2020,June,Tom Green                                            ,Not Adjusted,49222,53938,4716,8.7
16270,2020,September,Tom Green                                            ,Not Adjusted,50060,53618,3558,6.6
16271,2020,December,Tom Green                                            ,Not Adjusted,50885,54047,3162,5.9
16272,2020,March,Travis                                               ,Not Adjusted,710622,737872,27250,3.7
16273,2020,June,Travis                                               ,Not Adjusted,675868,741853,65985,8.9
16274,2020,September,Travis                                               ,Not Adjusted,696224,743554,47330,6.4
16275,2020,December,Travis                                               ,Not Adjusted,716218,753258,37040,4.9
16276,2020,March,Trinity                                              ,Not Adjusted,4913,5270,357,6.8
16277,2020,June,Trinity                                              ,Not Adjusted,4809,5337,528,9.9
16278,2020,September,Trinity                                              ,Not Adjusted,4951,5412,461,8.5
16279,2020,December,Trinity                                              ,Not Adjusted,4891,5331,440,8.3
16280,2020,March,Tyler                                                ,Not Adjusted,6793,7370,577,7.8
16281,2020,June,Tyler                                                ,Not Adjusted,6517,7437,920,12.4
16282,2020,September,Tyler                                                ,Not Adjusted,6618,7399,781,10.6
16283,2020,December,Tyler                                                ,Not Adjusted,6664,7406,742,10.0
16284,2020,March,Upshur                                               ,Not Adjusted,16702,17687,985,5.6
16285,2020,June,Upshur                                               ,Not Adjusted,15650,17425,1775,10.2
16286,2020,September,Upshur                                               ,Not Adjusted,15952,17384,1432,8.2
16287,2020,December,Upshur                                               ,Not Adjusted,16185,17501,1316,7.5
16288,2020,March,Upton                                                ,Not Adjusted,1777,1847,70,3.8
16289,2020,June,Upton                                                ,Not Adjusted,1681,1828,147,8.0
16290,2020,September,Upton                                                ,Not Adjusted,1695,1808,113,6.3
16291,2020,December,Upton                                                ,Not Adjusted,1706,1806,100,5.5
16292,2020,March,Uvalde                                               ,Not Adjusted,10892,11439,547,4.8
16293,2020,June,Uvalde                                               ,Not Adjusted,10744,11669,925,7.9
16294,2020,September,Uvalde                                               ,Not Adjusted,10555,11322,767,6.8
16295,2020,December,Uvalde                                               ,Not Adjusted,10492,11225,733,6.5
16296,2020,March,Val Verde                                            ,Not Adjusted,20662,21911,1249,5.7
16297,2020,June,Val Verde                                            ,Not Adjusted,19975,22508,2533,11.3
16298,2020,September,Val Verde                                            ,Not Adjusted,21381,23170,1789,7.7
16299,2020,December,Val Verde                                            ,Not Adjusted,21752,23322,1570,6.7
16300,2020,March,Van Zandt                                            ,Not Adjusted,24680,25897,1217,4.7
16301,2020,June,Van Zandt                                            ,Not Adjusted,24387,26531,2144,8.1
16302,2020,September,Van Zandt                                            ,Not Adjusted,24657,26297,1640,6.2
16303,2020,December,Van Zandt                                            ,Not Adjusted,24918,26380,1462,5.5
16304,2020,March,Victoria                                             ,Not Adjusted,38884,41121,2237,5.4
16305,2020,June,Victoria                                             ,Not Adjusted,36957,41295,4338,10.5
16306,2020,September,Victoria                                             ,Not Adjusted,37714,41252,3538,8.6
16307,2020,December,Victoria                                             ,Not Adjusted,38408,41530,3122,7.5
16308,2020,March,Walker                                               ,Not Adjusted,22663,23994,1331,5.5
16309,2020,June,Walker                                               ,Not Adjusted,21933,24157,2224,9.2
16310,2020,September,Walker                                               ,Not Adjusted,22396,24245,1849,7.6
16311,2020,December,Walker                                               ,Not Adjusted,22488,24201,1713,7.1
16312,2020,March,Waller                                               ,Not Adjusted,22768,24050,1282,5.3
16313,2020,June,Waller                                               ,Not Adjusted,21537,23956,2419,10.1
16314,2020,September,Waller                                               ,Not Adjusted,21694,23663,1969,8.3
16315,2020,December,Waller                                               ,Not Adjusted,22174,23983,1809,7.5
16316,2020,March,Ward                                                 ,Not Adjusted,6260,6559,299,4.6
16317,2020,June,Ward                                                 ,Not Adjusted,5393,6226,833,13.4
16318,2020,September,Ward                                                 ,Not Adjusted,5172,5887,715,12.1
16319,2020,December,Ward                                                 ,Not Adjusted,5197,5777,580,10.0
16320,2020,March,Washington                                           ,Not Adjusted,14550,15322,772,5.0
16321,2020,June,Washington                                           ,Not Adjusted,14262,15397,1135,7.4
16322,2020,September,Washington                                           ,Not Adjusted,14624,15505,881,5.7
16323,2020,December,Washington                                           ,Not Adjusted,14701,15583,882,5.7
16324,2020,March,Webb                                                 ,Not Adjusted,110716,117054,6338,5.4
16325,2020,June,Webb                                                 ,Not Adjusted,103734,117294,13560,11.6
16326,2020,September,Webb                                                 ,Not Adjusted,105322,115778,10456,9.0
16327,2020,December,Webb                                                 ,Not Adjusted,107314,116211,8897,7.7
16328,2020,March,Wharton                                              ,Not Adjusted,20642,21752,1110,5.1
16329,2020,June,Wharton                                              ,Not Adjusted,19487,21342,1855,8.7
16330,2020,September,Wharton                                              ,Not Adjusted,19635,21254,1619,7.6
16331,2020,December,Wharton                                              ,Not Adjusted,19883,21299,1416,6.6
16332,2020,March,Wheeler                                              ,Not Adjusted,2116,2214,98,4.4
16333,2020,June,Wheeler                                              ,Not Adjusted,2012,2168,156,7.2
16334,2020,September,Wheeler                                              ,Not Adjusted,2082,2236,154,6.9
16335,2020,December,Wheeler                                              ,Not Adjusted,2101,2273,172,7.6
16336,2020,March,Wichita                                              ,Not Adjusted,52603,55025,2422,4.4
16337,2020,June,Wichita                                              ,Not Adjusted,51153,55879,4726,8.5
16338,2020,September,Wichita                                              ,Not Adjusted,51320,55215,3895,7.1
16339,2020,December,Wichita                                              ,Not Adjusted,52369,56024,3655,6.5
16340,2020,March,Wilbarger                                            ,Not Adjusted,4648,4908,260,5.3
16341,2020,June,Wilbarger                                            ,Not Adjusted,4592,4940,348,7.0
16342,2020,September,Wilbarger                                            ,Not Adjusted,4661,4954,293,5.9
16343,2020,December,Wilbarger                                            ,Not Adjusted,4677,5024,347,6.9
16344,2020,March,Willacy                                              ,Not Adjusted,6034,6771,737,10.9
16345,2020,June,Willacy                                              ,Not Adjusted,5711,6703,992,14.8
16346,2020,September,Willacy                                              ,Not Adjusted,5739,6521,782,12.0
16347,2020,December,Willacy                                              ,Not Adjusted,5803,6549,746,11.4
16348,2020,March,Williamson                                           ,Not Adjusted,306842,319321,12479,3.9
16349,2020,June,Williamson                                           ,Not Adjusted,291820,317294,25474,8.0
16350,2020,September,Williamson                                           ,Not Adjusted,300375,318694,18319,5.7
16351,2020,December,Williamson                                           ,Not Adjusted,309343,324666,15323,4.7
16352,2020,March,Wilson                                               ,Not Adjusted,23585,24621,1036,4.2
16353,2020,June,Wilson                                               ,Not Adjusted,22520,24437,1917,7.8
16354,2020,September,Wilson                                               ,Not Adjusted,23145,24598,1453,5.9
16355,2020,December,Wilson                                               ,Not Adjusted,23766,25028,1262,5.0
16356,2020,March,Winkler                                              ,Not Adjusted,4081,4276,195,4.6
16357,2020,June,Winkler                                              ,Not Adjusted,3415,3953,538,13.6
16358,2020,September,Winkler                                              ,Not Adjusted,3402,3860,458,11.9
16359,2020,December,Winkler                                              ,Not Adjusted,3574,3959,385,9.7
16360,2020,March,Wise                                                 ,Not Adjusted,30682,32383,1701,5.3
16361,2020,June,Wise                                                 ,Not Adjusted,29316,32171,2855,8.9
16362,2020,September,Wise                                                 ,Not Adjusted,29971,32043,2072,6.5
16363,2020,December,Wise                                                 ,Not Adjusted,30961,32819,1858,5.7
16364,2020,March,Wood                                                 ,Not Adjusted,16780,17782,1002,5.6
16365,2020,June,Wood                                                 ,Not Adjusted,16580,18100,1520,8.4
16366,2020,September,Wood                                                 ,Not Adjusted,16924,18119,1195,6.6
16367,2020,December,Wood                                                 ,Not Adjusted,17069,18175,1106,6.1
16368,2020,March,Yoakum                                               ,Not Adjusted,3336,3515,179,5.1
16369,2020,June,Yoakum                                               ,Not Adjusted,2995,3663,668,18.2
16370,2020,September,Yoakum                                               ,Not Adjusted,3020,3499,479,13.7
16371,2020,December,Yoakum                                               ,Not Adjusted,2985,3346,361,10.8
16372,2020,March,Young                                                ,Not Adjusted,7354,7692,338,4.4
16373,2020,June,Young                                                ,Not Adjusted,7372,7907,535,6.8
16374,2020,September,Young                                                ,Not Adjusted,7431,7856,425,5.4
16375,2020,December,Young                                                ,Not Adjusted,7420,7818,398,5.1
16376,2020,March,Zapata                                               ,Not Adjusted,4646,5050,404,8.0
16377,2020,June,Zapata                                               ,Not Adjusted,3779,4529,750,16.6
16378,2020,September,Zapata                                               ,Not Adjusted,3763,4401,638,14.5
16379,2020,December,Zapata                                               ,Not Adjusted,3700,4332,632,14.6
16380,2020,March,Zavala                                               ,Not Adjusted,3119,3523,404,11.5
16381,2020,June,Zavala                                               ,Not Adjusted,2822,3460,638,18.4
16382,2020,September,Zavala                                               ,Not Adjusted,2828,3354,526,15.7
16383,2020,December,Zavala                                               ,Not Adjusted,3001,3498,497,14.2
16384,2021,March,Texas,Not Adjusted,13087177,14094131,1006954,7.1
16385,2021,March,Texas,Adjusted,13064883,14032262,967379,6.9
16386,2021,June,Texas,Not Adjusted,13186927,14126847,939920,6.7
16387,2021,June,Texas,Adjusted,13159779,14068729,908950,6.5
16388,2021,March,Anderson                                             ,Not Adjusted,21811,23253,1442,6.2
16389,2021,June,Anderson                                             ,Not Adjusted,20792,22152,1360,6.1
16390,2021,March,Andrews                                              ,Not Adjusted,8138,8824,686,7.8
16391,2021,June,Andrews                                              ,Not Adjusted,8097,8697,600,6.9
16392,2021,March,Angelina                                             ,Not Adjusted,32529,35362,2833,8.0
16393,2021,June,Angelina                                             ,Not Adjusted,31787,34490,2703,7.8
16394,2021,March,Aransas                                              ,Not Adjusted,8417,9260,843,9.1
16395,2021,June,Aransas                                              ,Not Adjusted,8422,9194,772,8.4
16396,2021,March,Archer                                               ,Not Adjusted,3745,3959,214,5.4
16397,2021,June,Archer                                               ,Not Adjusted,3778,3969,191,4.8
16398,2021,March,Armstrong                                            ,Not Adjusted,913,955,42,4.4
16399,2021,June,Armstrong                                            ,Not Adjusted,895,932,37,4.0
16400,2021,March,Atascosa                                             ,Not Adjusted,20646,22313,1667,7.5
16401,2021,June,Atascosa                                             ,Not Adjusted,20777,22346,1569,7.0
16402,2021,March,Austin                                               ,Not Adjusted,12916,13837,921,6.7
16403,2021,June,Austin                                               ,Not Adjusted,12950,13853,903,6.5
16404,2021,March,Bailey                                               ,Not Adjusted,2418,2562,144,5.6
16405,2021,June,Bailey                                               ,Not Adjusted,2326,2489,163,6.5
16406,2021,March,Bandera                                              ,Not Adjusted,9579,10168,589,5.8
16407,2021,June,Bandera                                              ,Not Adjusted,9642,10196,554,5.4
16408,2021,March,Bastrop                                              ,Not Adjusted,41329,43823,2494,5.7
16409,2021,June,Bastrop                                              ,Not Adjusted,41672,44097,2425,5.5
16410,2021,March,Baylor                                               ,Not Adjusted,1782,1854,72,3.9
16411,2021,June,Baylor                                               ,Not Adjusted,1773,1844,71,3.9
16412,2021,March,Bee                                                  ,Not Adjusted,8840,9846,1006,10.2
16413,2021,June,Bee                                                  ,Not Adjusted,8305,9219,914,9.9
16414,2021,March,Bell                                                 ,Not Adjusted,134939,145245,10306,7.1
16415,2021,June,Bell                                                 ,Not Adjusted,136636,146531,9895,6.8
16416,2021,March,Bexar                                                ,Not Adjusted,892410,956420,64010,6.7
16417,2021,June,Bexar                                                ,Not Adjusted,906641,965742,59101,6.1
16418,2021,March,Blanco                                               ,Not Adjusted,6505,6780,275,4.1
16419,2021,June,Blanco                                               ,Not Adjusted,6378,6658,280,4.2
16420,2021,March,Borden                                               ,Not Adjusted,503,519,16,3.1
16421,2021,June,Borden                                               ,Not Adjusted,475,489,14,2.9
16422,2021,March,Bosque                                               ,Not Adjusted,8024,8503,479,5.6
16423,2021,June,Bosque                                               ,Not Adjusted,7931,8381,450,5.4
16424,2021,March,Bowie                                                ,Not Adjusted,36248,39028,2780,7.1
16425,2021,June,Bowie                                                ,Not Adjusted,36455,39100,2645,6.8
16426,2021,March,Brazoria                                             ,Not Adjusted,162952,177922,14970,8.4
16427,2021,June,Brazoria                                             ,Not Adjusted,165013,179187,14174,7.9
16428,2021,March,Brazos                                               ,Not Adjusted,112982,119036,6054,5.1
16429,2021,June,Brazos                                               ,Not Adjusted,108487,114618,6131,5.3
16430,2021,March,Brewster                                             ,Not Adjusted,3918,4160,242,5.8
16431,2021,June,Brewster                                             ,Not Adjusted,3750,3976,226,5.7
16432,2021,March,Briscoe                                              ,Not Adjusted,573,608,35,5.8
16433,2021,June,Briscoe                                              ,Not Adjusted,566,599,33,5.5
16434,2021,March,Brooks                                               ,Not Adjusted,2285,2573,288,11.2
16435,2021,June,Brooks                                               ,Not Adjusted,2087,2354,267,11.3
16436,2021,March,Brown                                                ,Not Adjusted,14308,15261,953,6.2
16437,2021,June,Brown                                                ,Not Adjusted,13899,14846,947,6.4
16438,2021,March,Burleson                                             ,Not Adjusted,7907,8454,547,6.5
16439,2021,June,Burleson                                             ,Not Adjusted,7551,8048,497,6.2
16440,2021,March,Burnet                                               ,Not Adjusted,23157,24316,1159,4.8
16441,2021,June,Burnet                                               ,Not Adjusted,23019,24095,1076,4.5
16442,2021,March,Caldwell                                             ,Not Adjusted,18677,19875,1198,6.0
16443,2021,June,Caldwell                                             ,Not Adjusted,18847,20044,1197,6.0
16444,2021,March,Calhoun                                              ,Not Adjusted,12002,12723,721,5.7
16445,2021,June,Calhoun                                              ,Not Adjusted,11129,11846,717,6.1
16446,2021,March,Callahan                                             ,Not Adjusted,5760,6113,353,5.8
16447,2021,June,Callahan                                             ,Not Adjusted,5788,6119,331,5.4
16448,2021,March,Cameron                                              ,Not Adjusted,153822,170871,17049,10.0
16449,2021,June,Cameron                                              ,Not Adjusted,154430,171080,16650,9.7
16450,2021,March,Camp                                                 ,Not Adjusted,4681,5056,375,7.4
16451,2021,June,Camp                                                 ,Not Adjusted,4684,5037,353,7.0
16452,2021,March,Carson                                               ,Not Adjusted,2924,3064,140,4.6
16453,2021,June,Carson                                               ,Not Adjusted,2877,3011,134,4.5
16454,2021,March,Cass                                                 ,Not Adjusted,11428,12476,1048,8.4
16455,2021,June,Cass                                                 ,Not Adjusted,11246,12230,984,8.0
16456,2021,March,Castro                                               ,Not Adjusted,3400,3543,143,4.0
16457,2021,June,Castro                                               ,Not Adjusted,3265,3412,147,4.3
16458,2021,March,Chambers                                             ,Not Adjusted,17990,20000,2010,10.1
16459,2021,June,Chambers                                             ,Not Adjusted,18237,20264,2027,10.0
16460,2021,March,Cherokee                                             ,Not Adjusted,20037,21686,1649,7.6
16461,2021,June,Cherokee                                             ,Not Adjusted,18911,20455,1544,7.5
16462,2021,March,Childress                                            ,Not Adjusted,3051,3190,139,4.4
16463,2021,June,Childress                                            ,Not Adjusted,2828,2949,121,4.1
16464,2021,March,Clay                                                 ,Not Adjusted,4594,4891,297,6.1
16465,2021,June,Clay                                                 ,Not Adjusted,4612,4892,280,5.7
16466,2021,March,Cochran                                              ,Not Adjusted,1125,1211,86,7.1
16467,2021,June,Cochran                                              ,Not Adjusted,980,1054,74,7.0
16468,2021,March,Coke                                                 ,Not Adjusted,1278,1366,88,6.4
16469,2021,June,Coke                                                 ,Not Adjusted,1260,1340,80,6.0
16470,2021,March,Coleman                                              ,Not Adjusted,2712,2936,224,7.6
16471,2021,June,Coleman                                              ,Not Adjusted,2714,2923,209,7.2
16472,2021,March,Collin                                               ,Not Adjusted,544143,576470,32327,5.6
16473,2021,June,Collin                                               ,Not Adjusted,553501,583416,29915,5.1
16474,2021,March,Collingsworth                                        ,Not Adjusted,1046,1113,67,6.0
16475,2021,June,Collingsworth                                        ,Not Adjusted,1055,1115,60,5.4
16476,2021,March,Colorado                                             ,Not Adjusted,9161,9754,593,6.1
16477,2021,June,Colorado                                             ,Not Adjusted,9029,9585,556,5.8
16478,2021,March,Comal                                                ,Not Adjusted,72214,76568,4354,5.7
16479,2021,June,Comal                                                ,Not Adjusted,73268,77460,4192,5.4
16480,2021,March,Comanche                                             ,Not Adjusted,5556,5902,346,5.9
16481,2021,June,Comanche                                             ,Not Adjusted,5499,5818,319,5.5
16482,2021,March,Concho                                               ,Not Adjusted,1361,1432,71,5.0
16483,2021,June,Concho                                               ,Not Adjusted,1261,1330,69,5.2
16484,2021,March,Cooke                                                ,Not Adjusted,17938,19231,1293,6.7
16485,2021,June,Cooke                                                ,Not Adjusted,17690,18797,1107,5.9
16486,2021,March,Coryell                                              ,Not Adjusted,22506,24218,1712,7.1
16487,2021,June,Coryell                                              ,Not Adjusted,22764,24391,1627,6.7
16488,2021,March,Cottle                                               ,Not Adjusted,596,633,37,5.8
16489,2021,June,Cottle                                               ,Not Adjusted,552,588,36,6.1
16490,2021,March,Crane                                                ,Not Adjusted,1349,1561,212,13.6
16491,2021,June,Crane                                                ,Not Adjusted,1476,1653,177,10.7
16492,2021,March,Crockett                                             ,Not Adjusted,1377,1506,129,8.6
16493,2021,June,Crockett                                             ,Not Adjusted,1297,1414,117,8.3
16494,2021,March,Crosby                                               ,Not Adjusted,2410,2574,164,6.4
16495,2021,June,Crosby                                               ,Not Adjusted,2281,2457,176,7.2
16496,2021,March,Culberson                                            ,Not Adjusted,1151,1216,65,5.3
16497,2021,June,Culberson                                            ,Not Adjusted,1029,1089,60,5.5
16498,2021,March,Dallam                                               ,Not Adjusted,3671,3807,136,3.6
16499,2021,June,Dallam                                               ,Not Adjusted,3535,3665,130,3.5
16500,2021,March,Dallas                                               ,Not Adjusted,1273760,1371615,97855,7.1
16501,2021,June,Dallas                                               ,Not Adjusted,1295929,1385007,89078,6.4
16502,2021,March,Dawson                                               ,Not Adjusted,4283,4690,407,8.7
16503,2021,June,Dawson                                               ,Not Adjusted,4089,4453,364,8.2
16504,2021,March,Deaf Smith                                           ,Not Adjusted,8691,9114,423,4.6
16505,2021,June,Deaf Smith                                           ,Not Adjusted,8201,8597,396,4.6
16506,2021,March,Delta                                                ,Not Adjusted,2298,2440,142,5.8
16507,2021,June,Delta                                                ,Not Adjusted,2265,2402,137,5.7
16508,2021,March,Denton                                               ,Not Adjusted,479505,507826,28321,5.6
16509,2021,June,Denton                                               ,Not Adjusted,487783,514697,26914,5.2
16510,2021,March,DeWitt                                               ,Not Adjusted,8601,9186,585,6.4
16511,2021,June,DeWitt                                               ,Not Adjusted,8506,9040,534,5.9
16512,2021,March,Dickens                                              ,Not Adjusted,636,686,50,7.3
16513,2021,June,Dickens                                              ,Not Adjusted,659,699,40,5.7
16514,2021,March,Dimmit                                               ,Not Adjusted,5752,6181,429,6.9
16515,2021,June,Dimmit                                               ,Not Adjusted,5040,5444,404,7.4
16516,2021,March,Donley                                               ,Not Adjusted,1399,1468,69,4.7
16517,2021,June,Donley                                               ,Not Adjusted,1351,1432,81,5.7
16518,2021,March,Duval                                                ,Not Adjusted,4145,4709,564,12.0
16519,2021,June,Duval                                                ,Not Adjusted,4722,5252,530,10.1
16520,2021,March,Eastland                                             ,Not Adjusted,6717,7255,538,7.4
16521,2021,June,Eastland                                             ,Not Adjusted,6077,6604,527,8.0
16522,2021,March,Ector                                                ,Not Adjusted,70727,79391,8664,10.9
16523,2021,June,Ector                                                ,Not Adjusted,70947,78555,7608,9.7
16524,2021,March,Edwards                                              ,Not Adjusted,1326,1387,61,4.4
16525,2021,June,Edwards                                              ,Not Adjusted,1270,1336,66,4.9
16526,2021,March,Ellis                                                ,Not Adjusted,89646,95083,5437,5.7
16527,2021,June,Ellis                                                ,Not Adjusted,91057,96275,5218,5.4
16528,2021,March,El Paso                                              ,Not Adjusted,337311,365783,28472,7.8
16529,2021,June,El Paso                                              ,Not Adjusted,337428,363878,26450,7.3
16530,2021,March,Erath                                                ,Not Adjusted,19669,20795,1126,5.4
16531,2021,June,Erath                                                ,Not Adjusted,18197,19333,1136,5.9
16532,2021,March,Falls                                                ,Not Adjusted,6379,6855,476,6.9
16533,2021,June,Falls                                                ,Not Adjusted,6298,6698,400,6.0
16534,2021,March,Fannin                                               ,Not Adjusted,16110,16982,872,5.1
16535,2021,June,Fannin                                               ,Not Adjusted,16177,16980,803,4.7
16536,2021,March,Fayette                                              ,Not Adjusted,11100,11743,643,5.5
16537,2021,June,Fayette                                              ,Not Adjusted,10879,11463,584,5.1
16538,2021,March,Fisher                                               ,Not Adjusted,1597,1693,96,5.7
16539,2021,June,Fisher                                               ,Not Adjusted,1467,1546,79,5.1
16540,2021,March,Floyd                                                ,Not Adjusted,2448,2646,198,7.5
16541,2021,June,Floyd                                                ,Not Adjusted,2281,2451,170,6.9
16542,2021,March,Foard                                                ,Not Adjusted,564,585,21,3.6
16543,2021,June,Foard                                                ,Not Adjusted,537,560,23,4.1
16544,2021,March,Fort Bend                                            ,Not Adjusted,365665,395725,30060,7.6
16545,2021,June,Fort Bend                                            ,Not Adjusted,370533,398375,27842,7.0
16546,2021,March,Franklin                                             ,Not Adjusted,4777,5077,300,5.9
16547,2021,June,Franklin                                             ,Not Adjusted,5009,5272,263,5.0
16548,2021,March,Freestone                                            ,Not Adjusted,5794,6403,609,9.5
16549,2021,June,Freestone                                            ,Not Adjusted,5611,6158,547,8.9
16550,2021,March,Frio                                                 ,Not Adjusted,8866,9444,578,6.1
16551,2021,June,Frio                                                 ,Not Adjusted,8572,9121,549,6.0
16552,2021,March,Gaines                                               ,Not Adjusted,9356,9958,602,6.0
16553,2021,June,Gaines                                               ,Not Adjusted,8948,9471,523,5.5
16554,2021,March,Galveston                                            ,Not Adjusted,150887,164245,13358,8.1
16555,2021,June,Galveston                                            ,Not Adjusted,152714,165365,12651,7.7
16556,2021,March,Garza                                                ,Not Adjusted,1874,2004,130,6.5
16557,2021,June,Garza                                                ,Not Adjusted,1822,1939,117,6.0
16558,2021,March,Gillespie                                            ,Not Adjusted,12924,13500,576,4.3
16559,2021,June,Gillespie                                            ,Not Adjusted,12836,13385,549,4.1
16560,2021,March,Glasscock                                            ,Not Adjusted,842,873,31,3.6
16561,2021,June,Glasscock                                            ,Not Adjusted,719,749,30,4.0
16562,2021,March,Goliad                                               ,Not Adjusted,2944,3209,265,8.3
16563,2021,June,Goliad                                               ,Not Adjusted,2932,3166,234,7.4
16564,2021,March,Gonzales                                             ,Not Adjusted,9445,9987,542,5.4
16565,2021,June,Gonzales                                             ,Not Adjusted,9002,9486,484,5.1
16566,2021,March,Gray                                                 ,Not Adjusted,6979,7638,659,8.6
16567,2021,June,Gray                                                 ,Not Adjusted,6865,7456,591,7.9
16568,2021,March,Grayson                                              ,Not Adjusted,61570,65304,3734,5.7
16569,2021,June,Grayson                                              ,Not Adjusted,62352,65820,3468,5.3
16570,2021,March,Gregg                                                ,Not Adjusted,51901,56412,4511,8.0
16571,2021,June,Gregg                                                ,Not Adjusted,52250,56483,4233,7.5
16572,2021,March,Grimes                                               ,Not Adjusted,10291,11190,899,8.0
16573,2021,June,Grimes                                               ,Not Adjusted,9977,10843,866,8.0
16574,2021,March,Guadalupe                                            ,Not Adjusted,77583,82120,4537,5.5
16575,2021,June,Guadalupe                                            ,Not Adjusted,78715,83041,4326,5.2
16576,2021,March,Hale                                                 ,Not Adjusted,11253,12145,892,7.3
16577,2021,June,Hale                                                 ,Not Adjusted,10520,11470,950,8.3
16578,2021,March,Hall                                                 ,Not Adjusted,1049,1128,79,7.0
16579,2021,June,Hall                                                 ,Not Adjusted,1003,1070,67,6.3
16580,2021,March,Hamilton                                             ,Not Adjusted,3639,3829,190,5.0
16581,2021,June,Hamilton                                             ,Not Adjusted,3628,3819,191,5.0
16582,2021,March,Hansford                                             ,Not Adjusted,2458,2546,88,3.5
16583,2021,June,Hansford                                             ,Not Adjusted,2410,2506,96,3.8
16584,2021,March,Hardeman                                             ,Not Adjusted,1671,1772,101,5.7
16585,2021,June,Hardeman                                             ,Not Adjusted,1578,1661,83,5.0
16586,2021,March,Hardin                                               ,Not Adjusted,23085,25290,2205,8.7
16587,2021,June,Hardin                                               ,Not Adjusted,23283,25646,2363,9.2
16588,2021,March,Harris                                               ,Not Adjusted,2097191,2279958,182767,8.0
16589,2021,June,Harris                                               ,Not Adjusted,2125004,2294861,169857,7.4
16590,2021,March,Harrison                                             ,Not Adjusted,26756,29106,2350,8.1
16591,2021,June,Harrison                                             ,Not Adjusted,25904,28201,2297,8.1
16592,2021,March,Hartley                                              ,Not Adjusted,2602,2674,72,2.7
16593,2021,June,Hartley                                              ,Not Adjusted,2566,2640,74,2.8
16594,2021,March,Haskell                                              ,Not Adjusted,2736,2866,130,4.5
16595,2021,June,Haskell                                              ,Not Adjusted,2442,2569,127,4.9
16596,2021,March,Hays                                                 ,Not Adjusted,116986,123501,6515,5.3
16597,2021,June,Hays                                                 ,Not Adjusted,118400,124619,6219,5.0
16598,2021,March,Hemphill                                             ,Not Adjusted,1666,1751,85,4.9
16599,2021,June,Hemphill                                             ,Not Adjusted,1447,1538,91,5.9
16600,2021,March,Henderson                                            ,Not Adjusted,35460,37915,2455,6.5
16601,2021,June,Henderson                                            ,Not Adjusted,35150,37513,2363,6.3
16602,2021,March,Hidalgo                                              ,Not Adjusted,324676,365337,40661,11.1
16603,2021,June,Hidalgo                                              ,Not Adjusted,324177,363633,39456,10.9
16604,2021,March,Hill                                                 ,Not Adjusted,15423,16490,1067,6.5
16605,2021,June,Hill                                                 ,Not Adjusted,15210,16204,994,6.1
16606,2021,March,Hockley                                              ,Not Adjusted,9749,10562,813,7.7
16607,2021,June,Hockley                                              ,Not Adjusted,9289,10062,773,7.7
16608,2021,March,Hood                                                 ,Not Adjusted,26241,28089,1848,6.6
16609,2021,June,Hood                                                 ,Not Adjusted,26315,28019,1704,6.1
16610,2021,March,Hopkins                                              ,Not Adjusted,16923,17868,945,5.3
16611,2021,June,Hopkins                                              ,Not Adjusted,16400,17322,922,5.3
16612,2021,March,Houston                                              ,Not Adjusted,9407,10027,620,6.2
16613,2021,June,Houston                                              ,Not Adjusted,9570,10180,610,6.0
16614,2021,March,Howard                                               ,Not Adjusted,12284,13342,1058,7.9
16615,2021,June,Howard                                               ,Not Adjusted,11847,12850,1003,7.8
16616,2021,March,Hudspeth                                             ,Not Adjusted,1791,1930,139,7.2
16617,2021,June,Hudspeth                                             ,Not Adjusted,1713,1843,130,7.1
16618,2021,March,Hunt                                                 ,Not Adjusted,41509,44386,2877,6.5
16619,2021,June,Hunt                                                 ,Not Adjusted,42101,44848,2747,6.1
16620,2021,March,Hutchinson                                           ,Not Adjusted,7707,8343,636,7.6
16621,2021,June,Hutchinson                                           ,Not Adjusted,7905,8505,600,7.1
16622,2021,March,Irion                                                ,Not Adjusted,739,789,50,6.3
16623,2021,June,Irion                                                ,Not Adjusted,716,759,43,5.7
16624,2021,March,Jack                                                 ,Not Adjusted,3021,3265,244,7.5
16625,2021,June,Jack                                                 ,Not Adjusted,3172,3388,216,6.4
16626,2021,March,Jackson                                              ,Not Adjusted,6859,7298,439,6.0
16627,2021,June,Jackson                                              ,Not Adjusted,6545,6966,421,6.0
16628,2021,March,Jasper                                               ,Not Adjusted,11484,12930,1446,11.2
16629,2021,June,Jasper                                               ,Not Adjusted,11249,12686,1437,11.3
16630,2021,March,Jeff Davis                                           ,Not Adjusted,989,1044,55,5.3
16631,2021,June,Jeff Davis                                           ,Not Adjusted,906,956,50,5.2
16632,2021,March,Jefferson                                            ,Not Adjusted,94388,106596,12208,11.5
16633,2021,June,Jefferson                                            ,Not Adjusted,95152,107059,11907,11.1
16634,2021,March,Jim Hogg                                             ,Not Adjusted,1694,1887,193,10.2
16635,2021,June,Jim Hogg                                             ,Not Adjusted,1643,1832,189,10.3
16636,2021,March,Jim Wells                                            ,Not Adjusted,13370,15374,2004,13.0
16637,2021,June,Jim Wells                                            ,Not Adjusted,13273,15153,1880,12.4
16638,2021,March,Johnson                                              ,Not Adjusted,78586,83866,5280,6.3
16639,2021,June,Johnson                                              ,Not Adjusted,79104,83996,4892,5.8
16640,2021,March,Jones                                                ,Not Adjusted,5483,5974,491,8.2
16641,2021,June,Jones                                                ,Not Adjusted,5432,5853,421,7.2
16642,2021,March,Karnes                                               ,Not Adjusted,6485,6950,465,6.7
16643,2021,June,Karnes                                               ,Not Adjusted,6196,6617,421,6.4
16644,2021,March,Kaufman                                              ,Not Adjusted,64006,68279,4273,6.3
16645,2021,June,Kaufman                                              ,Not Adjusted,65073,69182,4109,5.9
16646,2021,March,Kendall                                              ,Not Adjusted,21769,22827,1058,4.6
16647,2021,June,Kendall                                              ,Not Adjusted,21868,22894,1026,4.5
16648,2021,March,Kenedy                                               ,Not Adjusted,177,190,13,6.8
16649,2021,June,Kenedy                                               ,Not Adjusted,146,160,14,8.8
16650,2021,March,Kent                                                 ,Not Adjusted,451,468,17,3.6
16651,2021,June,Kent                                                 ,Not Adjusted,434,451,17,3.8
16652,2021,March,Kerr                                                 ,Not Adjusted,20386,21621,1235,5.7
16653,2021,June,Kerr                                                 ,Not Adjusted,20326,21506,1180,5.5
16654,2021,March,Kimble                                               ,Not Adjusted,1762,1860,98,5.3
16655,2021,June,Kimble                                               ,Not Adjusted,1800,1889,89,4.7
16656,2021,March,King                                                 ,Not Adjusted,281,285,4,1.4
16657,2021,June,King                                                 ,Not Adjusted,378,382,4,1.0
16658,2021,March,Kinney                                               ,Not Adjusted,1329,1418,89,6.3
16659,2021,June,Kinney                                               ,Not Adjusted,1057,1140,83,7.3
16660,2021,March,Kleberg                                              ,Not Adjusted,12707,13880,1173,8.5
16661,2021,June,Kleberg                                              ,Not Adjusted,11411,12535,1124,9.0
16662,2021,March,Knox                                                 ,Not Adjusted,1464,1556,92,5.9
16663,2021,June,Knox                                                 ,Not Adjusted,1358,1435,77,5.4
16664,2021,March,Lamar                                                ,Not Adjusted,22254,23972,1718,7.2
16665,2021,June,Lamar                                                ,Not Adjusted,22182,23671,1489,6.3
16666,2021,March,Lamb                                                 ,Not Adjusted,5248,5575,327,5.9
16667,2021,June,Lamb                                                 ,Not Adjusted,4761,5087,326,6.4
16668,2021,March,Lampasas                                             ,Not Adjusted,8658,9210,552,6.0
16669,2021,June,Lampasas                                             ,Not Adjusted,8704,9233,529,5.7
16670,2021,March,La Salle                                             ,Not Adjusted,3259,3476,217,6.2
16671,2021,June,La Salle                                             ,Not Adjusted,3184,3373,189,5.6
16672,2021,March,Lavaca                                               ,Not Adjusted,7964,8461,497,5.9
16673,2021,June,Lavaca                                               ,Not Adjusted,7980,8430,450,5.3
16674,2021,March,Lee                                                  ,Not Adjusted,8648,9137,489,5.4
16675,2021,June,Lee                                                  ,Not Adjusted,7974,8423,449,5.3
16676,2021,March,Leon                                                 ,Not Adjusted,5763,6308,545,8.6
16677,2021,June,Leon                                                 ,Not Adjusted,5553,6059,506,8.4
16678,2021,March,Liberty                                              ,Not Adjusted,30238,34069,3831,11.2
16679,2021,June,Liberty                                              ,Not Adjusted,30509,34222,3713,10.8
16680,2021,March,Limestone                                            ,Not Adjusted,7801,8453,652,7.7
16681,2021,June,Limestone                                            ,Not Adjusted,7469,8082,613,7.6
16682,2021,March,Lipscomb                                             ,Not Adjusted,1521,1596,75,4.7
16683,2021,June,Lipscomb                                             ,Not Adjusted,1420,1483,63,4.2
16684,2021,March,Live Oak                                             ,Not Adjusted,4646,5060,414,8.2
16685,2021,June,Live Oak                                             ,Not Adjusted,4343,4727,384,8.1
16686,2021,March,Llano                                                ,Not Adjusted,8135,8683,548,6.3
16687,2021,June,Llano                                                ,Not Adjusted,8154,8657,503,5.8
16688,2021,March,Loving                                               ,Not Adjusted,292,296,4,1.4
16689,2021,June,Loving                                               ,Not Adjusted,381,387,6,1.6
16690,2021,March,Lubbock                                              ,Not Adjusted,149348,158520,9172,5.8
16691,2021,June,Lubbock                                              ,Not Adjusted,149836,158814,8978,5.7
16692,2021,March,Lynn                                                 ,Not Adjusted,2734,2886,152,5.3
16693,2021,June,Lynn                                                 ,Not Adjusted,2613,2752,139,5.1
16694,2021,March,McCulloch                                            ,Not Adjusted,3080,3339,259,7.8
16695,2021,June,McCulloch                                            ,Not Adjusted,2801,3035,234,7.7
16696,2021,March,McLennan                                             ,Not Adjusted,115790,123215,7425,6.0
16697,2021,June,McLennan                                             ,Not Adjusted,116318,123446,7128,5.8
16698,2021,March,McMullen                                             ,Not Adjusted,674,697,23,3.3
16699,2021,June,McMullen                                             ,Not Adjusted,631,652,21,3.2
16700,2021,March,Madison                                              ,Not Adjusted,4218,4585,367,8.0
16701,2021,June,Madison                                              ,Not Adjusted,4116,4470,354,7.9
16702,2021,March,Marion                                               ,Not Adjusted,3924,4278,354,8.3
16703,2021,June,Marion                                               ,Not Adjusted,3804,4141,337,8.1
16704,2021,March,Martin                                               ,Not Adjusted,2403,2569,166,6.5
16705,2021,June,Martin                                               ,Not Adjusted,2367,2516,149,5.9
16706,2021,March,Mason                                                ,Not Adjusted,1703,1811,108,6.0
16707,2021,June,Mason                                                ,Not Adjusted,1646,1745,99,5.7
16708,2021,March,Matagorda                                            ,Not Adjusted,15011,16647,1636,9.8
16709,2021,June,Matagorda                                            ,Not Adjusted,14710,16296,1586,9.7
16710,2021,March,Maverick                                             ,Not Adjusted,20499,24564,4065,16.5
16711,2021,June,Maverick                                             ,Not Adjusted,19832,23245,3413,14.7
16712,2021,March,Medina                                               ,Not Adjusted,20788,22172,1384,6.2
16713,2021,June,Medina                                               ,Not Adjusted,20896,22149,1253,5.7
16714,2021,March,Menard                                               ,Not Adjusted,855,906,51,5.6
16715,2021,June,Menard                                               ,Not Adjusted,793,840,47,5.6
16716,2021,March,Midland                                              ,Not Adjusted,87847,95089,7242,7.6
16717,2021,June,Midland                                              ,Not Adjusted,89498,95956,6458,6.7
16718,2021,March,Milam                                                ,Not Adjusted,9291,10052,761,7.6
16719,2021,June,Milam                                                ,Not Adjusted,9156,9853,697,7.1
16720,2021,March,Mills                                                ,Not Adjusted,1906,2008,102,5.1
16721,2021,June,Mills                                                ,Not Adjusted,1753,1849,96,5.2
16722,2021,March,Mitchell                                             ,Not Adjusted,2208,2422,214,8.8
16723,2021,June,Mitchell                                             ,Not Adjusted,2121,2325,204,8.8
16724,2021,March,Montague                                             ,Not Adjusted,8449,9081,632,7.0
16725,2021,June,Montague                                             ,Not Adjusted,8302,8843,541,6.1
16726,2021,March,Montgomery                                           ,Not Adjusted,264903,286045,21142,7.4
16727,2021,June,Montgomery                                           ,Not Adjusted,268186,287790,19604,6.8
16728,2021,March,Moore                                                ,Not Adjusted,10276,10752,476,4.4
16729,2021,June,Moore                                                ,Not Adjusted,10412,10841,429,4.0
16730,2021,March,Morris                                               ,Not Adjusted,4139,4727,588,12.4
16731,2021,June,Morris                                               ,Not Adjusted,3959,4505,546,12.1
16732,2021,March,Motley                                               ,Not Adjusted,437,464,27,5.8
16733,2021,June,Motley                                               ,Not Adjusted,399,429,30,7.0
16734,2021,March,Nacogdoches                                          ,Not Adjusted,26629,28541,1912,6.7
16735,2021,June,Nacogdoches                                          ,Not Adjusted,25664,27538,1874,6.8
16736,2021,March,Navarro                                              ,Not Adjusted,21637,23240,1603,6.9
16737,2021,June,Navarro                                              ,Not Adjusted,21033,22439,1406,6.3
16738,2021,March,Newton                                               ,Not Adjusted,4580,5178,598,11.5
16739,2021,June,Newton                                               ,Not Adjusted,4592,5168,576,11.1
16740,2021,March,Nolan                                                ,Not Adjusted,6895,7324,429,5.9
16741,2021,June,Nolan                                                ,Not Adjusted,6630,7019,389,5.5
16742,2021,March,Nueces                                               ,Not Adjusted,150203,164169,13966,8.5
16743,2021,June,Nueces                                               ,Not Adjusted,151214,164520,13306,8.1
16744,2021,March,Ochiltree                                            ,Not Adjusted,3747,3976,229,5.8
16745,2021,June,Ochiltree                                            ,Not Adjusted,3641,3862,221,5.7
16746,2021,March,Oldham                                               ,Not Adjusted,895,936,41,4.4
16747,2021,June,Oldham                                               ,Not Adjusted,874,910,36,4.0
16748,2021,March,Orange                                               ,Not Adjusted,32684,36328,3644,10.0
16749,2021,June,Orange                                               ,Not Adjusted,32996,36652,3656,10.0
16750,2021,March,Palo Pinto                                           ,Not Adjusted,12239,13194,955,7.2
16751,2021,June,Palo Pinto                                           ,Not Adjusted,11777,12639,862,6.8
16752,2021,March,Panola                                               ,Not Adjusted,8409,9199,790,8.6
16753,2021,June,Panola                                               ,Not Adjusted,8175,8955,780,8.7
16754,2021,March,Parker                                               ,Not Adjusted,65156,69105,3949,5.7
16755,2021,June,Parker                                               ,Not Adjusted,65457,69080,3623,5.2
16756,2021,March,Parmer                                               ,Not Adjusted,5076,5246,170,3.2
16757,2021,June,Parmer                                               ,Not Adjusted,4722,4916,194,3.9
16758,2021,March,Pecos                                                ,Not Adjusted,6205,6766,561,8.3
16759,2021,June,Pecos                                                ,Not Adjusted,5630,6137,507,8.3
16760,2021,March,Polk                                                 ,Not Adjusted,17171,19022,1851,9.7
16761,2021,June,Polk                                                 ,Not Adjusted,16360,18062,1702,9.4
16762,2021,March,Potter                                               ,Not Adjusted,52117,55148,3031,5.5
16763,2021,June,Potter                                               ,Not Adjusted,52697,55436,2739,4.9
16764,2021,March,Presidio                                             ,Not Adjusted,2753,3158,405,12.8
16765,2021,June,Presidio                                             ,Not Adjusted,2617,3007,390,13.0
16766,2021,March,Rains                                                ,Not Adjusted,5942,6244,302,4.8
16767,2021,June,Rains                                                ,Not Adjusted,5799,6095,296,4.9
16768,2021,March,Randall                                              ,Not Adjusted,70426,73658,3232,4.4
16769,2021,June,Randall                                              ,Not Adjusted,71027,74134,3107,4.2
16770,2021,March,Reagan                                               ,Not Adjusted,1591,1752,161,9.2
16771,2021,June,Reagan                                               ,Not Adjusted,1468,1615,147,9.1
16772,2021,March,Real                                                 ,Not Adjusted,1070,1149,79,6.9
16773,2021,June,Real                                                 ,Not Adjusted,1099,1175,76,6.5
16774,2021,March,Red River                                            ,Not Adjusted,4938,5325,387,7.3
16775,2021,June,Red River                                            ,Not Adjusted,4807,5148,341,6.6
16776,2021,March,Reeves                                               ,Not Adjusted,7693,8318,625,7.5
16777,2021,June,Reeves                                               ,Not Adjusted,7324,7908,584,7.4
16778,2021,March,Refugio                                              ,Not Adjusted,2852,3120,268,8.6
16779,2021,June,Refugio                                              ,Not Adjusted,2770,2994,224,7.5
16780,2021,March,Roberts                                              ,Not Adjusted,409,429,20,4.7
16781,2021,June,Roberts                                              ,Not Adjusted,368,388,20,5.2
16782,2021,March,Robertson                                            ,Not Adjusted,7127,7618,491,6.4
16783,2021,June,Robertson                                            ,Not Adjusted,6766,7243,477,6.6
16784,2021,March,Rockwall                                             ,Not Adjusted,50939,53950,3011,5.6
16785,2021,June,Rockwall                                             ,Not Adjusted,51799,54618,2819,5.2
16786,2021,March,Runnels                                              ,Not Adjusted,4399,4631,232,5.0
16787,2021,June,Runnels                                              ,Not Adjusted,4321,4548,227,5.0
16788,2021,March,Rusk                                                 ,Not Adjusted,20629,22293,1664,7.5
16789,2021,June,Rusk                                                 ,Not Adjusted,20669,22249,1580,7.1
16790,2021,March,Sabine                                               ,Not Adjusted,3624,4073,449,11.0
16791,2021,June,Sabine                                               ,Not Adjusted,3506,3942,436,11.1
16792,2021,March,San Augustine                                        ,Not Adjusted,2724,3009,285,9.5
16793,2021,June,San Augustine                                        ,Not Adjusted,2699,2985,286,9.6
16794,2021,March,San Jacinto                                          ,Not Adjusted,10924,12002,1078,9.0
16795,2021,June,San Jacinto                                          ,Not Adjusted,10705,11721,1016,8.7
16796,2021,March,San Patricio                                         ,Not Adjusted,26460,29507,3047,10.3
16797,2021,June,San Patricio                                         ,Not Adjusted,26521,29484,2963,10.0
16798,2021,March,San Saba                                             ,Not Adjusted,2060,2202,142,6.4
16799,2021,June,San Saba                                             ,Not Adjusted,1930,2050,120,5.9
16800,2021,March,Schleicher                                           ,Not Adjusted,1099,1184,85,7.2
16801,2021,June,Schleicher                                           ,Not Adjusted,1082,1163,81,7.0
16802,2021,March,Scurry                                               ,Not Adjusted,5600,6116,516,8.4
16803,2021,June,Scurry                                               ,Not Adjusted,5409,5875,466,7.9
16804,2021,March,Shackelford                                          ,Not Adjusted,1707,1792,85,4.7
16805,2021,June,Shackelford                                          ,Not Adjusted,1714,1804,90,5.0
16806,2021,March,Shelby                                               ,Not Adjusted,10669,11452,783,6.8
16807,2021,June,Shelby                                               ,Not Adjusted,10431,11171,740,6.6
16808,2021,March,Sherman                                              ,Not Adjusted,1347,1398,51,3.6
16809,2021,June,Sherman                                              ,Not Adjusted,1261,1311,50,3.8
16810,2021,March,Smith                                                ,Not Adjusted,103204,110314,7110,6.4
16811,2021,June,Smith                                                ,Not Adjusted,105288,111932,6644,5.9
16812,2021,March,Somervell                                            ,Not Adjusted,4108,4403,295,6.7
16813,2021,June,Somervell                                            ,Not Adjusted,4134,4407,273,6.2
16814,2021,March,Starr                                                ,Not Adjusted,21876,26750,4874,18.2
16815,2021,June,Starr                                                ,Not Adjusted,21139,26018,4879,18.8
16816,2021,March,Stephens                                             ,Not Adjusted,3870,4148,278,6.7
16817,2021,June,Stephens                                             ,Not Adjusted,3762,3999,237,5.9
16818,2021,March,Sterling                                             ,Not Adjusted,571,608,37,6.1
16819,2021,June,Sterling                                             ,Not Adjusted,584,617,33,5.3
16820,2021,March,Stonewall                                            ,Not Adjusted,561,591,30,5.1
16821,2021,June,Stonewall                                            ,Not Adjusted,567,591,24,4.1
16822,2021,March,Sutton                                               ,Not Adjusted,1077,1199,122,10.2
16823,2021,June,Sutton                                               ,Not Adjusted,1016,1133,117,10.3
16824,2021,March,Swisher                                              ,Not Adjusted,2501,2660,159,6.0
16825,2021,June,Swisher                                              ,Not Adjusted,2341,2500,159,6.4
16826,2021,March,Tarrant                                              ,Not Adjusted,1014934,1089767,74833,6.9
16827,2021,June,Tarrant                                              ,Not Adjusted,1023789,1092124,68335,6.3
16828,2021,March,Taylor                                               ,Not Adjusted,63244,66946,3702,5.5
16829,2021,June,Taylor                                               ,Not Adjusted,63839,67327,3488,5.2
16830,2021,March,Terrell                                              ,Not Adjusted,392,413,21,5.1
16831,2021,June,Terrell                                              ,Not Adjusted,388,404,16,4.0
16832,2021,March,Terry                                                ,Not Adjusted,4598,4966,368,7.4
16833,2021,June,Terry                                                ,Not Adjusted,4355,4701,346,7.4
16834,2021,March,Throckmorton                                         ,Not Adjusted,629,667,38,5.7
16835,2021,June,Throckmorton                                         ,Not Adjusted,730,766,36,4.7
16836,2021,March,Titus                                                ,Not Adjusted,12797,13677,880,6.4
16837,2021,June,Titus                                                ,Not Adjusted,12288,13164,876,6.7
16838,2021,March,Tom Green                                            ,Not Adjusted,50751,54012,3261,6.0
16839,2021,June,Tom Green                                            ,Not Adjusted,50704,53823,3119,5.8
16840,2021,March,Travis                                               ,Not Adjusted,714743,754921,40178,5.3
16841,2021,June,Travis                                               ,Not Adjusted,723952,759754,35802,4.7
16842,2021,March,Trinity                                              ,Not Adjusted,4994,5471,477,8.7
16843,2021,June,Trinity                                              ,Not Adjusted,4868,5321,453,8.5
16844,2021,March,Tyler                                                ,Not Adjusted,6882,7600,718,9.4
16845,2021,June,Tyler                                                ,Not Adjusted,6551,7285,734,10.1
16846,2021,March,Upshur                                               ,Not Adjusted,16199,17535,1336,7.6
16847,2021,June,Upshur                                               ,Not Adjusted,16228,17505,1277,7.3
16848,2021,March,Upton                                                ,Not Adjusted,1822,1942,120,6.2
16849,2021,June,Upton                                                ,Not Adjusted,1685,1789,104,5.8
16850,2021,March,Uvalde                                               ,Not Adjusted,10763,11543,780,6.8
16851,2021,June,Uvalde                                               ,Not Adjusted,10300,11073,773,7.0
16852,2021,March,Val Verde                                            ,Not Adjusted,20728,22340,1612,7.2
16853,2021,June,Val Verde                                            ,Not Adjusted,20584,22118,1534,6.9
16854,2021,March,Van Zandt                                            ,Not Adjusted,25040,26650,1610,6.0
16855,2021,June,Van Zandt                                            ,Not Adjusted,25031,26535,1504,5.7
16856,2021,March,Victoria                                             ,Not Adjusted,37751,40975,3224,7.9
16857,2021,June,Victoria                                             ,Not Adjusted,37926,40939,3013,7.4
16858,2021,March,Walker                                               ,Not Adjusted,22350,24237,1887,7.8
16859,2021,June,Walker                                               ,Not Adjusted,22123,23959,1836,7.7
16860,2021,March,Waller                                               ,Not Adjusted,22188,24093,1905,7.9
16861,2021,June,Waller                                               ,Not Adjusted,22303,24223,1920,7.9
16862,2021,March,Ward                                                 ,Not Adjusted,5249,5786,537,9.3
16863,2021,June,Ward                                                 ,Not Adjusted,5138,5618,480,8.5
16864,2021,March,Washington                                           ,Not Adjusted,14538,15528,990,6.4
16865,2021,June,Washington                                           ,Not Adjusted,14221,15221,1000,6.6
16866,2021,March,Webb                                                 ,Not Adjusted,106581,115785,9204,7.9
16867,2021,June,Webb                                                 ,Not Adjusted,107246,116111,8865,7.6
16868,2021,March,Wharton                                              ,Not Adjusted,19962,21490,1528,7.1
16869,2021,June,Wharton                                              ,Not Adjusted,19360,20780,1420,6.8
16870,2021,March,Wheeler                                              ,Not Adjusted,2167,2334,167,7.2
16871,2021,June,Wheeler                                              ,Not Adjusted,2025,2174,149,6.9
16872,2021,March,Wichita                                              ,Not Adjusted,51484,55184,3700,6.7
16873,2021,June,Wichita                                              ,Not Adjusted,52790,56263,3473,6.2
16874,2021,March,Wilbarger                                            ,Not Adjusted,4713,5142,429,8.3
16875,2021,June,Wilbarger                                            ,Not Adjusted,4447,4831,384,7.9
16876,2021,March,Willacy                                              ,Not Adjusted,6028,6933,905,13.1
16877,2021,June,Willacy                                              ,Not Adjusted,5887,6770,883,13.0
16878,2021,March,Williamson                                           ,Not Adjusted,308231,325145,16914,5.2
16879,2021,June,Williamson                                           ,Not Adjusted,312245,327841,15596,4.8
16880,2021,March,Wilson                                               ,Not Adjusted,23746,25097,1351,5.4
16881,2021,June,Wilson                                               ,Not Adjusted,24009,25321,1312,5.2
16882,2021,March,Winkler                                              ,Not Adjusted,3641,4009,368,9.2
16883,2021,June,Winkler                                              ,Not Adjusted,3395,3715,320,8.6
16884,2021,March,Wise                                                 ,Not Adjusted,30595,32567,1972,6.1
16885,2021,June,Wise                                                 ,Not Adjusted,30655,32578,1923,5.9
16886,2021,March,Wood                                                 ,Not Adjusted,17206,18493,1287,7.0
16887,2021,June,Wood                                                 ,Not Adjusted,16556,17725,1169,6.6
16888,2021,March,Yoakum                                               ,Not Adjusted,3073,3410,337,9.9
16889,2021,June,Yoakum                                               ,Not Adjusted,2880,3187,307,9.6
16890,2021,March,Young                                                ,Not Adjusted,7316,7799,483,6.2
16891,2021,June,Young                                                ,Not Adjusted,7462,7895,433,5.5
16892,2021,March,Zapata                                               ,Not Adjusted,3744,4352,608,14.0
16893,2021,June,Zapata                                               ,Not Adjusted,3734,4433,699,15.8
16894,2021,March,Zavala                                               ,Not Adjusted,3012,3537,525,14.8
16895,2021,June,Zavala                                               ,Not Adjusted,2825,3302,477,14.4
